state,county,total_pop,white,black,latino,non_white,pct_white,pct_nonwhite,pct_latino
Alabama,AUTAUGA,54590,41982,9796,1310,12608,0.769041949,0.230958051,0.023997069
Alabama,BALDWIN,183226,153183,16922,7915,30043,0.836033096,0.163966904,0.043198018
Alabama,BARBOUR,27469,12865,12610,1365,14604,0.468346136,0.531653864,0.049692381
Alabama,BIBB,22769,17058,4944,419,5711,0.749176512,0.250823488,0.018402214
Alabama,BLOUNT,57466,51033,710,4646,6433,0.888055546,0.111944454,0.080847806
Alabama,BULLOCK,10779,2405,7609,623,8374,0.223119028,0.776880972,0.057797569
Alabama,BUTLER,20730,11199,8961,203,9531,0.540231548,0.459768452,0.009792571
Alabama,CALHOUN,117834,86764,24164,3838,31070,0.736323981,0.263676019,0.032571244
Alabama,CHAMBERS,34228,19869,13383,555,14359,0.580489658,0.419510342,0.016214795
Alabama,CHEROKEE,25917,23848,1234,333,2069,0.920168229,0.079831771,0.012848709
Alabama,CHILTON,43611,35481,4257,3238,8130,0.813579143,0.186420857,0.074247323
Alabama,CHOCTAW,13838,7664,5919,83,6174,0.55383726,0.44616274,0.005997977
Alabama,CLARKE,25768,13879,11310,183,11889,0.538613785,0.461386215,0.007101832
Alabama,CLAY,13828,11070,2157,401,2758,0.800549609,0.199450391,0.028999132
Alabama,CLEBURNE,14905,13852,573,313,1053,0.929352566,0.070647434,0.020999665
Alabama,COFFEE,49966,36140,8579,3070,13826,0.723291838,0.276708162,0.06144178
Alabama,COLBERT,54451,43334,8706,1132,11117,0.795834787,0.204165213,0.020789334
Alabama,CONECUH,13188,6756,6130,38,6432,0.512283894,0.487716106,0.002881407
Alabama,COOSA,11305,7431,3558,225,3874,0.65731977,0.34268023,0.019902698
Alabama,COVINGTON,37803,31734,4744,516,6069,0.839457186,0.160542814,0.01364971
Alabama,CRENSHAW,13971,9932,3099,213,4039,0.710901152,0.289098848,0.015245866
Alabama,CULLMAN,80403,74566,743,3402,5837,0.927403206,0.072596794,0.042311854
Alabama,DALE,50129,35388,9491,2794,14741,0.705938678,0.294061322,0.055736201
Alabama,DALLAS,43572,12651,30027,315,30921,0.290347012,0.709652988,0.007229413
Alabama,DEKALB,70949,57992,1162,9544,12957,0.817375862,0.182624138,0.134519162
Alabama,ELMORE,79330,59267,15916,2091,20063,0.747094416,0.252905584,0.02635825
Alabama,ESCAMBIA,38122,23359,12265,730,14763,0.612743298,0.387256702,0.019149048
Alabama,ETOWAH,104317,82700,15704,3503,21617,0.792775866,0.207224134,0.033580337
Alabama,FAYETTE,17219,14775,1937,213,2444,0.858063767,0.141936233,0.012370056
Alabama,FRANKLIN,31664,25283,1288,4649,6381,0.798477767,0.201522233,0.14682289
Alabama,GENEVA,26769,22640,2576,899,4129,0.845754417,0.154245583,0.033583623
Alabama,GREENE,9067,1608,7421,0,7459,0.177346421,0.822653579,0
Alabama,HALE,15750,6241,9312,66,9509,0.396253968,0.603746032,0.004190476
Alabama,HENRY,17275,11676,4790,389,5599,0.675890014,0.324109986,0.02251809
Alabama,HOUSTON,101459,69571,25997,2950,31888,0.685705556,0.314294444,0.029075784
Alabama,JACKSON,53279,47986,1770,1334,5293,0.900655042,0.099344958,0.025038007
Alabama,JEFFERSON,658464,340382,276695,24770,318082,0.516933348,0.483066652,0.03761785
Alabama,LAMAR,14513,12478,1728,186,2035,0.859780886,0.140219114,0.012816096
Alabama,LAUDERDALE,92528,79132,9322,2065,13396,0.855222203,0.144777797,0.022317569
Alabama,LAWRENCE,34148,26187,3797,601,7961,0.766867752,0.233132248,0.017599859
Alabama,LEE,140938,98181,31944,4668,42757,0.696625467,0.303374533,0.033120947
Alabama,LIMESTONE,83313,65500,10623,4529,17813,0.786191831,0.213808169,0.054361264
Alabama,LOWNDES,11304,2837,8350,72,8467,0.250973107,0.749026893,0.006369427
Alabama,MACON,21214,3262,17495,274,17952,0.153766381,0.846233619,0.012915999
Alabama,MADISON,334661,221765,79621,14916,112896,0.662655643,0.337344357,0.044570476
Alabama,MARENGO,20909,9538,10840,364,11371,0.456167201,0.543832799,0.017408771
Alabama,MARION,30641,28382,1153,645,2259,0.926275252,0.073724748,0.021050227
Alabama,MARSHALL,93070,78169,1498,11174,14901,0.839894703,0.160105297,0.12006017
Alabama,MOBILE,412297,243363,143018,9864,168934,0.590261389,0.409738611,0.023924501
Alabama,MONROE,22993,12618,9534,224,10375,0.548775714,0.451224286,0.009742095
Alabama,MONTGOMERY,229376,88320,124716,7887,141056,0.385044643,0.614955357,0.034384591
Alabama,MORGAN,119330,92689,14000,8943,26641,0.77674516,0.22325484,0.074943434
Alabama,PERRY,10525,3144,7223,81,7381,0.29871734,0.70128266,0.007695962
Alabama,PICKENS,19646,10954,8168,320,8692,0.557568971,0.442431029,0.016288303
Alabama,PIKE,32750,18784,11905,743,13966,0.573557252,0.426442748,0.022687023
Alabama,RANDOLPH,22843,17196,4705,636,5647,0.752790789,0.247209211,0.027842227
Alabama,RUSSELL,53938,27939,22579,2092,25999,0.517983611,0.482016389,0.038785272
Alabama,ST. CLAIR,83530,72840,7358,1733,10690,0.872022028,0.127977972,0.020747037
Alabama,SHELBY,195237,156497,20982,11191,38740,0.801574497,0.198425503,0.057320078
Alabama,SUMTER,13669,3288,10132,101,10381,0.240544297,0.759455703,0.007388982
Alabama,TALLADEGA,82194,52980,26510,1653,29214,0.644572597,0.355427403,0.020110957
Alabama,TALLAPOOSA,41534,28823,11183,1006,12711,0.693961574,0.306038426,0.02422112
Alabama,TUSCALOOSA,194254,125823,58012,5860,68431,0.647724114,0.352275886,0.030166689
Alabama,WALKER,67016,60534,3611,1340,6482,0.903276829,0.096723171,0.019995225
Alabama,WASHINGTON,17407,11362,4238,163,6045,0.652725915,0.347274085,0.009364049
Alabama,WILCOX,11706,3124,8546,21,8582,0.26687169,0.73312831,0.001793952
Alabama,WINSTON,24432,23170,152,648,1262,0.948346431,0.051653569,0.026522593
Alaska,ALEUTIANS EAST BOROUGH,3114,348,405,449,2766,0.111753372,0.888246628,0.14418754
Alaska,ALEUTIANS WEST CENSUS AREA,5507,1684,316,741,3823,0.305792628,0.694207372,0.13455602
Alaska,ANCHORAGE MUNICIPALITY,291470,182176,15658,22473,109294,0.625024874,0.374975126,0.077102275
Alaska,BETHEL CENSUS AREA,17184,1908,49,201,15276,0.11103352,0.88896648,0.011696927
Alaska,BRISTOL BAY BOROUGH,929,488,2,49,441,0.525296017,0.474703983,0.052744887
Alaska,DENALI BOROUGH,1917,1634,20,43,283,0.8523735,0.1476265,0.022430882
Alaska,DILLINGHAM CENSUS AREA,4887,878,19,102,4009,0.179660323,0.820339677,0.0208717
Alaska,FAIRBANKS NORTH STAR BOROUGH,97523,71833,4267,5898,25690,0.736574962,0.263425038,0.060478041
Alaska,HAINES BOROUGH,2500,2021,8,32,479,0.8084,0.1916,0.0128
Alaska,HOONAH-ANGOON CENSUS AREA,2153,1005,5,61,1148,0.466790525,0.533209475,0.028332559
Alaska,JUNEAU CITY AND BOROUGH,31636,21282,212,1663,10354,0.672714629,0.327285371,0.052566696
Alaska,KENAI PENINSULA BOROUGH,55474,45967,302,1698,9507,0.828622418,0.171377582,0.030608934
Alaska,KETCHIKAN GATEWAY BOROUGH,13525,8910,54,559,4615,0.658780037,0.341219963,0.041330869
Alaska,KODIAK ISLAND BOROUGH,13710,7184,105,1044,6526,0.523997082,0.476002918,0.076148796
Alaska,LAKE AND PENINSULA BOROUGH,1551,416,7,19,1135,0.268214055,0.731785945,0.012250161
Alaska,MATANUSKA-SUSITNA BOROUGH,89319,73850,772,3396,15469,0.826811765,0.173188235,0.038021026
Alaska,NOME CENSUS AREA,9580,1548,126,123,8032,0.161586639,0.838413361,0.012839248
Alaska,NORTH SLOPE BOROUGH,9317,2953,46,264,6364,0.316947515,0.683052485,0.028335301
Alaska,NORTHWEST ARCTIC BOROUGH,7601,857,30,66,6744,0.112748323,0.887251677,0.008683068
Alaska,PETERSBURG CENSUS AREA,3822,2699,50,158,1123,0.706174778,0.293825222,0.041339613
Alaska,PRINCE OF WALES-HYDER CENSUS AREA,5603,2755,12,135,2848,0.491700875,0.508299125,0.024094235
Alaska,SITKA CITY AND BOROUGH,8909,5695,70,441,3214,0.639241217,0.360758783,0.049500505
Alaska,SKAGWAY MUNICIPALITY,1050,791,3,11,259,0.753333333,0.246666667,0.01047619
Alaska,SOUTHEAST FAIRBANKS CENSUS AREA,7039,5524,103,251,1515,0.784770564,0.215229436,0.035658474
Alaska,VALDEZ-CORDOVA CENSUS AREA,9614,6841,28,355,2773,0.711566466,0.288433534,0.036925317
Alaska,WADE HAMPTON CENSUS AREA,7556,233,8,34,7323,0.030836421,0.969163579,0.004499735
Alaska,WRANGELL CITY AND BOROUGH,2368,1739,13,21,629,0.734375,0.265625,0.008868243
Alaska,YAKUTAT CITY AND BOROUGH,644,247,8,14,397,0.383540373,0.616459627,0.02173913
Alaska,YUKON-KOYUKUK CENSUS AREA,5637,1223,6,70,4414,0.216959376,0.783040624,0.012417953
Arizona,APACHE,71618,14323,207,4286,57295,0.199991622,0.800008378,0.05984529
Arizona,COCHISE,131118,76471,4872,42595,54647,0.583222746,0.416777254,0.32486005
Arizona,COCONINO,134011,73929,1642,18106,60082,0.551663669,0.448336331,0.135108312
Arizona,GILA,53436,35059,238,9612,18377,0.65609327,0.34390673,0.179878733
Arizona,GRAHAM,37115,19456,706,11365,17659,0.524208541,0.475791459,0.306210427
Arizona,GREENLEE,8592,4116,84,4080,4476,0.479050279,0.520949721,0.474860335
Arizona,LA PAZ,20460,12729,179,4870,7731,0.622140762,0.377859238,0.238025415
Arizona,MARICOPA,3841819,2253066,182923,1136308,1588753,0.586458134,0.413541866,0.295773434
Arizona,MOHAVE,201216,159755,1797,30016,41461,0.793947797,0.206052203,0.149173028
Arizona,NAVAJO,107415,46958,868,11549,60457,0.437164269,0.562835731,0.107517572
Arizona,PIMA,981048,541533,32608,339278,439515,0.551994398,0.448005602,0.345832212
Arizona,PINAL,368374,214423,15811,106207,153951,0.582079626,0.417920374,0.288312965
Arizona,SANTA CRUZ,47057,7469,135,38905,39588,0.1587224,0.8412776,0.826763287
Arizona,YAVAPAI,211280,173032,1047,28767,38248,0.818970087,0.181029913,0.136155812
Arizona,YUMA,196420,69613,3357,117002,126807,0.35440892,0.64559108,0.595672538
Arkansas,ARKANSAS,19029,13523,4634,512,5506,0.710652162,0.289347838,0.026906301
Arkansas,ASHLEY,21811,14842,5610,1067,6969,0.680482325,0.319517675,0.04892027
Arkansas,BAXTER,41387,39608,123,712,1779,0.957015488,0.042984512,0.01720347
Arkansas,BENTON,222028,169904,2463,34339,52124,0.765236817,0.234763183,0.154660673
Arkansas,BOONE,37032,35197,113,720,1835,0.950448261,0.049551739,0.019442644
Arkansas,BRADLEY,11510,6663,3180,1528,4847,0.578887924,0.421112076,0.132754127
Arkansas,CALHOUN,5373,3932,1304,45,1441,0.731807184,0.268192816,0.008375209
Arkansas,CARROLL,27321,22853,41,3547,4468,0.836462794,0.163537206,0.129826873
Arkansas,CHICOT,11759,4713,6367,557,7046,0.400799388,0.599200612,0.047367973
Arkansas,CLARK,23050,16210,5438,928,6840,0.703253796,0.296746204,0.040260304
Arkansas,CLAY,15981,15460,38,223,521,0.967398786,0.032601214,0.01395407
Arkansas,CLEBURNE,25849,24721,102,536,1128,0.956361948,0.043638052,0.020735812
Arkansas,CLEVELAND,8685,7381,1043,147,1304,0.849856074,0.150143926,0.016925734
Arkansas,COLUMBIA,24644,14627,9072,551,10017,0.593531894,0.406468106,0.022358383
Arkansas,CONWAY,21203,17446,2490,771,3757,0.822808093,0.177191907,0.036362779
Arkansas,CRAIGHEAD,96709,77153,12747,4270,19556,0.797785108,0.202214892,0.044153078
Arkansas,CRAWFORD,61670,53468,820,3768,8202,0.867001784,0.132998216,0.0610994
Arkansas,CRITTENDEN,50618,22974,25748,1049,27644,0.453870165,0.546129835,0.020723853
Arkansas,CROSS,17891,13271,4114,110,4620,0.741769605,0.258230395,0.006148343
Arkansas,DALLAS,8122,4388,3495,192,3734,0.540261019,0.459738981,0.023639498
Arkansas,DESHA,12922,6066,6192,581,6856,0.469431976,0.530568024,0.04496208
Arkansas,DREW,18615,12587,5271,460,6028,0.676175128,0.323824872,0.024711254
Arkansas,FAULKNER,113730,93716,11799,4397,20014,0.824021806,0.175978194,0.038661743
Arkansas,FRANKLIN,18110,16949,116,406,1161,0.935891773,0.064108227,0.022418553
Arkansas,FULTON,12301,11853,36,110,448,0.963580197,0.036419803,0.008942362
Arkansas,GARLAND,96249,80620,7988,4643,15629,0.837619092,0.162380908,0.048239462
Arkansas,GRANT,17852,16759,364,408,1093,0.938774367,0.061225633,0.022854582
Arkansas,GREENE,42224,40224,263,940,2000,0.952633573,0.047366427,0.022262221
Arkansas,HEMPSTEAD,22548,12757,6796,2678,9791,0.5657708,0.4342292,0.118768849
Arkansas,HOT SPRING,33011,27733,3602,925,5278,0.840113901,0.159886099,0.028020963
Arkansas,HOWARD,13790,9266,2943,1338,4524,0.671936186,0.328063814,0.097026831
Arkansas,INDEPENDENCE,36572,32854,939,2089,3718,0.898337526,0.101662474,0.057120201
Arkansas,IZARD,13614,12908,163,207,706,0.948141619,0.051858381,0.015204936
Arkansas,JACKSON,17885,14050,2923,442,3835,0.785574504,0.214425496,0.024713447
Arkansas,JEFFERSON,76836,31895,42236,1236,44941,0.415104899,0.584895101,0.01608621
Arkansas,JOHNSON,25554,21317,394,3121,4237,0.834194255,0.165805745,0.122133521
Arkansas,LAFAYETTE,7618,4567,2834,132,3051,0.599501181,0.400498819,0.017327383
Arkansas,LAWRENCE,17314,16743,114,160,571,0.967020908,0.032979092,0.009241077
Arkansas,LEE,10430,4322,5888,186,6108,0.414381592,0.585618408,0.017833174
Arkansas,LINCOLN,14167,9258,4173,458,4909,0.653490506,0.346509494,0.032328651
Arkansas,LITTLE RIVER,13068,9702,2863,130,3366,0.742424242,0.257575758,0.009947964
Arkansas,LOGAN,22352,20579,289,527,1773,0.920678239,0.079321761,0.023577309
Arkansas,LONOKE,68274,59948,4225,2261,8326,0.878050209,0.121949791,0.03311656
Arkansas,MADISON,15674,14402,27,769,1272,0.918846497,0.081153503,0.049062141
Arkansas,MARION,16712,15954,39,300,758,0.95464337,0.04535663,0.017951173
Arkansas,MILLER,43449,30734,10539,1097,12715,0.707358052,0.292641948,0.025247992
Arkansas,MISSISSIPPI,46388,28047,15750,1700,18341,0.604617574,0.395382426,0.036647409
Arkansas,MONROE,8145,4537,3406,143,3608,0.557028852,0.442971148,0.017556783
Arkansas,MONTGOMERY,9453,8770,38,359,683,0.927747805,0.072252195,0.037977362
Arkansas,NEVADA,9003,5799,2854,238,3204,0.644118627,0.355881373,0.026435633
Arkansas,NEWTON,8286,7841,38,50,445,0.946294955,0.053705045,0.006034275
Arkansas,OUACHITA,25894,14542,10381,414,11352,0.561597281,0.438402719,0.01598826
Arkansas,PERRY,10413,9750,237,244,663,0.936329588,0.063670412,0.023432248
Arkansas,PHILLIPS,21646,7527,13577,299,14119,0.347731683,0.652268317,0.013813176
Arkansas,PIKE,11261,9896,397,736,1365,0.878785188,0.121214812,0.065358316
Arkansas,POINSETT,24506,21775,1777,571,2731,0.888557904,0.111442096,0.023300416
Arkansas,POLK,20535,18434,19,1185,2101,0.897686876,0.102313124,0.057706355
Arkansas,POPE,61853,53742,1950,4149,8111,0.868866506,0.131133494,0.067078396
Arkansas,PRAIRIE,8659,7390,1119,81,1269,0.85344728,0.14655272,0.009354429
Arkansas,PULASKI,383185,212279,133365,21706,170906,0.553985673,0.446014327,0.056646267
Arkansas,RANDOLPH,17992,17239,53,290,753,0.958148066,0.041851934,0.016118275
Arkansas,ST. FRANCIS,28089,11838,14552,1187,16251,0.421446118,0.578553882,0.042258535
Arkansas,SALINE,107498,95467,5009,4028,12031,0.888081639,0.111918361,0.037470465
Arkansas,SCOTT,11170,9534,22,779,1636,0.853536258,0.146463742,0.069740376
Arkansas,SEARCY,8146,7741,26,127,405,0.950282347,0.049717653,0.015590474
Arkansas,SEBASTIAN,125795,91715,7240,15352,34080,0.729083032,0.270916968,0.122039827
Arkansas,SEVIER,16978,10384,717,5212,6594,0.611615031,0.388384969,0.306985511
Arkansas,SHARP,17278,16414,50,285,864,0.949994212,0.050005788,0.016494965
Arkansas,STONE,12480,11983,9,165,497,0.960176282,0.039823718,0.013221154
Arkansas,UNION,41594,25725,13703,1415,15869,0.618478627,0.381521373,0.03401933
Arkansas,VAN BUREN,17223,16203,154,467,1020,0.940776868,0.059223132,0.027114904
Arkansas,WASHINGTON,204057,151052,6598,31439,53005,0.740244147,0.259755853,0.154069696
Arkansas,WHITE,77007,68992,3197,2863,8015,0.895918553,0.104081447,0.037178438
Arkansas,WOODRUFF,7262,5026,2086,28,2236,0.692095841,0.307904159,0.003855687
Arkansas,YELL,22033,16935,273,4154,5098,0.768619798,0.231380202,0.188535379
California,ALAMEDA,1515136,516580,181711,339441,998556,0.340946291,0.659053709,0.224033354
California,ALPINE,1197,835,0,78,362,0.697577277,0.302422723,0.065162907
California,AMADOR,37764,30248,946,4673,7516,0.800974473,0.199025527,0.123742188
California,BUTTE,220101,165440,2982,31256,54661,0.751654922,0.248345078,0.142007533
California,CALAVERAS,45507,37944,468,4738,7563,0.833805788,0.166194212,0.10411585
California,COLUSA,21329,8535,157,11740,12794,0.400159407,0.599840593,0.550424305
California,CONTRA COSTA,1052047,503249,93001,255128,548798,0.478352203,0.521647797,0.242506276
California,DEL NORTE,28496,18514,1069,5119,9982,0.649705222,0.350294778,0.179639248
California,EL DORADO,180441,144479,1298,21650,35962,0.800699398,0.199300602,0.119983817
California,FRESNO,930517,303916,44497,467958,626601,0.326609831,0.673390169,0.502901075
California,GLENN,28078,15674,211,10525,12404,0.558230643,0.441769357,0.374848636
California,HUMBOLDT,134317,103889,1584,13208,30428,0.773461289,0.226538711,0.098334537
California,IMPERIAL,173487,23876,5064,139382,149611,0.137624145,0.862375855,0.803414665
California,INYO,18474,12202,152,3575,6272,0.660495832,0.339504168,0.193515211
California,KERN,839153,323572,44582,412779,515581,0.385593569,0.614406431,0.49189957
California,KINGS,151982,53890,9978,77382,98092,0.354581464,0.645418536,0.5091524
California,LAKE,64360,47662,1417,11068,16698,0.740553139,0.259446861,0.171970168
California,LASSEN,34628,23029,2852,6108,11599,0.665039852,0.334960148,0.176389049
California,LOS ANGELES,9840024,2731605,809858,4694846,7108419,0.277601457,0.722398543,0.477117332
California,MADERA,150615,57468,4802,80939,93147,0.381555622,0.618444378,0.537390034
California,MARIN,252759,184847,6804,38605,67912,0.731317184,0.268682816,0.152734423
California,MARIPOSA,18193,15110,141,1714,3083,0.830539218,0.169460782,0.09421206
California,MENDOCINO,87577,59992,650,19426,27585,0.68502004,0.31497996,0.22181623
California,MERCED,256398,81483,8857,141027,174915,0.317798891,0.682201109,0.550031592
California,MODOC,9545,7518,129,1337,2027,0.787637507,0.212362493,0.140073337
California,MONO,14181,9674,69,3747,4507,0.682180382,0.317819618,0.264226782
California,MONTEREY,416199,137358,11516,230202,278841,0.330029625,0.669970375,0.553105606
California,NAPA,136644,77227,2646,43897,59417,0.565169345,0.434830655,0.321250842
California,NEVADA,98521,85313,300,8400,13208,0.865937211,0.134062789,0.08526101
California,ORANGE,3021840,1332316,45438,1015013,1689524,0.440895613,0.559104387,0.33589237
California,PLACER,350074,266065,4095,44888,84009,0.760025023,0.239974977,0.128224318
California,PLUMAS,19926,16965,253,1604,2961,0.851400181,0.148599819,0.080497842
California,RIVERSIDE,2192982,867580,129961,998113,1325402,0.395616562,0.604383438,0.455139623
California,SACRAMENTO,1422348,688966,138550,305985,733382,0.484386381,0.515613619,0.215126678
California,SAN BENITO,55467,21094,445,31300,34373,0.380298195,0.619701805,0.564299493
California,SAN BERNARDINO,2041029,677104,169394,1005858,1363925,0.331746389,0.668253611,0.492819063
California,SAN DIEGO,3100500,1502635,148249,992087,1597865,0.4846428,0.5153572,0.319976455
California,SAN FRANCISCO,807755,337443,46293,121628,470312,0.417754146,0.582245854,0.15057536
California,SAN JOAQUIN,687036,246851,46941,266808,440185,0.359298494,0.640701506,0.388346462
California,SAN LUIS OBISPO,270121,191834,5475,56068,78287,0.710178031,0.289821969,0.207566239
California,SAN MATEO,721183,306464,18910,181328,414719,0.424946234,0.575053766,0.251431329
California,SANTA BARBARA,423594,203859,7171,180631,219735,0.481260358,0.518739642,0.426424831
California,SANTA CLARA,1788393,629179,42681,478065,1159214,0.351812493,0.648187507,0.267315406
California,SANTA CRUZ,262340,156894,2573,83709,105446,0.598055958,0.401944042,0.319085919
California,SHASTA,177693,146440,1563,14994,31253,0.824118001,0.175881999,0.084381489
California,SIERRA,3163,2806,36,281,357,0.887132469,0.112867531,0.088839709
California,SISKIYOU,44673,35501,541,4652,9172,0.794685828,0.205314172,0.104134488
California,SOLANO,414209,168848,57592,99502,245361,0.407639622,0.592360378,0.240221724
California,SONOMA,483456,320460,7063,119747,162996,0.662852462,0.337147538,0.247689552
California,STANISLAUS,515115,240545,13250,216009,274570,0.466973394,0.533026606,0.419341312
California,SUTTER,94615,47771,1536,27119,46844,0.5048988,0.4951012,0.286624742
California,TEHAMA,63200,45453,360,13885,17747,0.719193038,0.280806962,0.219699367
California,TRINITY,13693,11418,119,956,2275,0.833856715,0.166143285,0.069816695
California,TULARE,441877,144029,5559,267639,297848,0.325948171,0.674051829,0.60568665
California,TUOLUMNE,55205,44945,1105,5935,10260,0.814147269,0.185852731,0.107508378
California,VENTURA,822794,400432,12937,331225,422362,0.486673457,0.513326543,0.402561273
California,YOLO,200873,100254,4748,60939,100619,0.499091466,0.500908534,0.303370787
California,YUBA,72244,42230,1975,18193,30014,0.584546814,0.415453186,0.251827141
Colorado,ADAMS,442996,235991,12970,167556,207005,0.532715871,0.467284129,0.378233664
Colorado,ALAMOSA,15750,7767,110,7185,7983,0.493142857,0.506857143,0.456190476
Colorado,ARAPAHOE,574357,364766,55629,105174,209591,0.635085844,0.364914156,0.183116076
Colorado,ARCHULETA,12109,9493,9,2157,2616,0.783962342,0.216037658,0.178131968
Colorado,BACA,3783,3311,16,347,472,0.875231298,0.124768702,0.091726143
Colorado,BENT,6192,3445,525,1908,2747,0.556363049,0.443636951,0.308139535
Colorado,BOULDER,297218,235676,2230,39475,61542,0.792939862,0.207060138,0.132814971
Colorado,BROOMFIELD,55913,44218,413,6380,11695,0.790835763,0.209164237,0.114105843
Colorado,CHAFFEE,17879,15439,500,1722,2440,0.863527043,0.136472957,0.096314112
Colorado,CHEYENNE,2095,1761,5,308,334,0.840572792,0.159427208,0.147016706
Colorado,CLEAR CREEK,9059,8327,27,453,732,0.919196379,0.080803621,0.050005519
Colorado,CONEJOS,8241,3490,6,4584,4751,0.423492295,0.576507705,0.556243174
Colorado,COSTILLA,3556,1105,12,2333,2451,0.310742407,0.689257593,0.656074241
Colorado,CROWLEY,5747,3436,441,1673,2311,0.597877153,0.402122847,0.291108404
Colorado,CUSTER,4208,3976,34,152,232,0.94486692,0.05513308,0.036121673
Colorado,DELTA,30710,25460,306,4310,5250,0.829045913,0.170954087,0.140345164
Colorado,DENVER,604356,315700,59347,192012,288656,0.52237423,0.47762577,0.317713401
Colorado,DOLORES,1806,1693,0,68,113,0.937430786,0.062569214,0.03765227
Colorado,DOUGLAS,286883,244370,3010,21771,42513,0.851810668,0.148189332,0.07588808
Colorado,EAGLE,51850,34932,156,15484,16918,0.673712633,0.326287367,0.298630665
Colorado,ELBERT,23058,20841,73,1280,2217,0.903851158,0.096148842,0.055512187
Colorado,EL PASO,622816,448325,35389,93837,174491,0.719835393,0.280164607,0.150665686
Colorado,FREMONT,47006,36270,2736,5839,10736,0.771603625,0.228396375,0.124218185
Colorado,GARFIELD,56330,38992,267,15743,17338,0.692206639,0.307793361,0.279478076
Colorado,GILPIN,5358,4845,44,319,513,0.904255319,0.095744681,0.059537141
Colorado,GRAND,14608,13110,87,1095,1498,0.89745345,0.10254655,0.074958927
Colorado,GUNNISON,15385,13680,95,1280,1705,0.889177771,0.110822229,0.08319792
Colorado,HINSDALE,790,764,0,19,26,0.967088608,0.032911392,0.024050633
Colorado,HUERFANO,6730,3573,129,2391,3157,0.530906389,0.469093611,0.355274889
Colorado,JACKSON,1397,1257,4,126,140,0.899785254,0.100214746,0.090193271
Colorado,JEFFERSON,536095,427845,5201,77024,108250,0.798076833,0.201923167,0.143676028
Colorado,KIOWA,1393,1304,2,65,89,0.936109117,0.063890883,0.046661881
Colorado,KIT CARSON,8210,6307,259,1534,1903,0.768209501,0.231790499,0.186845311
Colorado,LAKE,7372,4432,75,2519,2940,0.601193706,0.398806294,0.341698318
Colorado,LA PLATA,51443,41297,186,6119,10146,0.802772,0.197228,0.118947184
Colorado,LARIMER,300870,253754,2285,31771,47116,0.843400804,0.156599196,0.105597102
Colorado,LAS ANIMAS,15385,8228,158,6459,7157,0.53480663,0.46519337,0.419824504
Colorado,LINCOLN,5443,4048,499,680,1395,0.743707514,0.256292486,0.124931104
Colorado,LOGAN,22541,18256,315,3542,4285,0.809901956,0.190098044,0.157135886
Colorado,MESA,146562,121714,822,19484,24848,0.830460829,0.169539171,0.132940326
Colorado,MINERAL,702,671,9,15,31,0.955840456,0.044159544,0.021367521
Colorado,MOFFAT,13547,11169,47,1918,2378,0.824462981,0.175537019,0.141581162
Colorado,MONTEZUMA,25424,19081,13,2865,6343,0.750511328,0.249488672,0.112688798
Colorado,MONTROSE,40994,31799,186,8037,9195,0.775698883,0.224301117,0.196053081
Colorado,MORGAN,28200,17399,701,9557,10801,0.616985816,0.383014184,0.338900709
Colorado,OTERO,18791,10592,72,7596,8199,0.563674099,0.436325901,0.40423607
Colorado,OURAY,4445,4284,0,91,161,0.963779528,0.036220472,0.020472441
Colorado,PARK,16168,14818,5,777,1350,0.916501732,0.083498268,0.048057892
Colorado,PHILLIPS,4380,3204,1,1103,1176,0.731506849,0.268493151,0.251826484
Colorado,PITKIN,17000,14919,85,1532,2081,0.877588235,0.122411765,0.090117647
Colorado,PROWERS,12539,7824,27,4432,4715,0.623973204,0.376026796,0.353457213
Colorado,PUEBLO,159072,85971,2736,65892,73101,0.54045338,0.45954662,0.41422752
Colorado,RIO BLANCO,6728,5780,48,691,948,0.859096314,0.140903686,0.102705113
Colorado,RIO GRANDE,11925,6523,69,5098,5402,0.547002096,0.452997904,0.427505241
Colorado,ROUTT,23385,21278,89,1535,2107,0.909899508,0.090100492,0.065640368
Colorado,SAGUACHE,6189,3413,20,2556,2776,0.551462272,0.448537728,0.41299079
Colorado,SAN JUAN,747,608,0,108,139,0.813922356,0.186077644,0.144578313
Colorado,SAN MIGUEL,7432,6559,1,664,873,0.882534984,0.117465016,0.08934338
Colorado,SEDGWICK,2389,1891,6,446,498,0.791544579,0.208455421,0.186688991
Colorado,SUMMIT,27753,22955,164,3836,4798,0.827117789,0.172882211,0.138219292
Colorado,TELLER,23163,20962,191,1248,2201,0.904977766,0.095022234,0.053879031
Colorado,WASHINGTON,4796,4262,20,431,534,0.888657214,0.111342786,0.089866555
Colorado,WELD,253552,171475,1969,71792,82077,0.676291254,0.323708746,0.283145075
Colorado,YUMA,10032,7823,15,2080,2209,0.779804625,0.220195375,0.207336523
Connecticut,FAIRFIELD,918892,608561,94363,155557,310331,0.66227696,0.33772304,0.169287577
Connecticut,HARTFORD,893504,589792,109539,137155,303712,0.660088819,0.339911181,0.153502391
Connecticut,LITCHFIELD,189277,172669,2050,8575,16608,0.912255583,0.087744417,0.045303972
Connecticut,MIDDLESEX,165639,142473,7161,7968,23166,0.860141633,0.139858367,0.048104613
Connecticut,NEW HAVEN,860995,580912,101036,129612,280083,0.674698459,0.325301541,0.15053746
Connecticut,NEW LONDON,273723,214365,13635,23331,59358,0.783145735,0.216854265,0.085235804
Connecticut,TOLLAND,152137,133125,4103,6655,19012,0.875033687,0.124966313,0.043743468
Connecticut,WINDHAM,118046,100538,2007,11332,17508,0.851684936,0.148315064,0.095996476
Delaware,KENT,162785,106146,38080,9521,56639,0.652062536,0.347937464,0.05848819
Delaware,NEW CASTLE,539665,332713,125637,46774,206952,0.616517654,0.383482346,0.086672287
Delaware,SUSSEX,197681,149227,24725,16935,48454,0.754887925,0.245112075,0.085668324
District of Columbia,DISTRICT OF COLUMBIA,605759,209183,305141,56259,396576,0.3453238,0.6546762,0.092873569
Florida,ALACHUA,247973,157819,49063,20924,90154,0.636436225,0.363563775,0.084380154
Florida,BAKER,27010,22231,3761,572,4779,0.823065531,0.176934469,0.021177342
Florida,BAY,168957,133734,17289,8171,35223,0.791526838,0.208473162,0.048361417
Florida,BRADFORD,28404,20966,5801,1030,7438,0.738135474,0.261864526,0.036262498
Florida,BREVARD,544019,421138,52630,44432,122881,0.774123698,0.225876302,0.081673618
Florida,BROWARD,1761993,766779,454977,444904,995214,0.435177098,0.564822902,0.252500436
Florida,CALHOUN,14639,11373,2119,755,3266,0.776897329,0.223102671,0.051574561
Florida,CHARLOTTE,160380,137481,8589,9496,22899,0.857220352,0.142779648,0.059209378
Florida,CITRUS,140805,126083,3976,6595,14722,0.895444054,0.104555946,0.046837825
Florida,CLAY,190891,146964,18621,14867,43927,0.769884384,0.230115616,0.077882142
Florida,COLLIER,323548,212451,20461,83512,111097,0.656629001,0.343370999,0.25811317
Florida,COLUMBIA,67546,50313,11778,3325,17233,0.744870163,0.255129837,0.049225713
Florida,DESOTO,34628,19422,4373,10360,15206,0.560875592,0.439124408,0.299179854
Florida,DIXIE,16301,14059,1504,342,2242,0.862462426,0.137537574,0.020980308
Florida,DUVAL,866431,489991,250078,65943,376440,0.565528011,0.434471989,0.076108773
Florida,ESCAMBIA,298864,197920,65923,14243,100944,0.662241019,0.337758981,0.047657128
Florida,FLAGLER,95987,73190,10359,8436,22797,0.762499088,0.237500912,0.087886901
Florida,FRANKLIN,11545,9170,1625,524,2375,0.794283239,0.205716761,0.045387614
Florida,GADSDEN,46823,15607,25873,4552,31216,0.333319095,0.666680905,0.09721718
Florida,GILCHRIST,16880,14849,900,810,2031,0.879680095,0.120319905,0.047985782
Florida,GLADES,12952,7976,1479,2702,4976,0.61581223,0.38418777,0.20861643
Florida,GULF,15796,11759,2917,685,4037,0.744428969,0.255571031,0.043365409
Florida,HAMILTON,14728,8067,5021,1293,6661,0.547732211,0.452267789,0.087791961
Florida,HARDEE,27347,13174,1931,11663,14173,0.481734742,0.518265258,0.426481881
Florida,HENDRY,38669,13517,5035,18946,25152,0.349556492,0.650443508,0.489953192
Florida,HERNANDO,172784,141604,8617,17986,31180,0.819543476,0.180456524,0.104095287
Florida,HIGHLANDS,98734,69671,8673,17175,29063,0.705643446,0.294356554,0.173952235
Florida,HILLSBOROUGH,1238365,665123,194233,307899,573242,0.537097705,0.462902295,0.24863348
Florida,HOLMES,19971,17672,1058,483,2299,0.88488308,0.11511692,0.024185068
Florida,INDIAN RIVER,138203,106966,12022,15501,31237,0.77397741,0.22602259,0.112161096
Florida,JACKSON,49589,32802,12861,2177,16787,0.661477344,0.338522656,0.043900865
Florida,JEFFERSON,14564,8400,5316,544,6164,0.576764625,0.423235375,0.037352376
Florida,LAFAYETTE,8668,6396,1320,906,2272,0.737886479,0.262113521,0.104522381
Florida,LAKE,297995,220445,28033,36397,77550,0.739760734,0.260239266,0.122139633
Florida,LEE,624155,441937,48799,114755,182218,0.708056492,0.291943508,0.183856574
Florida,LEON,276506,163519,82814,15695,112987,0.591375956,0.408624044,0.056761879
Florida,LEVY,40541,32725,3781,3016,7816,0.807207518,0.192792482,0.074393824
Florida,LIBERTY,8300,5861,1298,687,2439,0.706144578,0.293855422,0.082771084
Florida,MADISON,19187,10506,7303,911,8681,0.547558243,0.452441757,0.047480065
Florida,MANATEE,324834,238514,27419,47943,86320,0.73426427,0.26573573,0.147592309
Florida,MARION,331987,245439,39874,36335,86548,0.739303045,0.260696955,0.109447057
Florida,MARTIN,146497,117581,7549,17756,28916,0.802617118,0.197382882,0.121203847
Florida,MIAMI-DADE,2512219,395156,433889,1622824,2117063,0.157293612,0.842706388,0.645972346
Florida,MONROE,73475,52212,4491,15176,21263,0.710609051,0.289390949,0.206546444
Florida,NASSAU,73303,64073,4823,2432,9230,0.87408428,0.12591572,0.03317736
Florida,OKALOOSA,183400,140773,15691,12958,42627,0.76757361,0.23242639,0.070654308
Florida,OKEECHOBEE,39779,25979,3360,9548,13800,0.653083285,0.346916715,0.240026144
Florida,ORANGE,1153795,527132,227103,312106,626663,0.456867988,0.543132012,0.270503859
Florida,OSCEOLA,272355,109155,25639,124711,163200,0.400782068,0.599217932,0.457898698
Florida,PALM BEACH,1324085,795020,222819,252510,529065,0.600429731,0.399570269,0.190705279
Florida,PASCO,465276,371569,19335,54841,93707,0.798599111,0.201400889,0.117867674
Florida,PINELLAS,917389,705264,92286,73378,212125,0.768773116,0.231226884,0.079985699
Florida,POLK,604562,389777,86356,107145,214785,0.644726265,0.355273735,0.17722748
Florida,PUTNAM,74224,53783,11972,6729,20441,0.724603902,0.275396098,0.090658008
Florida,ST. JOHNS,191495,163290,10016,10136,28205,0.852711559,0.147288441,0.052930886
Florida,ST. LUCIE,278246,170356,51043,46152,107890,0.612249592,0.387750408,0.165867614
Florida,SANTA ROSA,153086,129478,7824,6797,23608,0.845786029,0.154213971,0.04439988
Florida,SARASOTA,380479,322198,16707,30241,58281,0.846822032,0.153177968,0.079481391
Florida,SEMINOLE,423389,280375,44241,73066,143014,0.662216071,0.337783929,0.172574158
Florida,SUMTER,94240,77983,8945,5687,16257,0.827493633,0.172506367,0.060345925
Florida,SUWANNEE,42287,32415,4761,3678,9872,0.766547639,0.233452361,0.086977085
Florida,TAYLOR,22561,16462,4710,794,6099,0.729666238,0.270333762,0.035193475
Florida,UNION,15400,10958,3187,758,4442,0.711558442,0.288441558,0.049220779
Florida,VOLUSIA,495581,372109,50229,55845,123472,0.750854048,0.249145952,0.112685918
Florida,WAKULLA,30449,24378,4206,1000,6071,0.800617426,0.199382574,0.032841801
Florida,WALTON,55349,46855,3018,2910,8494,0.846537426,0.153462574,0.052575476
Florida,WASHINGTON,24732,19324,3550,757,5408,0.781335921,0.218664079,0.030608119
Georgia,APPLING,18279,12782,3563,1669,5497,0.699272389,0.300727611,0.091306964
Georgia,ATKINSON,8355,4734,1411,2023,3621,0.566606822,0.433393178,0.242130461
Georgia,BACON,11124,8419,1810,792,2705,0.756832075,0.243167925,0.071197411
Georgia,BAKER,3483,1485,1981,12,1998,0.426356589,0.573643411,0.003445306
Georgia,BALDWIN,46378,25135,19284,933,21243,0.54195955,0.45804045,0.020117297
Georgia,BANKS,18250,16348,507,1053,1902,0.895780822,0.104219178,0.05769863
Georgia,BARROW,69136,51593,8117,6120,17543,0.746253761,0.253746239,0.088521176
Georgia,BARTOW,99872,79645,9921,7599,20227,0.797470763,0.202529237,0.076087392
Georgia,BEN HILL,17612,10102,6238,1034,7510,0.573586191,0.426413809,0.05870997
Georgia,BERRIEN,19131,15800,2126,894,3331,0.82588469,0.17411531,0.046730438
Georgia,BIBB,155560,65642,79626,4469,89918,0.421972229,0.578027771,0.028728465
Georgia,BLECKLEY,13009,8924,3658,60,4085,0.685986625,0.314013375,0.004612192
Georgia,BRANTLEY,18279,17035,743,361,1244,0.931943761,0.068056239,0.019749439
Georgia,BROOKS,16066,9359,5669,836,6707,0.582534545,0.417465455,0.052035354
Georgia,BRYAN,30616,23589,4193,1462,7027,0.770479488,0.229520512,0.047752809
Georgia,BULLOCH,70360,45910,19262,2448,24450,0.652501421,0.347498579,0.034792496
Georgia,BURKE,23242,10831,11493,621,12411,0.46600981,0.53399019,0.026718871
Georgia,BUTTS,23671,16107,6749,620,7564,0.680452875,0.319547125,0.026192387
Georgia,CALHOUN,6581,2193,3924,348,4388,0.333232032,0.666767968,0.052879502
Georgia,CAMDEN,50435,35958,9642,2622,14477,0.712957272,0.287042728,0.051987707
Georgia,CANDLER,11007,6908,2665,1230,4099,0.627600618,0.372399382,0.11174707
Georgia,CARROLL,110750,80843,20020,6832,29907,0.729959368,0.270040632,0.061688488
Georgia,CATOOSA,64226,59264,1534,1515,4962,0.922741569,0.077258431,0.023588578
Georgia,CHARLTON,12954,8281,3121,1484,4673,0.639262004,0.360737996,0.11455921
Georgia,CHATHAM,266344,134167,106489,14426,132177,0.50373577,0.49626423,0.054163037
Georgia,CHATTAHOOCHEE,11917,7306,2324,1556,4611,0.61307376,0.38692624,0.130569774
Georgia,CHATTOOGA,25905,21477,2875,1073,4428,0.829067748,0.170932252,0.041420575
Georgia,CHEROKEE,215014,174655,11712,20670,40359,0.812295944,0.187704056,0.096133275
Georgia,CLARKE,117762,67434,30677,12213,50328,0.572629541,0.427370459,0.103709176
Georgia,CLAY,3174,1101,1999,6,2073,0.346880907,0.653119093,0.001890359
Georgia,CLAYTON,262066,38282,168882,34960,223784,0.146077706,0.853922294,0.13340151
Georgia,CLINCH,6800,4557,1910,227,2243,0.670147059,0.329852941,0.033382353
Georgia,COBB,691820,389770,169946,84703,302050,0.563397994,0.436602006,0.122435026
Georgia,COFFEE,42566,25576,11621,4379,16990,0.600855143,0.399144857,0.102875534
Georgia,COLQUITT,45531,26591,10379,7769,18940,0.584019679,0.415980321,0.170630999
Georgia,COLUMBIA,124665,91724,18819,6293,32941,0.735763847,0.264236153,0.050479284
Georgia,COOK,17073,11052,4762,1014,6021,0.647337902,0.352662098,0.059392022
Georgia,COWETA,127212,92386,22246,8443,34826,0.726236519,0.273763481,0.066369525
Georgia,CRAWFORD,12701,9266,2985,91,3435,0.729548854,0.270451146,0.00716479
Georgia,CRISP,23460,12123,10224,750,11337,0.516751918,0.483248082,0.031969309
Georgia,DADE,16598,15731,211,302,867,0.947764791,0.052235209,0.018194963
Georgia,DAWSON,22246,20718,42,869,1528,0.931313495,0.068686505,0.039063202
Georgia,DECATUR,27815,14437,11539,1428,13378,0.519036491,0.480963509,0.051339205
Georgia,DEKALB,694671,205863,373339,66469,488808,0.29634604,0.70365396,0.095684144
Georgia,DODGE,21509,14083,6452,733,7426,0.654749175,0.345250825,0.034078758
Georgia,DOOLY,14528,6289,7279,879,8239,0.432888216,0.567111784,0.060503855
Georgia,DOUGHERTY,94591,27323,63207,2187,67268,0.288854119,0.711145881,0.023120593
Georgia,DOUGLAS,132124,65022,51089,10990,67102,0.492128606,0.507871394,0.083179437
Georgia,EARLY,10928,5182,5545,73,5746,0.474194729,0.525805271,0.006680088
Georgia,ECHOLS,4024,2814,85,1100,1210,0.699304175,0.300695825,0.273359841
Georgia,EFFINGHAM,52203,42247,7086,1515,9956,0.809282991,0.190717009,0.029021321
Georgia,ELBERT,20103,12893,6040,999,7210,0.641347063,0.358652937,0.049694076
Georgia,EMANUEL,22600,13683,7600,981,8917,0.605442478,0.394557522,0.04340708
Georgia,EVANS,10935,6224,3158,1363,4711,0.569181527,0.430818473,0.124645633
Georgia,FANNIN,23554,22596,65,435,958,0.959327503,0.040672497,0.018468201
Georgia,FAYETTE,106525,72369,20754,6668,34156,0.679361652,0.320638348,0.062595635
Georgia,FLOYD,96204,70593,13727,8999,25611,0.733784458,0.266215542,0.093540809
Georgia,FORSYTH,177103,141915,4593,16583,35188,0.80131336,0.19868664,0.093634778
Georgia,FRANKLIN,22070,18871,1922,850,3199,0.855052107,0.144947893,0.03851382
Georgia,FULTON,929535,381418,406752,72356,548117,0.410332048,0.589667952,0.077841071
Georgia,GILMER,28232,24947,106,2763,3285,0.883642675,0.116357325,0.097867668
Georgia,GLASCOCK,3082,2746,243,14,336,0.890979883,0.109020117,0.004542505
Georgia,GLYNN,79628,51676,20277,5032,27952,0.6489677,0.3510323,0.063193851
Georgia,GORDON,55192,43995,2170,7789,11197,0.797126395,0.202873605,0.141125525
Georgia,GRADY,25068,14879,7253,2554,10189,0.593545556,0.406454444,0.101882879
Georgia,GREENE,15988,8810,6018,906,7178,0.551038279,0.448961721,0.056667501
Georgia,GWINNETT,810624,357549,184809,162252,453075,0.441078725,0.558921275,0.200156916
Georgia,HABERSHAM,43038,34544,1726,5356,8494,0.802639528,0.197360472,0.124448162
Georgia,HALL,180831,114963,12971,47315,65868,0.635748295,0.364251705,0.261653146
Georgia,HANCOCK,9422,2225,7038,112,7197,0.236149437,0.763850563,0.011887073
Georgia,HARALSON,28627,26156,1380,339,2471,0.913682887,0.086317113,0.011841967
Georgia,HARRIS,31870,24612,5529,886,7258,0.772262316,0.227737684,0.027800439
Georgia,HART,25277,19233,4994,799,6044,0.760889346,0.239110654,0.031609764
Georgia,HEARD,11756,10069,1372,106,1687,0.856498809,0.143501191,0.009016672
Georgia,HENRY,203185,107064,72900,11797,96121,0.526928661,0.473071339,0.058060388
Georgia,HOUSTON,140699,85051,39909,8553,55648,0.604489016,0.395510984,0.060789345
Georgia,IRWIN,9646,6716,2794,99,2930,0.696247149,0.303752851,0.010263322
Georgia,JACKSON,60268,50330,4272,3761,9938,0.835103206,0.164896794,0.062404593
Georgia,JASPER,13786,9965,2930,525,3821,0.72283476,0.27716524,0.038082112
Georgia,JEFF DAVIS,14972,11009,2279,1539,3963,0.735305904,0.264694096,0.102791878
Georgia,JEFFERSON,16817,6970,9638,101,9847,0.414461557,0.585538443,0.006005827
Georgia,JENKINS,8477,4636,3028,602,3841,0.546891589,0.453108411,0.07101569
Georgia,JOHNSON,9981,6183,3519,51,3798,0.619477006,0.380522994,0.005109708
Georgia,JONES,28638,20699,7187,333,7939,0.72278092,0.27721908,0.011627907
Georgia,LAMAR,18151,11818,5655,360,6333,0.651093604,0.348906396,0.019833618
Georgia,LANIER,10066,6861,2392,468,3205,0.681601431,0.318398569,0.046493145
Georgia,LAURENS,48264,28885,17292,1101,19379,0.598479198,0.401520802,0.022812034
Georgia,LEE,28449,21463,5382,589,6986,0.754437766,0.245562234,0.020703715
Georgia,LIBERTY,64663,27845,26334,6612,36818,0.4306172,0.5693828,0.102253221
Georgia,LINCOLN,7962,5174,2595,18,2788,0.649836724,0.350163276,0.002260739
Georgia,LONG,14488,8587,3656,1722,5901,0.592697405,0.407302595,0.118856985
Georgia,LOWNDES,109730,61240,39166,5311,48490,0.558097148,0.441902852,0.04840062
Georgia,LUMPKIN,30040,27546,426,1367,2494,0.916977364,0.083022636,0.045505992
Georgia,MCDUFFIE,21762,12216,8808,486,9546,0.561345465,0.438654535,0.022332506
Georgia,MCINTOSH,14119,8551,4978,189,5568,0.605637793,0.394362207,0.013386217
Georgia,MACON,14552,4747,8839,535,9805,0.326209456,0.673790544,0.036764706
Georgia,MADISON,27988,24015,2232,1119,3973,0.858046306,0.141953694,0.039981421
Georgia,MARION,8615,5004,2854,567,3611,0.580847359,0.419152641,0.065815438
Georgia,MERIWETHER,21966,12536,8815,357,9430,0.570700173,0.429299827,0.01625239
Georgia,MILLER,6094,4183,1822,33,1911,0.686412865,0.313587135,0.005415162
Georgia,MITCHELL,23510,10895,11305,1023,12615,0.463419821,0.536580179,0.043513399
Georgia,MONROE,26376,18946,6292,560,7430,0.718304519,0.281695481,0.021231423
Georgia,MONTGOMERY,9054,6084,2416,501,2970,0.671968191,0.328031809,0.055334659
Georgia,MORGAN,17919,12791,4440,486,5128,0.713823316,0.286176684,0.027122049
Georgia,MURRAY,39635,33494,259,5269,6141,0.845061183,0.154938817,0.13293806
Georgia,MUSCOGEE,191278,83577,85175,12423,107701,0.436939951,0.563060049,0.064947354
Georgia,NEWTON,100047,52297,39473,4598,47750,0.52272432,0.47727568,0.0459584
Georgia,OCONEE,32814,28271,1600,1440,4543,0.861552996,0.138447004,0.043883708
Georgia,OGLETHORPE,14745,11320,2443,547,3425,0.76771787,0.23228213,0.037097321
Georgia,PAULDING,141846,106510,24061,7246,35336,0.750884762,0.249115238,0.05108357
Georgia,PEACH,27531,12321,12611,1879,15210,0.447531873,0.552468127,0.068250336
Georgia,PICKENS,29445,27794,368,832,1651,0.94392936,0.05607064,0.028256071
Georgia,PIERCE,18631,15768,1687,872,2863,0.846331383,0.153668617,0.046803714
Georgia,PIKE,17765,15356,1899,199,2409,0.864396285,0.135603715,0.011201801
Georgia,POLK,41350,30307,5267,4941,11043,0.732938331,0.267061669,0.11949214
Georgia,PULASKI,11801,7438,3700,587,4363,0.630285569,0.369714431,0.049741547
Georgia,PUTNAM,21184,13965,5697,1319,7219,0.659223943,0.340776057,0.062263973
Georgia,QUITMAN,2542,1176,1344,0,1366,0.462627852,0.537372148,0
Georgia,RABUN,16297,14502,181,1275,1795,0.889857029,0.110142971,0.078235258
Georgia,RANDOLPH,7596,2820,4424,36,4776,0.371248025,0.628751975,0.004739336
Georgia,RICHMOND,200337,75900,107168,8322,124437,0.378861618,0.621138382,0.041540005
Georgia,ROCKDALE,85008,35114,38459,8121,49894,0.413067005,0.586932995,0.095532185
Georgia,SCHLEY,4963,3084,1420,311,1879,0.621398348,0.378601652,0.062663711
Georgia,SCREVEN,14574,7875,6416,100,6699,0.540345821,0.459654179,0.006861534
Georgia,SEMINOLE,8815,5549,2944,228,3266,0.629495179,0.370504821,0.025865003
Georgia,SPALDING,63979,38923,21018,2480,25056,0.608371497,0.391628503,0.038762719
Georgia,STEPHENS,26003,21809,3013,645,4194,0.838710918,0.161289082,0.02480483
Georgia,STEWART,5991,1664,3722,576,4327,0.277749958,0.722250042,0.096144216
Georgia,SUMTER,32425,13209,16640,1709,19216,0.407370856,0.592629144,0.052706245
Georgia,TALBOT,6772,2602,4069,24,4170,0.384229179,0.615770821,0.003544005
Georgia,TALIAFERRO,1674,692,930,29,982,0.413381123,0.586618877,0.017323775
Georgia,TATTNALL,25023,14896,7127,2554,10127,0.595292331,0.404707669,0.102066099
Georgia,TAYLOR,8700,5027,3474,165,3673,0.577816092,0.422183908,0.018965517
Georgia,TELFAIR,16312,8318,5846,2049,7994,0.509931339,0.490068661,0.125613046
Georgia,TERRELL,9365,3366,5698,165,5999,0.359423385,0.640576615,0.017618793
Georgia,THOMAS,44715,26016,16582,1327,18699,0.581818182,0.418181818,0.029676842
Georgia,TIFT,40430,23296,11978,4117,17134,0.576205788,0.423794212,0.101830324
Georgia,TOOMBS,27270,16707,6762,3076,10563,0.612651265,0.387348735,0.112797946
Georgia,TOWNS,10491,10094,128,208,397,0.96215804,0.03784196,0.019826518
Georgia,TREUTLEN,6851,4574,1958,36,2277,0.667639761,0.332360239,0.005254707
Georgia,TROUP,67146,40432,22555,2195,26714,0.602150538,0.397849462,0.032689959
Georgia,TURNER,8834,4819,3632,310,4015,0.545506,0.454494,0.035091691
Georgia,TWIGGS,8984,4969,3823,76,4015,0.55309439,0.44690561,0.008459484
Georgia,UNION,21344,20262,205,525,1082,0.949306597,0.050693403,0.024597076
Georgia,UPSON,27061,18470,7559,606,8591,0.682532057,0.317467943,0.022393851
Georgia,WALKER,68463,62963,2886,1125,5500,0.919664636,0.080335364,0.016432233
Georgia,WALTON,83771,65582,12733,2826,18189,0.782872354,0.217127646,0.033734825
Georgia,WARE,36099,23488,10715,1218,12611,0.650655143,0.349344857,0.033740547
Georgia,WARREN,5788,2141,3509,2,3647,0.369903248,0.630096752,0.000345543
Georgia,WASHINGTON,21092,9304,11170,407,11788,0.441115115,0.558884885,0.019296416
Georgia,WAYNE,30157,21747,6214,1747,8410,0.721126107,0.278873893,0.057930165
Georgia,WEBSTER,2773,1547,1073,39,1226,0.557879553,0.442120447,0.01406419
Georgia,WHEELER,7572,4400,3079,68,3172,0.58108822,0.41891178,0.008980454
Georgia,WHITE,27141,25425,616,660,1716,0.936774621,0.063225379,0.024317453
Georgia,WHITFIELD,102152,63308,3659,32577,38844,0.619743128,0.380256872,0.318907119
Georgia,WILCOX,9142,5470,3316,188,3672,0.598337344,0.401662656,0.020564428
Georgia,WILKES,10398,5418,4382,360,4980,0.521061743,0.478938257,0.034622043
Georgia,WILKINSON,9577,5528,3746,213,4049,0.577216247,0.422783753,0.022240785
Georgia,WORTH,21746,14913,6114,378,6833,0.685781293,0.314218707,0.017382507
Hawaii,HAWAII,185399,57553,1032,21529,127846,0.31042778,0.68957222,0.116122525
Hawaii,HONOLULU,955215,182951,18948,79173,772264,0.191528609,0.808471391,0.082885005
Hawaii,KALAWAO,66,38,0,1,28,0.575757576,0.424242424,0.015151515
Hawaii,KAUAI,67113,20507,319,6415,46606,0.305559281,0.694440719,0.095585058
Hawaii,MAUI,154937,49318,527,15764,105619,0.318310023,0.681689977,0.10174458
Idaho,ADA,394961,340935,3965,28186,54026,0.863211811,0.136788189,0.071364008
Idaho,ADAMS,3976,3765,0,43,211,0.94693159,0.05306841,0.010814889
Idaho,BANNOCK,82584,71284,547,5658,11300,0.863169621,0.136830379,0.06851206
Idaho,BEAR LAKE,5977,5653,22,218,324,0.945792203,0.054207797,0.036473147
Idaho,BENEWAH,9247,7848,139,243,1399,0.848707689,0.151292311,0.026278793
Idaho,BINGHAM,45312,34061,113,7772,11251,0.751699329,0.248300671,0.171521893
Idaho,BLAINE,21323,16666,8,4241,4657,0.781597336,0.218402664,0.198893214
Idaho,BOISE,7014,6536,31,250,478,0.931850585,0.068149415,0.035643
Idaho,BONNER,40806,38560,90,932,2246,0.944959075,0.055040925,0.022839778
Idaho,BONNEVILLE,104177,88847,475,11864,15330,0.852846598,0.147153402,0.113883103
Idaho,BOUNDARY,10857,9972,0,425,885,0.91848577,0.08151423,0.039145252
Idaho,BUTTE,2828,2639,3,108,189,0.933168317,0.066831683,0.038189533
Idaho,CAMAS,1276,1071,6,145,205,0.839341693,0.160658307,0.113636364
Idaho,CANYON,189396,137163,544,45038,52233,0.724212761,0.275787239,0.237798053
Idaho,CARIBOU,6872,6387,7,332,485,0.929423749,0.070576251,0.048311991
Idaho,CASSIA,22813,16588,102,5703,6225,0.727129268,0.272870732,0.249989041
Idaho,CLARK,780,387,0,393,393,0.496153846,0.503846154,0.503846154
Idaho,CLEARWATER,8679,7988,25,269,691,0.920382533,0.079617467,0.030994354
Idaho,CUSTER,4338,4150,0,112,188,0.956662056,0.043337944,0.025818349
Idaho,ELMORE,26655,19921,626,4090,6734,0.747364472,0.252635528,0.153442131
Idaho,FRANKLIN,12739,11692,23,839,1047,0.917811445,0.082188555,0.065860743
Idaho,FREMONT,13123,11200,5,1654,1923,0.853463385,0.146536615,0.126038253
Idaho,GEM,16768,14888,2,1333,1880,0.887881679,0.112118321,0.07949666
Idaho,GOODING,15327,10730,2,4244,4597,0.700071769,0.299928231,0.276896979
Idaho,IDAHO,16215,14980,19,434,1235,0.923835954,0.076164046,0.026765341
Idaho,JEFFERSON,25940,22732,32,2650,3208,0.876329992,0.123670008,0.102158828
Idaho,JEROME,22140,14794,31,6861,7346,0.668202349,0.331797651,0.309891599
Idaho,KOOTENAI,139083,127952,277,5331,11131,0.919968652,0.080031348,0.038329631
Idaho,LATAH,37365,33877,247,1321,3488,0.906650609,0.093349391,0.035353941
Idaho,LEMHI,7892,7473,35,189,419,0.946908262,0.053091738,0.023948302
Idaho,LEWIS,3818,3398,0,133,420,0.889994762,0.110005238,0.034834992
Idaho,LINCOLN,5167,3593,30,1443,1574,0.695374492,0.304625508,0.279272305
Idaho,MADISON,37311,33806,209,2216,3505,0.906059875,0.093940125,0.059392672
Idaho,MINIDOKA,19909,13037,12,6415,6872,0.654829474,0.345170526,0.322216083
Idaho,NEZ PERCE,39226,34756,112,1133,4470,0.88604497,0.11395503,0.028883904
Idaho,ONEIDA,4236,4023,0,78,213,0.949716714,0.050283286,0.018413598
Idaho,OWYHEE,11479,7878,0,2931,3601,0.686296716,0.313703284,0.255335831
Idaho,PAYETTE,22614,18361,15,3372,4253,0.811930662,0.188069338,0.14911117
Idaho,POWER,7717,5275,0,2288,2442,0.683555786,0.316444214,0.296488273
Idaho,SHOSHONE,12797,11944,17,395,853,0.933343752,0.066656248,0.030866609
Idaho,TETON,10007,8176,0,1646,1831,0.81702808,0.18297192,0.164484861
Idaho,TWIN FALLS,77122,63886,350,10509,13236,0.82837582,0.17162418,0.13626462
Idaho,VALLEY,9793,9164,0,381,629,0.935770448,0.064229552,0.038905341
Idaho,WASHINGTON,10144,8130,0,1694,2014,0.801458991,0.198541009,0.166995268
Illinois,ADAMS,67098,62414,2411,822,4684,0.93019166,0.06980834,0.012250738
Illinois,ALEXANDER,8147,4918,2833,157,3229,0.603657788,0.396342212,0.019270897
Illinois,BOND,17762,15766,514,544,1996,0.887625267,0.112374733,0.030627182
Illinois,BOONE,54141,40754,1141,10922,13387,0.752738221,0.247261779,0.201732513
Illinois,BROWN,6913,5166,994,420,1747,0.747287719,0.252712281,0.060755099
Illinois,BUREAU,34798,31294,221,2703,3504,0.899304558,0.100695442,0.077676878
Illinois,CALHOUN,5065,4977,3,13,88,0.982625864,0.017374136,0.002566634
Illinois,CARROLL,15338,14533,59,447,805,0.947515973,0.052484027,0.029143304
Illinois,CASS,13570,10797,423,2260,2773,0.795652174,0.204347826,0.166543847
Illinois,CHAMPAIGN,200931,142369,24924,10566,58562,0.708546715,0.291453285,0.052585216
Illinois,CHRISTIAN,34805,33278,501,491,1527,0.956126993,0.043873007,0.014107169
Illinois,CLARK,16353,15926,64,181,427,0.973888583,0.026111417,0.011068306
Illinois,CLAY,13828,13404,86,61,424,0.969337576,0.030662424,0.004411339
Illinois,CLINTON,37793,34797,1286,1049,2996,0.92072606,0.07927394,0.027756463
Illinois,COLES,53683,49208,1963,1163,4475,0.916640277,0.083359723,0.021664214
Illinois,COOK,5197677,2277287,1267825,1245329,2920390,0.438135536,0.561864464,0.23959338
Illinois,CRAWFORD,19777,18175,569,371,1602,0.918996814,0.081003186,0.018759165
Illinois,CUMBERLAND,11044,10808,56,62,236,0.978630931,0.021369069,0.005613908
Illinois,DEKALB,104820,83423,6395,10655,21397,0.795869109,0.204130891,0.101650448
Illinois,DE WITT,16562,15878,217,344,684,0.95870064,0.04129936,0.020770438
Illinois,DOUGLAS,19908,18328,82,1240,1580,0.920634921,0.079365079,0.062286518
Illinois,DUPAGE,918608,645537,40620,122069,273071,0.702733919,0.297266081,0.132884756
Illinois,EDGAR,18513,18057,64,196,456,0.97536866,0.02463134,0.010587155
Illinois,EDWARDS,6691,6523,63,0,168,0.974891645,0.025108355,0
Illinois,EFFINGHAM,34258,33115,87,587,1143,0.96663553,0.03336447,0.017134684
Illinois,FAYETTE,22082,20522,397,313,1560,0.929354225,0.070645775,0.014174441
Illinois,FORD,14045,13453,75,319,592,0.957849769,0.042150231,0.022712709
Illinois,FRANKLIN,39518,38260,69,496,1258,0.968166405,0.031833595,0.012551242
Illinois,FULTON,36989,34272,1260,885,2717,0.92654573,0.07345427,0.023926032
Illinois,GALLATIN,5592,5422,23,21,170,0.969599428,0.030400572,0.003755365
Illinois,GREENE,13828,13139,177,119,689,0.950173561,0.049826439,0.008605728
Illinois,GRUNDY,49870,44302,535,4112,5568,0.888349709,0.111650291,0.082454381
Illinois,HAMILTON,8430,8269,21,106,161,0.980901542,0.019098458,0.01257414
Illinois,HANCOCK,19063,18566,60,198,497,0.973928553,0.026071447,0.010386613
Illinois,HARDIN,4315,4117,32,22,198,0.954113557,0.045886443,0.005098494
Illinois,HENDERSON,7275,6993,21,80,282,0.961237113,0.038762887,0.010996564
Illinois,HENRY,50378,46030,785,2444,4348,0.913692485,0.086307515,0.04851324
Illinois,IROQUOIS,29689,27339,320,1645,2350,0.920846105,0.079153895,0.055407727
Illinois,JACKSON,59992,45440,8486,2398,14552,0.757434325,0.242565675,0.039971996
Illinois,JASPER,9707,9508,6,88,199,0.97949933,0.02050067,0.009065623
Illinois,JEFFERSON,38908,33900,3094,827,5008,0.871286111,0.128713889,0.021255269
Illinois,JERSEY,22939,22230,153,227,709,0.969091939,0.030908061,0.009895811
Illinois,JO DAVIESS,22663,21636,114,628,1027,0.954683846,0.045316154,0.027710365
Illinois,JOHNSON,12653,11057,1187,264,1596,0.873863906,0.126136094,0.020864617
Illinois,KANE,514891,304876,27215,157032,210015,0.592117555,0.407882445,0.304981054
Illinois,KANKAKEE,113170,83125,16730,10056,30045,0.734514447,0.265485553,0.088857471
Illinois,KENDALL,114226,84645,5977,18090,29581,0.741030939,0.258969061,0.158370248
Illinois,KNOX,52698,44811,4119,2580,7887,0.850335876,0.149664124,0.048958215
Illinois,LAKE,701282,457261,45982,139349,244021,0.652035843,0.347964157,0.198706084
Illinois,LASALLE,113688,100253,1879,9145,13435,0.881825698,0.118174302,0.080439448
Illinois,LAWRENCE,16778,12063,3635,835,4715,0.718977232,0.281022768,0.049767553
Illinois,LEE,35778,31605,1583,1796,4173,0.883364078,0.116635922,0.050198446
Illinois,LIVINGSTON,38903,34380,2332,1555,4523,0.883736473,0.116263527,0.03997121
Illinois,LOGAN,30278,25078,3552,898,5200,0.828258141,0.171741859,0.029658498
Illinois,MCDONOUGH,32568,28905,1606,858,3663,0.887527634,0.112472366,0.026344878
Illinois,MCHENRY,308163,257757,3352,35265,50406,0.83643072,0.16356928,0.114436191
Illinois,MCLEAN,169689,138890,11960,7441,30799,0.818497369,0.181502631,0.043850809
Illinois,MACON,110558,86694,17540,2070,23864,0.784149496,0.215850504,0.018723204
Illinois,MACOUPIN,47712,46238,291,427,1474,0.969106304,0.030893696,0.008949531
Illinois,MADISON,268586,232714,20946,7361,35872,0.866441289,0.133558711,0.027406492
Illinois,MARION,39319,36317,1275,567,3002,0.923650144,0.076349856,0.014420509
Illinois,MARSHALL,12567,12034,52,322,533,0.957587332,0.042412668,0.025622663
Illinois,MASON,14636,14257,135,120,379,0.974104947,0.025895053,0.008198961
Illinois,MASSAC,15370,13803,817,169,1567,0.898048146,0.101951854,0.010995446
Illinois,MENARD,12728,12328,93,124,400,0.968573224,0.031426776,0.0097423
Illinois,MERCER,16421,15891,87,303,530,0.967724256,0.032275744,0.018451982
Illinois,MONROE,33003,32041,73,456,962,0.970851135,0.029148865,0.013816926
Illinois,MONTGOMERY,29977,26983,2208,455,2994,0.900123428,0.099876572,0.015178303
Illinois,MORGAN,35544,31962,2207,722,3582,0.899223498,0.100776502,0.020312852
Illinois,MOULTRIE,14844,14510,58,139,334,0.977499326,0.022500674,0.009364053
Illinois,OGLE,53378,47339,457,4732,6039,0.886863502,0.113136498,0.088650755
Illinois,PEORIA,186399,135536,32903,7150,50863,0.727128364,0.272871636,0.038358575
Illinois,PERRY,22287,19346,1926,610,2941,0.868039664,0.131960336,0.027370216
Illinois,PIATT,16679,16223,73,169,456,0.972660231,0.027339769,0.010132502
Illinois,PIKE,16436,15803,225,175,633,0.96148698,0.03851302,0.010647359
Illinois,POPE,4399,4017,199,106,382,0.913162082,0.086837918,0.024096386
Illinois,PULASKI,6107,3882,2037,99,2225,0.635663992,0.364336008,0.016210906
Illinois,PUTNAM,5968,5603,40,262,365,0.938840483,0.061159517,0.043900804
Illinois,RANDOLPH,33353,28833,3228,862,4520,0.864479957,0.135520043,0.025844752
Illinois,RICHLAND,16181,15588,59,131,593,0.96335208,0.03664792,0.008095915
Illinois,ROCK ISLAND,147504,111511,12932,17087,35993,0.755986278,0.244013722,0.115840926
Illinois,ST. CLAIR,268873,169352,80973,8842,99521,0.629858707,0.370141293,0.032885414
Illinois,SALINE,24975,23047,954,351,1928,0.922802803,0.077197197,0.014054054
Illinois,SANGAMON,197474,162849,23438,3551,34625,0.824660462,0.175339538,0.017982114
Illinois,SCHUYLER,7499,7112,72,105,387,0.948393119,0.051606881,0.014001867
Illinois,SCOTT,5322,5212,0,27,110,0.979331079,0.020668921,0.005073281
Illinois,SHELBY,22316,21852,72,191,464,0.979207743,0.020792257,0.008558882
Illinois,STARK,5983,5815,20,60,168,0.971920441,0.028079559,0.010028414
Illinois,STEPHENSON,47532,40536,4111,1368,6996,0.852814946,0.147185054,0.028780611
Illinois,TAZEWELL,135201,128394,1152,2560,6807,0.949652739,0.050347261,0.018934771
Illinois,UNION,17799,16436,344,862,1363,0.923422664,0.076577336,0.048429687
Illinois,VERMILION,81463,65363,10549,3471,16100,0.802364264,0.197635736,0.042608301
Illinois,WABASH,11935,11490,7,154,445,0.962714705,0.037285295,0.012903226
Illinois,WARREN,17723,15591,338,1454,2132,0.879704339,0.120295661,0.082040287
Illinois,WASHINGTON,14692,14214,125,201,478,0.967465287,0.032534713,0.013680915
Illinois,WAYNE,16727,16293,69,182,434,0.974053925,0.025946075,0.010880612
Illinois,WHITE,14686,14294,96,162,392,0.973307912,0.026692088,0.011030914
Illinois,WHITESIDE,58400,50184,717,6468,8216,0.859315068,0.140684932,0.110753425
Illinois,WILL,677669,455445,72989,105899,222224,0.672075895,0.327924105,0.156269506
Illinois,WILLIAMSON,66335,60710,2602,1314,5625,0.915203136,0.084796864,0.019808548
Illinois,WINNEBAGO,294433,213664,35652,32254,80769,0.725679526,0.274320474,0.109546145
Illinois,WOODFORD,38736,37337,226,546,1399,0.963883726,0.036116274,0.014095415
Indiana,ADAMS,34343,32447,123,1413,1896,0.944792243,0.055207757,0.041143756
Indiana,ALLEN,355940,271962,41703,23172,83978,0.764066978,0.235933022,0.06510086
Indiana,BARTHOLOMEW,77297,67084,1410,4737,10213,0.867873268,0.132126732,0.061283103
Indiana,BENTON,8816,8260,40,425,556,0.936932849,0.063067151,0.048207804
Indiana,BLACKFORD,12742,12356,48,131,386,0.969706482,0.030293518,0.010280961
Indiana,BOONE,56823,53171,610,1305,3652,0.93573025,0.06426975,0.022966052
Indiana,BROWN,15181,14683,24,186,498,0.967195837,0.032804163,0.012252157
Indiana,CARROLL,20105,19100,88,740,1005,0.950012435,0.049987565,0.036806764
Indiana,CASS,38875,32345,549,4888,6530,0.832025723,0.167974277,0.125736334
Indiana,CLARK,110100,93974,7530,5195,16126,0.853533152,0.146466848,0.047184378
Indiana,CLAY,26908,26159,56,303,749,0.972164412,0.027835588,0.011260592
Indiana,CLINTON,33179,28293,186,4426,4886,0.852738178,0.147261822,0.133397631
Indiana,CRAWFORD,10702,10357,52,130,345,0.967763035,0.032236965,0.012147262
Indiana,DAVIESS,31604,29651,187,1314,1953,0.938204025,0.061795975,0.041577016
Indiana,DEARBORN,49904,48306,338,505,1598,0.967978519,0.032021481,0.010119429
Indiana,DECATUR,25772,24830,88,421,942,0.963448704,0.036551296,0.016335558
Indiana,DEKALB,42218,40390,61,1046,1828,0.956700933,0.043299067,0.024776162
Indiana,DELAWARE,117459,103379,5475,2145,14080,0.880128385,0.119871615,0.018261691
Indiana,DUBOIS,41995,38855,181,2532,3140,0.925229194,0.074770806,0.060292892
Indiana,ELKHART,198214,152855,11140,28064,45359,0.771161472,0.228838528,0.141584348
Indiana,FAYETTE,24220,23314,293,230,906,0.962592898,0.037407102,0.009496284
Indiana,FLOYD,74601,66624,3334,1992,7977,0.893071138,0.106928862,0.026702055
Indiana,FOUNTAIN,17212,16570,54,375,642,0.962700442,0.037299558,0.021787125
Indiana,FRANKLIN,23108,22620,17,207,488,0.978881773,0.021118227,0.008957937
Indiana,FULTON,20762,19328,205,903,1434,0.930931509,0.069068491,0.04349292
Indiana,GIBSON,33437,31673,722,451,1764,0.947244071,0.052755929,0.013488052
Indiana,GRANT,69886,60522,4647,2526,9364,0.86601036,0.13398964,0.036144578
Indiana,GREENE,33032,32193,135,332,839,0.974600388,0.025399612,0.01005086
Indiana,HAMILTON,276098,238359,9152,9539,37739,0.863313027,0.136686973,0.034549327
Indiana,HANCOCK,69778,65619,1443,1210,4159,0.940396687,0.059603313,0.017340709
Indiana,HARRISON,39102,37746,196,592,1356,0.965321467,0.034678533,0.015139891
Indiana,HENDRICKS,145880,128737,7030,4399,17143,0.882485605,0.117514395,0.030154922
Indiana,HENRY,49381,46794,710,707,2587,0.947611429,0.052388571,0.014317248
Indiana,HOWARD,82914,72192,5857,2237,10722,0.870685288,0.129314712,0.026979762
Indiana,HUNTINGTON,37144,35695,187,661,1449,0.960989662,0.039010338,0.017795606
Indiana,JACKSON,42414,38861,125,2416,3553,0.91623049,0.08376951,0.056962324
Indiana,JASPER,33369,30946,236,1757,2423,0.927387695,0.072612305,0.052653661
Indiana,JAY,21353,20438,57,597,915,0.957148878,0.042851122,0.027958601
Indiana,JEFFERSON,32501,30520,672,723,1981,0.939048029,0.060951971,0.022245469
Indiana,JENNINGS,28373,27219,75,569,1154,0.95932753,0.04067247,0.020054277
Indiana,JOHNSON,140033,128765,1825,4297,11268,0.919533253,0.080466747,0.030685624
Indiana,KNOX,38392,36074,1052,603,2318,0.939622838,0.060377162,0.015706397
Indiana,KOSCIUSKO,77328,69391,460,5687,7937,0.897359301,0.102640699,0.073543865
Indiana,LAGRANGE,37284,35404,46,1348,1880,0.949576226,0.050423774,0.036154919
Indiana,LAKE,495230,273611,124204,82652,221619,0.552492781,0.447507219,0.16689619
Indiana,LAPORTE,111335,90579,11786,6053,20756,0.813571653,0.186428347,0.05436745
Indiana,LAWRENCE,46131,44425,210,576,1706,0.963018361,0.036981639,0.012486181
Indiana,MADISON,131244,113315,8802,4177,17929,0.86339185,0.13660815,0.031826217
Indiana,MARION,904535,540057,237264,83186,364478,0.59705484,0.40294516,0.091965485
Indiana,MARSHALL,47045,42037,205,4031,5008,0.89354873,0.10645127,0.08568392
Indiana,MARTIN,10300,10083,20,57,217,0.978932039,0.021067961,0.005533981
Indiana,MIAMI,36850,33281,1737,904,3569,0.903147897,0.096852103,0.024531886
Indiana,MONROE,138048,118580,4182,4064,19468,0.858976588,0.141023412,0.029439036
Indiana,MONTGOMERY,38207,35504,399,1677,2703,0.929253802,0.070746198,0.04389248
Indiana,MORGAN,69033,66883,194,831,2150,0.968855475,0.031144525,0.012037721
Indiana,NEWTON,14199,13234,37,729,965,0.932037467,0.067962533,0.051341644
Indiana,NOBLE,47547,42118,63,4579,5429,0.885818243,0.114181757,0.096304709
Indiana,OHIO,6093,5932,57,82,161,0.973576235,0.026423765,0.013458067
Indiana,ORANGE,19828,19120,263,197,708,0.964292919,0.035707081,0.009935445
Indiana,OWEN,21583,20984,100,200,599,0.972246676,0.027753324,0.009266552
Indiana,PARKE,17251,16462,390,212,789,0.954263521,0.045736479,0.012289143
Indiana,PERRY,19408,18469,506,198,939,0.95161789,0.04838211,0.010201979
Indiana,PIKE,12849,12765,4,12,84,0.993462526,0.006537474,0.000933925
Indiana,PORTER,164386,141314,4605,13958,23072,0.859647415,0.140352585,0.084909907
Indiana,POSEY,25840,24922,329,247,918,0.964473684,0.035526316,0.009558824
Indiana,PULASKI,13395,12794,33,333,601,0.955132512,0.044867488,0.024860022
Indiana,PUTNAM,37995,35161,1457,605,2834,0.925411238,0.074588762,0.015923148
Indiana,RANDOLPH,26101,24810,83,780,1291,0.950538294,0.049461706,0.029883912
Indiana,RIPLEY,28702,27754,97,454,948,0.966970943,0.033029057,0.015817713
Indiana,RUSH,17349,16806,139,193,543,0.968701366,0.031298634,0.01112456
Indiana,ST. JOSEPH,266785,201770,33676,19450,65015,0.756301891,0.243698109,0.072905148
Indiana,SCOTT,24044,23332,104,353,712,0.970387623,0.029612377,0.014681417
Indiana,SHELBY,44435,41481,488,1626,2954,0.933520873,0.066479127,0.036592776
Indiana,SPENCER,20948,20090,138,521,858,0.959041436,0.040958564,0.024871109
Indiana,STARKE,23310,22131,77,772,1179,0.949420849,0.050579151,0.033118833
Indiana,STEUBEN,34116,30936,264,1015,3180,0.906788604,0.093211396,0.029751436
Indiana,SULLIVAN,21379,19842,1049,302,1537,0.928107021,0.071892979,0.014126012
Indiana,SWITZERLAND,10509,10215,45,143,294,0.972023979,0.027976021,0.013607384
Indiana,TIPPECANOE,173317,139186,6604,13025,34131,0.803071828,0.196928172,0.075151312
Indiana,TIPTON,15917,15323,41,356,594,0.96268141,0.03731859,0.022366024
Indiana,UNION,7449,7211,42,31,238,0.968049403,0.031950597,0.004161632
Indiana,VANDERBURGH,179610,153301,16053,3869,26309,0.853521519,0.146478481,0.021541117
Indiana,VERMILLION,16224,15846,16,141,378,0.976701183,0.023298817,0.008690828
Indiana,VIGO,107805,93531,7107,2448,14274,0.867594267,0.132405733,0.022707667
Indiana,WABASH,32804,31277,219,694,1527,0.953450799,0.046549201,0.021155957
Indiana,WARREN,8490,8289,7,86,201,0.976325088,0.023674912,0.010129564
Indiana,WARRICK,59643,55974,499,938,3669,0.93848398,0.06151602,0.015726908
Indiana,WASHINGTON,28162,27442,125,316,720,0.974433634,0.025566366,0.011220794
Indiana,WAYNE,68797,61254,2193,1765,7543,0.890358591,0.109641409,0.025655188
Indiana,WELLS,27677,26623,148,585,1054,0.961917838,0.038082162,0.021136684
Indiana,WHITE,24612,22396,64,1725,2216,0.90996262,0.09003738,0.070087762
Indiana,WHITLEY,33234,32042,158,510,1192,0.964133117,0.035866883,0.01534573
Iowa,ADAIR,7628,7420,11,57,208,0.97273204,0.02726796,0.00747247
Iowa,ADAMS,4027,3918,12,53,109,0.972932704,0.027067296,0.013161162
Iowa,ALLAMAKEE,14285,13203,35,796,1082,0.924256213,0.075743787,0.055722786
Iowa,APPANOOSE,12858,12431,56,183,427,0.966791103,0.033208897,0.014232385
Iowa,AUDUBON,6077,5960,4,39,117,0.980747079,0.019252921,0.00641764
Iowa,BENTON,26044,25238,65,289,806,0.969052373,0.030947627,0.011096606
Iowa,BLACK HAWK,130843,109799,11643,4879,21044,0.839166023,0.160833977,0.037288965
Iowa,BOONE,26324,25225,236,509,1099,0.958251026,0.041748974,0.019335967
Iowa,BREMER,24294,23444,200,253,850,0.965011937,0.034988063,0.010414094
Iowa,BUCHANAN,20988,20368,124,256,620,0.97045931,0.02954069,0.012197446
Iowa,BUENA VISTA,20215,13672,467,4662,6543,0.676329458,0.323670542,0.230620826
Iowa,BUTLER,14899,14565,41,138,334,0.977582388,0.022417612,0.009262367
Iowa,CALHOUN,9936,9584,87,121,352,0.964573269,0.035426731,0.012177939
Iowa,CARROLL,20751,20030,85,353,721,0.965254687,0.034745313,0.017011228
Iowa,CASS,13865,13395,28,267,470,0.966101695,0.033898305,0.019257122
Iowa,CEDAR,18446,17833,16,288,613,0.966767863,0.033232137,0.015613141
Iowa,CERRO GORDO,44083,40824,386,1700,3259,0.926071275,0.073928725,0.038563619
Iowa,CHEROKEE,12011,11457,36,286,554,0.953875614,0.046124386,0.023811506
Iowa,CHICKASAW,12409,11990,25,270,419,0.966234185,0.033765815,0.021758401
Iowa,CLARKE,9286,8200,91,925,1086,0.883049752,0.116950248,0.09961232
Iowa,CLAY,16649,15828,48,472,821,0.950687729,0.049312271,0.028350051
Iowa,CLAYTON,18056,17490,62,308,566,0.968653079,0.031346921,0.017058042
Iowa,CLINTON,49074,45410,1382,1254,3664,0.925337246,0.074662754,0.025553246
Iowa,CRAWFORD,17100,12794,72,4137,4306,0.748187135,0.251812865,0.241929825
Iowa,DALLAS,66997,59214,823,4133,7783,0.883830619,0.116169381,0.061689329
Iowa,DAVIS,8718,8515,9,87,203,0.976714843,0.023285157,0.009979353
Iowa,DECATUR,8382,7873,148,190,509,0.939274636,0.060725364,0.022667621
Iowa,DELAWARE,17721,17364,18,145,357,0.97985441,0.02014559,0.008182382
Iowa,DES MOINES,40268,35962,2045,1079,4306,0.893066455,0.106933545,0.02679547
Iowa,DICKINSON,16778,16352,58,195,426,0.974609608,0.025390392,0.011622363
Iowa,DUBUQUE,93776,87277,1331,1813,6499,0.930696553,0.069303447,0.019333305
Iowa,EMMET,10263,9227,92,808,1036,0.899054857,0.100945143,0.078729416
Iowa,FAYETTE,20894,19964,186,392,930,0.955489614,0.044510386,0.018761367
Iowa,FLOYD,16204,15339,213,323,865,0.946618119,0.053381881,0.01993335
Iowa,FRANKLIN,10650,9311,19,1176,1339,0.8742723,0.1257277,0.110422535
Iowa,FREMONT,7373,7062,15,182,311,0.95781907,0.04218093,0.02468466
Iowa,GREENE,9304,8961,4,195,343,0.963134136,0.036865864,0.020958727
Iowa,GRUNDY,12431,12161,18,126,270,0.978280106,0.021719894,0.01013595
Iowa,GUTHRIE,10915,10545,32,207,370,0.966101695,0.033898305,0.018964727
Iowa,HAMILTON,15614,14305,52,761,1309,0.91616498,0.08383502,0.048738312
Iowa,HANCOCK,11320,10723,7,395,597,0.947261484,0.052738516,0.034893993
Iowa,HARDIN,17479,16386,128,644,1093,0.937467819,0.062532181,0.036844213
Iowa,HARRISON,14838,14427,15,185,411,0.972300849,0.027699151,0.012467988
Iowa,HENRY,20242,18199,409,781,2043,0.899071238,0.100928762,0.038583144
Iowa,HOWARD,9568,9316,73,80,252,0.973662207,0.026337793,0.008361204
Iowa,HUMBOLDT,9818,9304,13,347,514,0.947647179,0.052352821,0.035343247
Iowa,IDA,7113,6915,16,107,198,0.972163644,0.027836356,0.015042879
Iowa,IOWA,16320,15773,60,313,547,0.966482843,0.033517157,0.019178922
Iowa,JACKSON,19807,18427,133,227,1380,0.930327662,0.069672338,0.011460595
Iowa,JASPER,36823,35248,451,536,1575,0.95722782,0.04277218,0.01455612
Iowa,JEFFERSON,16791,14386,196,420,2405,0.856768507,0.143231493,0.0250134
Iowa,JOHNSON,131627,109500,6061,6249,22127,0.831896192,0.168103808,0.047475062
Iowa,JONES,20686,19734,350,274,952,0.953978536,0.046021464,0.013245673
Iowa,KEOKUK,10480,10241,32,104,239,0.977194656,0.022805344,0.009923664
Iowa,KOSSUTH,15510,15046,34,220,464,0.970083817,0.029916183,0.014184397
Iowa,LEE,35741,32684,1043,1107,3057,0.914467978,0.085532022,0.030972832
Iowa,LINN,211954,189055,8371,5628,22899,0.891962407,0.108037593,0.026552931
Iowa,LOUISA,11448,9288,110,1834,2160,0.811320755,0.188679245,0.160202655
Iowa,LUCAS,8913,8735,12,66,178,0.980029171,0.019970829,0.007404914
Iowa,LYON,11623,11289,3,224,334,0.971263873,0.028736127,0.019272133
Iowa,MADISON,15630,15175,90,198,455,0.970889315,0.029110685,0.012667946
Iowa,MAHASKA,22432,21292,169,377,1140,0.949179743,0.050820257,0.016806348
Iowa,MARION,33388,31894,185,535,1494,0.955253384,0.044746616,0.016023721
Iowa,MARSHALL,40568,31683,754,6982,8885,0.780985013,0.219014987,0.172106093
Iowa,MILLS,15028,14346,82,365,682,0.954618046,0.045381954,0.024287996
Iowa,MITCHELL,10761,10542,21,98,219,0.979648732,0.020351268,0.00910696
Iowa,MONONA,9242,8887,21,114,355,0.961588401,0.038411599,0.012334992
Iowa,MONROE,7979,7671,50,77,308,0.961398672,0.038601328,0.009650332
Iowa,MONTGOMERY,10710,10215,4,314,495,0.953781513,0.046218487,0.029318394
Iowa,MUSCATINE,42729,34520,486,6764,8209,0.807882235,0.192117765,0.158299984
Iowa,O'BRIEN,14302,13519,30,534,783,0.945252412,0.054747588,0.037337435
Iowa,OSCEOLA,6413,5920,41,393,493,0.923124903,0.076875097,0.061281771
Iowa,PAGE,15902,14724,353,446,1178,0.925921268,0.074078732,0.028046787
Iowa,PALO ALTO,9402,9076,37,157,326,0.965326526,0.034673474,0.016698575
Iowa,PLYMOUTH,24911,23638,36,740,1273,0.948898077,0.051101923,0.029705752
Iowa,POCAHONTAS,7307,7017,63,179,290,0.96031203,0.03968797,0.024497058
Iowa,POLK,431811,348895,25083,32479,82916,0.807980806,0.192019194,0.075215777
Iowa,POTTAWATTAMIE,92793,83239,1184,5992,9554,0.897039647,0.102960353,0.064573836
Iowa,POWESHIEK,18888,17671,179,456,1217,0.935567556,0.064432444,0.024142313
Iowa,RINGGOLD,5123,4954,5,93,169,0.967011517,0.032988483,0.018153426
Iowa,SAC,10307,9976,75,199,331,0.967885903,0.032114097,0.019307267
Iowa,SCOTT,165432,137294,11847,9262,28138,0.829911988,0.170088012,0.05598675
Iowa,SHELBY,12158,11756,10,221,402,0.966935351,0.033064649,0.018177332
Iowa,SIOUX,33776,30270,155,2898,3506,0.896198484,0.103801516,0.085800568
Iowa,STORY,89734,77999,2368,2657,11735,0.869224597,0.130775403,0.029609735
Iowa,TAMA,17746,14899,98,1302,2847,0.83956948,0.16043052,0.073368646
Iowa,TAYLOR,6292,5818,6,391,474,0.924666243,0.075333757,0.062142403
Iowa,UNION,12525,12011,269,56,514,0.958962076,0.041037924,0.004471058
Iowa,VAN BUREN,7565,7374,20,87,191,0.974752148,0.025247852,0.01150033
Iowa,WAPELLO,35449,30992,444,3151,4457,0.874270078,0.125729922,0.088888262
Iowa,WARREN,46239,44316,218,884,1923,0.95841173,0.04158827,0.019118061
Iowa,WASHINGTON,21765,20185,157,1120,1580,0.927406386,0.072593614,0.051458764
Iowa,WAYNE,6372,6202,5,75,170,0.973320778,0.026679222,0.011770245
Iowa,WEBSTER,37895,34068,1532,1428,3827,0.899010424,0.100989576,0.037683072
Iowa,WINNEBAGO,10800,10200,94,345,600,0.944444444,0.055555556,0.031944444
Iowa,WINNESHIEK,21033,20130,173,408,903,0.957067465,0.042932535,0.019398089
Iowa,WOODBURY,101948,79133,2385,13828,22815,0.77620944,0.22379056,0.135637776
Iowa,WORTH,7581,7309,25,154,272,0.964120828,0.035879172,0.020313943
Iowa,WRIGHT,13173,11733,32,1220,1440,0.890685493,0.109314507,0.092613679
Kansas,ALLEN,13364,12272,266,385,1092,0.918287938,0.081712062,0.02880874
Kansas,ANDERSON,8066,7719,22,11,347,0.956979916,0.043020084,0.001363749
Kansas,ATCHISON,16854,15043,880,401,1811,0.892547763,0.107452237,0.023792571
Kansas,BARBER,4867,4653,8,91,214,0.956030409,0.043969591,0.018697349
Kansas,BARTON,27556,22998,355,3676,4558,0.834591378,0.165408622,0.133401074
Kansas,BOURBON,15060,13836,431,313,1224,0.9187251,0.0812749,0.020783533
Kansas,BROWN,9962,8391,144,314,1571,0.842300743,0.157699257,0.031519775
Kansas,BUTLER,65647,59624,1019,2588,6023,0.90825171,0.09174829,0.039422974
Kansas,CHASE,2788,2598,32,100,190,0.931850789,0.068149211,0.035868006
Kansas,CHAUTAUQUA,3654,3267,29,89,387,0.89408867,0.10591133,0.024356869
Kansas,CHEROKEE,21521,19215,104,431,2306,0.892848845,0.107151155,0.02002695
Kansas,CHEYENNE,2724,2545,0,137,179,0.934287812,0.065712188,0.050293686
Kansas,CLARK,2198,1981,4,156,217,0.901273885,0.098726115,0.070973612
Kansas,CLAY,8547,8174,120,177,373,0.956358956,0.043641044,0.020709021
Kansas,CLOUD,9479,8985,31,277,494,0.947884798,0.052115202,0.029222492
Kansas,COFFEY,8553,8123,56,175,430,0.949725243,0.050274757,0.020460657
Kansas,COMANCHE,1893,1746,0,109,147,0.922345483,0.077654517,0.05758056
Kansas,COWLEY,36259,29744,963,3324,6515,0.820320472,0.179679528,0.091673791
Kansas,CRAWFORD,39133,34769,755,1778,4364,0.888482866,0.111517134,0.045434799
Kansas,DECATUR,2939,2833,20,28,106,0.963933311,0.036066689,0.00952705
Kansas,DICKINSON,19766,18315,68,788,1451,0.926591116,0.073408884,0.039866437
Kansas,DONIPHAN,7931,7255,274,170,676,0.914764847,0.085235153,0.021434876
Kansas,DOUGLAS,111073,90582,3982,5749,20491,0.815517723,0.184482277,0.051758753
Kansas,EDWARDS,3021,2416,8,536,605,0.799735187,0.200264813,0.177424694
Kansas,ELK,2856,2663,24,81,193,0.932422969,0.067577031,0.028361345
Kansas,ELLIS,28525,26173,295,1317,2352,0.917546012,0.082453988,0.046170026
Kansas,ELLSWORTH,6477,5696,297,328,781,0.879419484,0.120580516,0.050640729
Kansas,FINNEY,36608,16998,684,17136,19610,0.464324738,0.535675262,0.468094406
Kansas,FORD,33725,14862,597,17165,18863,0.440681987,0.559318013,0.508969607
Kansas,FRANKLIN,25916,23834,185,930,2082,0.919663528,0.080336472,0.035885167
Kansas,GEARY,34110,20485,5851,4321,13625,0.600557021,0.399442979,0.126678393
Kansas,GOVE,2771,2697,18,23,74,0.973294839,0.026705161,0.008300253
Kansas,GRAHAM,2617,2375,92,39,242,0.907527703,0.092472297,0.01490256
Kansas,GRANT,7817,4219,3,3429,3598,0.539721121,0.460278879,0.438659332
Kansas,GRAY,5982,5013,0,856,969,0.838014042,0.161985958,0.143095955
Kansas,GREELEY,1234,1014,10,190,220,0.82171799,0.17828201,0.153970827
Kansas,GREENWOOD,6654,6215,11,224,439,0.934024647,0.065975353,0.033663962
Kansas,HAMILTON,2656,1914,1,727,742,0.72063253,0.27936747,0.27371988
Kansas,HARPER,5998,5519,38,309,479,0.920140047,0.079859953,0.051517172
Kansas,HARVEY,34572,29290,398,3695,5282,0.847217401,0.152782599,0.106878399
Kansas,HASKELL,4222,2986,11,1155,1236,0.70724775,0.29275225,0.27356703
Kansas,HODGEMAN,1949,1745,1,191,204,0.895330939,0.104669061,0.097998974
Kansas,JACKSON,13401,11454,120,460,1947,0.854712335,0.145287665,0.034325797
Kansas,JEFFERSON,19036,18062,46,371,974,0.948833789,0.051166211,0.019489389
Kansas,JEWELL,3085,2967,12,62,118,0.961750405,0.038249595,0.020097245
Kansas,JOHNSON,546046,447891,22888,38735,98155,0.820244082,0.179755918,0.070937247
Kansas,KEARNY,3952,2696,18,1134,1256,0.682186235,0.317813765,0.28694332
Kansas,KINGMAN,7876,7484,42,202,392,0.950228542,0.049771458,0.025647537
Kansas,KIOWA,2503,2320,9,104,183,0.926887735,0.073112265,0.04155014
Kansas,LABETTE,21574,18459,756,876,3115,0.855613238,0.144386762,0.040604431
Kansas,LANE,1666,1533,1,97,133,0.920168067,0.079831933,0.058223289
Kansas,LEAVENWORTH,76286,61218,6410,4409,15068,0.802480141,0.197519859,0.057795664
Kansas,LINCOLN,3240,3108,3,73,132,0.959259259,0.040740741,0.022530864
Kansas,LINN,9613,9151,40,184,462,0.951940081,0.048059919,0.019140747
Kansas,LOGAN,2766,2607,0,10,159,0.942516269,0.057483731,0.003615329
Kansas,LYON,34103,24862,632,6915,9241,0.729026772,0.270973228,0.202768085
Kansas,MCPHERSON,29208,27191,270,1030,2017,0.930943577,0.069056423,0.035264311
Kansas,MARION,12565,11870,110,308,695,0.944687624,0.055312376,0.024512535
Kansas,MARSHALL,10083,9696,21,190,387,0.961618566,0.038381434,0.018843598
Kansas,MEADE,4504,3652,41,689,852,0.810834813,0.189165187,0.152975133
Kansas,MIAMI,32546,30444,399,850,2102,0.93541449,0.06458551,0.026116881
Kansas,MITCHELL,6359,6170,21,127,189,0.970278346,0.029721654,0.019971694
Kansas,MONTGOMERY,35167,28487,2005,1829,6680,0.810049194,0.189950806,0.052008986
Kansas,MORRIS,5917,5550,6,219,367,0.937975325,0.062024675,0.037011999
Kansas,MORTON,3207,2429,40,621,778,0.757405675,0.242594325,0.193638915
Kansas,NEMAHA,10170,9820,98,129,350,0.965585054,0.034414946,0.012684366
Kansas,NEOSHO,16501,15113,193,689,1388,0.915883886,0.084116114,0.041755045
Kansas,NESS,3102,2843,11,218,259,0.91650548,0.08349452,0.07027724
Kansas,NORTON,5658,5046,206,238,612,0.891834571,0.108165429,0.042064334
Kansas,OSAGE,16300,15530,67,349,770,0.952760736,0.047239264,0.021411043
Kansas,OSBORNE,3852,3732,12,48,120,0.968847352,0.031152648,0.012461059
Kansas,OTTAWA,6099,5827,44,123,272,0.955402525,0.044597475,0.020167241
Kansas,PAWNEE,6945,5982,347,464,963,0.861339093,0.138660907,0.066810655
Kansas,PHILLIPS,5579,5246,10,124,333,0.940311884,0.059688116,0.022226205
Kansas,POTTAWATOMIE,21620,19708,272,965,1912,0.911563367,0.088436633,0.044634598
Kansas,PRATT,9670,8787,106,540,883,0.90868666,0.09131334,0.055842813
Kansas,RAWLINS,2555,2416,5,87,139,0.945596869,0.054403131,0.034050881
Kansas,RENO,64346,55459,1894,5193,8887,0.861887297,0.138112703,0.080704317
Kansas,REPUBLIC,4965,4838,6,56,127,0.974420947,0.025579053,0.011278953
Kansas,RICE,10077,8572,57,994,1505,0.850649995,0.149350005,0.098640468
Kansas,RILEY,71927,57168,4415,4781,14759,0.794805845,0.205194155,0.066470171
Kansas,ROOKS,5205,5000,24,30,205,0.960614793,0.039385207,0.005763689
Kansas,RUSH,3262,3149,44,14,113,0.965358676,0.034641324,0.004291845
Kansas,RUSSELL,6926,6586,67,120,340,0.950909616,0.049090384,0.017326018
Kansas,SALINE,55493,45472,1623,5377,10021,0.819418665,0.180581335,0.096895104
Kansas,SCOTT,4872,4035,7,738,837,0.82820197,0.17179803,0.151477833
Kansas,SEDGWICK,497062,348721,43509,63829,148341,0.701564392,0.298435608,0.128412552
Kansas,SEWARD,23013,8274,752,12972,14739,0.359535914,0.640464086,0.563681397
Kansas,SHAWNEE,177688,134481,14083,19166,43207,0.756837828,0.243162172,0.107863221
Kansas,SHERIDAN,2562,2446,11,81,116,0.954722873,0.045277127,0.031615925
Kansas,SHERMAN,6036,5174,62,671,862,0.857190192,0.142809808,0.111166335
Kansas,SMITH,3835,3694,4,58,141,0.963233377,0.036766623,0.015123859
Kansas,STAFFORD,4398,3757,27,529,641,0.854251933,0.145748067,0.120281946
Kansas,STANTON,2200,1195,23,901,1005,0.543181818,0.456818182,0.409545455
Kansas,STEVENS,5633,3694,36,1813,1939,0.655778448,0.344221552,0.321853364
Kansas,SUMNER,24000,21920,140,1106,2080,0.913333333,0.086666667,0.046083333
Kansas,THOMAS,7854,7289,112,366,565,0.928062134,0.071937866,0.046600458
Kansas,TREGO,2977,2852,10,67,125,0.958011421,0.041988579,0.022505878
Kansas,WABAUNSEE,7048,6657,43,205,391,0.944523269,0.055476731,0.029086266
Kansas,WALLACE,1508,1403,1,94,105,0.930371353,0.069628647,0.062334218
Kansas,WASHINGTON,5806,5557,52,147,249,0.957113331,0.042886669,0.025318636
Kansas,WICHITA,2239,1662,0,550,577,0.742295668,0.257704332,0.245645377
Kansas,WILSON,9368,8816,8,223,552,0.941076003,0.058923997,0.023804441
Kansas,WOODSON,3311,3137,0,73,174,0.947447901,0.052552099,0.02204772
Kansas,WYANDOTTE,157274,68313,39662,41094,88961,0.434356601,0.565643399,0.261289215
Kentucky,ADAIR,18651,17517,530,318,1134,0.939198971,0.060801029,0.017050024
Kentucky,ALLEN,20007,19230,209,300,777,0.961163593,0.038836407,0.014994752
Kentucky,ANDERSON,21442,20329,581,292,1113,0.948092529,0.051907471,0.013618133
Kentucky,BALLARD,8268,7779,256,93,489,0.940856313,0.059143687,0.011248186
Kentucky,BARREN,42229,38632,1798,1092,3597,0.914821568,0.085178432,0.025859007
Kentucky,BATH,11665,11200,223,133,465,0.960137162,0.039862838,0.011401629
Kentucky,BELL,28613,27192,678,218,1421,0.950337259,0.049662741,0.007618914
Kentucky,BOONE,119406,107184,3395,4268,12222,0.897643335,0.102356665,0.035743597
Kentucky,BOURBON,20004,17076,1328,1336,2928,0.853629274,0.146370726,0.066786643
Kentucky,BOYD,49358,46284,1343,711,3074,0.937720329,0.062279671,0.01440496
Kentucky,BOYLE,28445,24699,1857,816,3746,0.86830726,0.13169274,0.02868694
Kentucky,BRACKEN,8488,8253,12,193,235,0.972313855,0.027686145,0.022737983
Kentucky,BREATHITT,13922,13615,73,74,307,0.977948571,0.022051429,0.005315328
Kentucky,BRECKINRIDGE,20068,19120,484,192,948,0.952760614,0.047239386,0.009567471
Kentucky,BULLITT,74431,71431,430,1036,3000,0.959694213,0.040305787,0.013918932
Kentucky,BUTLER,12748,12204,41,351,544,0.957326639,0.042673361,0.027533731
Kentucky,CALDWELL,12977,11933,672,176,1044,0.919549973,0.080450027,0.013562457
Kentucky,CALLOWAY,37198,33664,1413,885,3534,0.904994892,0.095005108,0.023791602
Kentucky,CAMPBELL,90119,83866,2371,1485,6253,0.930613966,0.069386034,0.016478212
Kentucky,CARLISLE,5081,4871,55,72,210,0.958669553,0.041330447,0.014170439
Kentucky,CARROLL,10851,9656,134,754,1195,0.889871901,0.110128099,0.069486683
Kentucky,CARTER,27594,26817,164,346,777,0.971841705,0.028158295,0.012538958
Kentucky,CASEY,15984,15335,120,390,649,0.959396897,0.040603103,0.024399399
Kentucky,CHRISTIAN,73722,50340,15142,4636,23382,0.682835517,0.317164483,0.062884892
Kentucky,CLARK,35555,32327,1843,886,3228,0.909211081,0.090788919,0.024919139
Kentucky,CLAY,21833,20288,1012,215,1545,0.929235561,0.070764439,0.009847479
Kentucky,CLINTON,10244,9827,125,164,417,0.959293245,0.040706755,0.016009371
Kentucky,CRITTENDEN,9321,9069,61,88,252,0.972964274,0.027035726,0.009441047
Kentucky,CUMBERLAND,6857,6508,249,41,349,0.949103106,0.050896894,0.005979291
Kentucky,DAVIESS,96711,87125,4684,2468,9586,0.900879941,0.099120059,0.025519331
Kentucky,EDMONSON,12141,11705,146,216,436,0.964088625,0.035911375,0.017790956
Kentucky,ELLIOTT,7774,7436,227,88,338,0.956521739,0.043478261,0.011319784
Kentucky,ESTILL,14647,14378,38,10,269,0.981634464,0.018365536,0.000682734
Kentucky,FAYETTE,296766,217204,41868,19968,79562,0.73190325,0.26809675,0.067285336
Kentucky,FLEMING,14415,13925,172,156,490,0.966007631,0.033992369,0.01082206
Kentucky,FLOYD,39454,38580,351,242,874,0.97784762,0.02215238,0.006133725
Kentucky,FRANKLIN,49399,41126,5137,1330,8273,0.832526974,0.167473026,0.026923622
Kentucky,FULTON,6758,4902,1593,62,1856,0.725362533,0.274637467,0.009174312
Kentucky,GALLATIN,8513,7888,68,366,625,0.926582873,0.073417127,0.042993069
Kentucky,GARRARD,16892,15961,347,401,931,0.944885153,0.055114847,0.023739048
Kentucky,GRANT,24683,23560,127,569,1123,0.954503099,0.045496901,0.023052303
Kentucky,GRAVES,37200,32701,1510,2077,4499,0.87905914,0.12094086,0.055833333
Kentucky,GRAYSON,25772,24888,174,293,884,0.965699208,0.034300792,0.011368928
Kentucky,GREEN,11309,10744,299,94,565,0.950039791,0.049960209,0.008311964
Kentucky,GREENUP,36922,35734,258,311,1188,0.967824062,0.032175938,0.008423162
Kentucky,HANCOCK,8588,8287,97,97,301,0.964951095,0.035048905,0.01129483
Kentucky,HARDIN,104513,81327,11857,5182,23186,0.778152,0.221848,0.049582349
Kentucky,HARLAN,29210,27928,748,219,1282,0.956110921,0.043889079,0.007497432
Kentucky,HARRISON,18781,17765,446,356,1016,0.945902774,0.054097226,0.018955327
Kentucky,HART,18278,16848,923,259,1430,0.921763869,0.078236131,0.01417004
Kentucky,HENDERSON,46254,40673,3521,859,5581,0.879340165,0.120659835,0.018571367
Kentucky,HENRY,15428,14232,446,479,1196,0.92247861,0.07752139,0.031047446
Kentucky,HICKMAN,4869,4255,498,46,614,0.873896077,0.126103923,0.009447525
Kentucky,HOPKINS,46891,41937,2750,731,4954,0.894350728,0.105649272,0.015589346
Kentucky,JACKSON,13475,13264,1,90,211,0.984341373,0.015658627,0.006679035
Kentucky,JEFFERSON,741285,523626,151430,31991,217659,0.70637609,0.29362391,0.043156141
Kentucky,JESSAMINE,48591,44371,1461,1315,4220,0.913152641,0.086847359,0.027062625
Kentucky,JOHNSON,23339,22871,86,138,468,0.979947727,0.020052273,0.00591285
Kentucky,KENTON,159926,143641,7433,4203,16285,0.898171654,0.101828346,0.026280905
Kentucky,KNOTT,16368,16031,157,55,337,0.979411046,0.020588954,0.003360215
Kentucky,KNOX,31874,30809,529,242,1065,0.966587187,0.033412813,0.007592395
Kentucky,LARUE,14175,13095,468,395,1080,0.923809524,0.076190476,0.027865961
Kentucky,LAUREL,58891,56686,407,738,2205,0.962557946,0.037442054,0.012531626
Kentucky,LAWRENCE,15889,15602,27,71,287,0.981937189,0.018062811,0.0044685
Kentucky,LEE,7831,7653,73,43,178,0.977269825,0.022730175,0.005490997
Kentucky,LESLIE,11318,11155,32,13,163,0.985598162,0.014401838,0.001148613
Kentucky,LETCHER,24336,23930,101,132,406,0.983316897,0.016683103,0.005424063
Kentucky,LEWIS,13889,13299,107,269,590,0.95752034,0.04247966,0.019367845
Kentucky,LINCOLN,24671,23355,637,376,1316,0.94665802,0.05334198,0.015240566
Kentucky,LIVINGSTON,9479,9199,77,84,280,0.970461019,0.029538981,0.008861694
Kentucky,LOGAN,26786,23886,2087,635,2900,0.891734488,0.108265512,0.023706414
Kentucky,LYON,8336,7687,557,44,649,0.922144914,0.077855086,0.005278311
Kentucky,MCCRACKEN,65558,55111,6400,1378,10447,0.840644925,0.159355075,0.021019555
Kentucky,MCCREARY,18204,16502,1095,269,1702,0.906504065,0.093495935,0.014776972
Kentucky,MCLEAN,9554,9291,51,108,263,0.972472263,0.027527737,0.011304166
Kentucky,MADISON,83174,75280,3583,1796,7894,0.905090533,0.094909467,0.021593286
Kentucky,MAGOFFIN,13229,12988,37,58,241,0.981782448,0.018217552,0.004384307
Kentucky,MARION,19872,17308,1792,488,2564,0.870974235,0.129025765,0.024557166
Kentucky,MARSHALL,31393,30599,105,360,794,0.974707737,0.025292263,0.011467525
Kentucky,MARTIN,12934,11528,867,385,1406,0.891294263,0.108705737,0.029766507
Kentucky,MASON,17495,15699,1244,252,1796,0.897342098,0.102657902,0.014404115
Kentucky,MEADE,28979,26141,1174,910,2838,0.902067014,0.097932986,0.03140205
Kentucky,MENIFEE,6331,6120,72,59,211,0.966671932,0.033328068,0.009319223
Kentucky,MERCER,21283,19607,761,471,1676,0.921251703,0.078748297,0.022130339
Kentucky,METCALFE,10074,9610,169,122,464,0.953940838,0.046059162,0.012110383
Kentucky,MONROE,10925,10274,248,290,651,0.940411899,0.059588101,0.026544622
Kentucky,MONTGOMERY,26517,24757,823,659,1760,0.933627484,0.066372516,0.024851982
Kentucky,MORGAN,13898,13011,511,135,887,0.936177867,0.063822133,0.009713628
Kentucky,MUHLENBERG,31399,29220,1416,364,2179,0.930602885,0.069397115,0.011592726
Kentucky,NELSON,43500,39621,2244,859,3879,0.910827586,0.089172414,0.019747126
Kentucky,NICHOLAS,7092,6947,33,108,145,0.979554428,0.020445572,0.015228426
Kentucky,OHIO,23975,22664,367,817,1311,0.94531804,0.05468196,0.034077164
Kentucky,OLDHAM,60357,53981,2631,2048,6376,0.89436188,0.10563812,0.033931441
Kentucky,OWEN,10870,10408,142,244,462,0.9574977,0.0425023,0.022447102
Kentucky,OWSLEY,4764,4581,43,0,183,0.961586902,0.038413098,0
Kentucky,PENDLETON,14771,14409,69,100,362,0.975492519,0.024507481,0.006770022
Kentucky,PERRY,28617,27537,311,187,1080,0.962260195,0.037739805,0.006534577
Kentucky,PIKE,64887,63298,358,443,1589,0.975511273,0.024488727,0.006827254
Kentucky,POWELL,12638,12284,116,134,354,0.971989239,0.028010761,0.010602944
Kentucky,PULASKI,63045,59923,694,1309,3122,0.950479816,0.049520184,0.020762947
Kentucky,ROBERTSON,2251,2250,0,0,1,0.999555753,0.000444247,0
Kentucky,ROCKCASTLE,17090,16755,70,22,335,0.980397894,0.019602106,0.001287303
Kentucky,ROWAN,23351,22196,240,304,1155,0.95053745,0.04946255,0.013018714
Kentucky,RUSSELL,17562,16684,143,560,878,0.950005694,0.049994306,0.031887029
Kentucky,SCOTT,47211,41550,2600,1886,5661,0.880091504,0.119908496,0.039948317
Kentucky,SHELBY,42286,34317,3175,3761,7969,0.811545192,0.188454808,0.088941967
Kentucky,SIMPSON,17323,14858,1698,316,2465,0.857703631,0.142296369,0.018241644
Kentucky,SPENCER,17135,16328,370,256,807,0.952903414,0.047096586,0.014940181
Kentucky,TAYLOR,24514,22349,1174,429,2165,0.91168312,0.08831688,0.017500204
Kentucky,TODD,12472,10788,1056,479,1684,0.86497755,0.13502245,0.03840603
Kentucky,TRIGG,14282,12624,1074,182,1658,0.883909817,0.116090183,0.012743313
Kentucky,TRIMBLE,8829,8422,26,231,407,0.953901914,0.046098086,0.026163778
Kentucky,UNION,14992,12610,1835,252,2382,0.841115261,0.158884739,0.016808965
Kentucky,WARREN,113787,92873,10342,5225,20914,0.816200445,0.183799555,0.04591913
Kentucky,WASHINGTON,11701,10361,773,400,1340,0.885479874,0.114520126,0.034185112
Kentucky,WAYNE,20819,19594,395,585,1225,0.941159518,0.058840482,0.028099332
Kentucky,WEBSTER,13618,12231,666,587,1387,0.898149508,0.101850492,0.043104714
Kentucky,WHITLEY,35756,34510,197,325,1246,0.965152702,0.034847298,0.009089384
Kentucky,WOLFE,7298,7251,2,9,47,0.993559879,0.006440121,0.001233215
Kentucky,WOODFORD,24847,21493,1399,1603,3354,0.865013885,0.134986115,0.064514831
Louisiana,ACADIA PARISH,61611,48137,11035,1059,13474,0.781305286,0.218694714,0.017188489
Louisiana,ALLEN PARISH,25740,18156,5099,1299,7584,0.705361305,0.294638695,0.0504662
Louisiana,ASCENSION PARISH,107647,76279,24023,5008,31368,0.708603119,0.291396881,0.04652243
Louisiana,ASSUMPTION PARISH,23321,15406,7147,484,7915,0.66060632,0.33939368,0.020753827
Louisiana,AVOYELLES PARISH,41925,27785,12350,626,14140,0.662731067,0.337268933,0.014931425
Louisiana,BEAUREGARD PARISH,35662,28706,4490,1031,6956,0.804946442,0.195053558,0.028910325
Louisiana,BIENVILLE PARISH,14312,7830,5968,209,6482,0.547093348,0.452906652,0.01460313
Louisiana,BOSSIER PARISH,117742,81453,25062,6925,36289,0.691792224,0.308207776,0.058815036
Louisiana,CADDO PARISH,254970,121748,120127,6106,133222,0.477499314,0.522500686,0.023947915
Louisiana,CALCASIEU PARISH,192307,133652,47613,4968,58655,0.694992902,0.305007098,0.025833693
Louisiana,CALDWELL PARISH,10118,8010,1792,222,2108,0.791658431,0.208341569,0.021941095
Louisiana,CAMERON PARISH,6934,6667,140,105,267,0.961494087,0.038505913,0.015142775
Louisiana,CATAHOULA PARISH,10409,6934,2946,336,3475,0.66615429,0.33384571,0.032279758
Louisiana,CLAIBORNE PARISH,17059,8005,8576,189,9054,0.469253766,0.530746234,0.011079196
Louisiana,CONCORDIA PARISH,20624,11719,8404,222,8905,0.56822149,0.43177851,0.010764158
Louisiana,DE SOTO PARISH,26695,15130,10154,669,11565,0.566772804,0.433227196,0.025060873
Louisiana,EAST BATON ROUGE PARISH,439662,206234,198575,15864,233428,0.46907397,0.53092603,0.036082263
Louisiana,EAST CARROLL PARISH,7738,2097,5401,198,5641,0.271000258,0.728999742,0.025588007
Louisiana,EAST FELICIANA PARISH,20252,10643,9067,217,9609,0.525528343,0.474471657,0.010714991
Louisiana,EVANGELINE PARISH,33989,23112,9575,771,10877,0.679984701,0.320015299,0.022683809
Louisiana,FRANKLIN PARISH,20714,13790,6691,129,6924,0.66573332,0.33426668,0.006227672
Louisiana,GRANT PARISH,22049,17096,3406,908,4953,0.775363962,0.224636038,0.041181006
Louisiana,IBERIA PARISH,73527,44659,23310,2325,28868,0.607382322,0.392617678,0.031621037
Louisiana,IBERVILLE PARISH,33386,15990,16180,687,17396,0.47894327,0.52105673,0.020577488
Louisiana,JACKSON PARISH,16210,10896,4863,219,5314,0.672177668,0.327822332,0.013510179
Louisiana,JEFFERSON PARISH,432706,242658,111962,53172,190048,0.560791854,0.439208146,0.122882511
Louisiana,JEFFERSON DAVIS PARISH,31529,24637,5294,548,6892,0.781407593,0.218592407,0.017380824
Louisiana,LAFAYETTE PARISH,221602,149342,56430,8487,72260,0.67391991,0.32608009,0.038298391
Louisiana,LAFOURCHE PARISH,96453,75292,12920,3629,21161,0.780608172,0.219391828,0.037624543
Louisiana,LASALLE PARISH,14840,12443,1823,330,2397,0.838477089,0.161522911,0.022237197
Louisiana,LINCOLN PARISH,46543,25110,18755,1170,21433,0.539501107,0.460498893,0.025138044
Louisiana,LIVINGSTON PARISH,128192,115392,6774,3801,12800,0.900149775,0.099850225,0.029650836
Louisiana,MADISON PARISH,12113,4387,7387,188,7726,0.362172872,0.637827128,0.015520515
Louisiana,MOREHOUSE PARISH,27893,14189,13083,265,13704,0.508693938,0.491306062,0.009500592
Louisiana,NATCHITOCHES PARISH,39434,21034,16225,731,18400,0.533397576,0.466602424,0.018537303
Louisiana,ORLEANS PARISH,341407,103837,203970,17825,237570,0.30414432,0.69585568,0.052210412
Louisiana,OUACHITA PARISH,153752,91659,56232,2833,62093,0.596148343,0.403851657,0.018425777
Louisiana,PLAQUEMINES PARISH,23220,15746,4887,1120,7474,0.678122308,0.321877692,0.048234281
Louisiana,POINTE COUPEE PARISH,22821,13722,8343,482,9099,0.601288287,0.398711713,0.021120897
Louisiana,RAPIDES PARISH,131655,81610,42176,3408,50045,0.619877711,0.380122289,0.025885838
Louisiana,RED RIVER PARISH,9068,5264,3575,105,3804,0.580502867,0.419497133,0.01157918
Louisiana,RICHLAND PARISH,20785,12713,7429,344,8072,0.611643012,0.388356988,0.016550397
Louisiana,SABINE PARISH,24265,16798,4033,825,7467,0.692272821,0.307727179,0.033999588
Louisiana,ST. BERNARD PARISH,35947,24542,6306,3408,11405,0.682727349,0.317272651,0.094806243
Louisiana,ST. CHARLES PARISH,52663,34787,13869,2645,17876,0.660558646,0.339441354,0.050225016
Louisiana,ST. HELENA PARISH,11106,4954,6005,35,6152,0.44606519,0.55393481,0.00315145
Louisiana,ST. JAMES PARISH,21978,10468,11108,266,11510,0.476294476,0.523705524,0.012103012
Louisiana,ST. JOHN THE BAPTIST PARISH,45741,18331,24236,2207,27410,0.400756433,0.599243567,0.048249929
Louisiana,ST. LANDRY PARISH,83774,46405,34359,1348,37369,0.553930814,0.446069186,0.016090911
Louisiana,ST. MARTIN PARISH,52343,34046,15959,1092,18297,0.650440365,0.349559635,0.020862388
Louisiana,ST. MARY PARISH,54285,31152,17220,2829,23133,0.573860182,0.426139818,0.052113844
Louisiana,ST. TAMMANY PARISH,234283,188534,26796,11009,45749,0.804727616,0.195272384,0.046990179
Louisiana,TANGIPAHOA PARISH,121209,78083,36459,4158,43126,0.644201338,0.355798662,0.034304383
Louisiana,TENSAS PARISH,5189,2149,2903,128,3040,0.414145307,0.585854693,0.024667566
Louisiana,TERREBONNE PARISH,111666,76616,20507,4357,35050,0.686117529,0.313882471,0.039018143
Louisiana,UNION PARISH,22633,15260,6049,920,7373,0.674236734,0.325763266,0.04064861
Louisiana,VERMILION PARISH,58041,46362,8289,1430,11679,0.798780173,0.201219827,0.024637756
Louisiana,VERNON PARISH,51542,37107,7103,3802,14435,0.719937139,0.280062861,0.073765085
Louisiana,WASHINGTON PARISH,47025,30913,14469,876,16112,0.657373737,0.342626263,0.018628389
Louisiana,WEBSTER PARISH,41156,26036,13832,671,15120,0.632617358,0.367382642,0.01630382
Louisiana,WEST BATON ROUGE PARISH,23748,13801,8707,585,9947,0.581143675,0.418856325,0.024633653
Louisiana,WEST CARROLL PARISH,11587,9279,1862,301,2308,0.800811254,0.199188746,0.025977388
Louisiana,WEST FELICIANA PARISH,15575,7976,6959,237,7599,0.512102729,0.487897271,0.015216693
Louisiana,WINN PARISH,15233,10028,4793,239,5205,0.658307622,0.341692378,0.015689621
Maine,ANDROSCOGGIN,107766,99245,1754,1699,8521,0.920930535,0.079069465,0.01576564
Maine,AROOSTOOK,71757,68182,420,697,3575,0.950179077,0.049820923,0.009713338
Maine,CUMBERLAND,282143,258733,7019,5189,23410,0.91702789,0.08297211,0.018391383
Maine,FRANKLIN,30704,29660,94,149,1044,0.965997916,0.034002084,0.004852788
Maine,HANCOCK,54470,52343,153,631,2127,0.960950982,0.039049018,0.011584358
Maine,KENNEBEC,122022,116464,802,1529,5558,0.954450837,0.045549163,0.012530527
Maine,KNOX,39848,38455,226,350,1393,0.96504216,0.03495784,0.008783377
Maine,LINCOLN,34440,33397,72,290,1043,0.969715447,0.030284553,0.008420441
Maine,OXFORD,57814,55632,247,597,2182,0.962258277,0.037741723,0.010326219
Maine,PENOBSCOT,153742,145537,1103,1670,8205,0.946631369,0.053368631,0.010862354
Maine,PISCATAQUIS,17432,16790,17,169,642,0.963171179,0.036828821,0.009694814
Maine,SAGADAHOC,35394,33615,336,482,1779,0.949737244,0.050262756,0.013618127
Maine,SOMERSET,52098,50306,193,422,1792,0.965603286,0.034396714,0.008100119
Maine,WALDO,38761,37455,115,359,1306,0.966306339,0.033693661,0.009261887
Maine,WASHINGTON,32832,29988,125,466,2844,0.913377193,0.086622807,0.01419347
Maine,YORK,197861,188939,1006,2542,8922,0.954907738,0.045092262,0.012847403
Maryland,ALLEGANY,74645,65921,5636,1089,8724,0.8831268,0.1168732,0.014589055
Maryland,ANNE ARUNDEL,538473,389813,80753,32839,148660,0.723923019,0.276076981,0.060985416
Maryland,BALTIMORE,807318,505425,207790,33958,301893,0.626054417,0.373945583,0.042062731
Maryland,CALVERT,88774,70771,12063,2515,18003,0.797204136,0.202795864,0.028330367
Maryland,CAROLINE,32947,25715,4523,1795,7232,0.780495948,0.219504052,0.05448144
Maryland,CARROLL,167249,152299,5405,4380,14950,0.910612321,0.089387679,0.026188497
Maryland,CECIL,101109,88006,6148,3436,13103,0.870407184,0.129592816,0.033983127
Maryland,CHARLES,147107,71321,59279,6422,75786,0.484823972,0.515176028,0.043655299
Maryland,DORCHESTER,32570,21539,9012,1162,11031,0.661314093,0.338685907,0.035677003
Maryland,FREDERICK,234268,182064,19759,17293,52204,0.7771612,0.2228388,0.073817167
Maryland,GARRETT,30079,29245,288,227,834,0.972273014,0.027726986,0.007546793
Maryland,HARFORD,245396,194211,30699,8714,51185,0.791418768,0.208581232,0.035509951
Maryland,HOWARD,288676,170853,50024,16839,117823,0.591850379,0.408149621,0.058331832
Maryland,KENT,20184,15687,2995,896,4497,0.777199762,0.222800238,0.044391597
Maryland,MONTGOMERY,974824,479708,162939,166124,495116,0.492097035,0.507902965,0.170414352
Maryland,PRINCE GEORGE'S,865443,130239,548459,129470,735204,0.150488247,0.849511753,0.149599685
Maryland,QUEEN ANNE'S,47894,41834,3377,1428,6060,0.873470581,0.126529419,0.029815843
Maryland,ST. MARY'S,105528,80740,14124,4056,24788,0.765104996,0.234895004,0.038435297
Maryland,SOMERSET,26402,13834,10700,866,12568,0.523975456,0.476024544,0.032800545
Maryland,TALBOT,37746,29886,4888,2030,7860,0.791766015,0.208233985,0.053780533
Maryland,WASHINGTON,147882,122987,14001,5155,24895,0.831656321,0.168343679,0.034858874
Maryland,WICOMICO,98940,66009,23176,4470,32931,0.667161916,0.332838084,0.045178896
Maryland,WORCESTER,51398,41367,7321,1586,10031,0.804836764,0.195163236,0.030857232
Maryland,BALTIMORE CITY,620644,173821,392173,25535,446823,0.280065545,0.719934455,0.041142748
Massachusetts,BARNSTABLE,216021,198702,4406,4779,17319,0.919827239,0.080172761,0.022122849
Massachusetts,BERKSHIRE,130866,118401,3438,4524,12465,0.904749897,0.095250103,0.034569713
Massachusetts,BRISTOL,548739,470779,17739,33137,77960,0.857928815,0.142071185,0.060387543
Massachusetts,DUKES,16581,15120,656,75,1461,0.9118871,0.0881129,0.00452325
Massachusetts,ESSEX,744961,565929,20564,123280,179032,0.75967601,0.24032399,0.165485173
Massachusetts,FRANKLIN,71489,66031,497,2301,5458,0.92365259,0.07634741,0.03218677
Massachusetts,HAMPDEN,464072,313556,36165,96925,150516,0.675662397,0.324337603,0.208857677
Massachusetts,HAMPSHIRE,158850,136732,3751,7589,22118,0.860761725,0.139238275,0.04777463
Massachusetts,MIDDLESEX,1507558,1160104,65529,99041,347454,0.769525285,0.230474715,0.065696312
Massachusetts,NANTUCKET,10194,8192,575,958,2002,0.803609967,0.196390033,0.093976849
Massachusetts,NORFOLK,672078,540382,37666,22270,131696,0.804046554,0.195953446,0.033136035
Massachusetts,PLYMOUTH,495407,417678,39833,15898,77729,0.843100723,0.156899277,0.032090786
Massachusetts,SUFFOLK,724502,348562,146857,144470,375940,0.481105642,0.518894358,0.199405937
Massachusetts,WORCESTER,799277,646235,29665,75159,153042,0.808524454,0.191475546,0.094033733
Michigan,ALCONA,10943,10621,18,126,322,0.970574797,0.029425203,0.01151421
Michigan,ALGER,9531,8181,716,112,1350,0.858356941,0.141643059,0.011751128
Michigan,ALLEGAN,111589,99874,1354,7520,11715,0.895016534,0.104983466,0.067390155
Michigan,ALPENA,29602,28593,129,322,1009,0.965914465,0.034085535,0.010877643
Michigan,ANTRIM,23634,22573,67,410,1061,0.955107049,0.044892951,0.017347889
Michigan,ARENAC,15952,15235,250,238,717,0.955052658,0.044947342,0.014919759
Michigan,BARAGA,8808,6531,1030,94,2277,0.741485014,0.258514986,0.010672116
Michigan,BARRY,59249,56497,267,1379,2752,0.953551959,0.046448041,0.023274654
Michigan,BAY,107633,98125,1255,5081,9508,0.91166278,0.08833722,0.047206712
Michigan,BENZIE,17554,16667,72,315,887,0.949470206,0.050529794,0.017944628
Michigan,BERRIEN,156759,119031,23713,7113,37728,0.759324823,0.240675177,0.045375385
Michigan,BRANCH,44920,40898,1208,1836,4022,0.910463045,0.089536955,0.040872663
Michigan,CALHOUN,136063,108661,14577,6137,27402,0.798607998,0.201392002,0.045104106
Michigan,CASS,52412,45813,2702,1571,6599,0.874093719,0.125906281,0.029974052
Michigan,CHARLEVOIX,26057,24690,139,364,1367,0.94753809,0.05246191,0.013969375
Michigan,CHEBOYGAN,26195,24347,121,236,1848,0.929452186,0.070547814,0.009009353
Michigan,CHIPPEWA,38919,27755,1905,566,11164,0.71314782,0.28685218,0.014543025
Michigan,CLARE,30924,29547,149,472,1377,0.955471478,0.044528522,0.015263226
Michigan,CLINTON,75274,68321,1503,2944,6953,0.907630789,0.092369211,0.03911045
Michigan,CRAWFORD,14119,13586,147,197,533,0.962249451,0.037750549,0.01395283
Michigan,DELTA,37075,34885,95,330,2190,0.940930546,0.059069454,0.008900877
Michigan,DICKINSON,26286,25353,75,278,933,0.964505821,0.035494179,0.010575972
Michigan,EATON,107861,91571,6046,5139,16290,0.848972288,0.151027712,0.047644654
Michigan,EMMET,32799,30175,190,433,2624,0.919997561,0.080002439,0.013201622
Michigan,GENESEE,425337,309430,85862,12938,115907,0.727493729,0.272506271,0.030418233
Michigan,GLADWIN,25736,24889,140,315,847,0.967088903,0.032911097,0.012239664
Michigan,GOGEBIC,16297,14845,739,154,1452,0.910903847,0.089096153,0.009449592
Michigan,GRAND TRAVERSE,87483,81603,1024,1959,5880,0.932786941,0.067213059,0.022392922
Michigan,GRATIOT,42340,37059,2148,2264,5281,0.875271611,0.124728389,0.053471894
Michigan,HILLSDALE,46617,44673,231,849,1944,0.958298475,0.041701525,0.01821224
Michigan,HOUGHTON,36519,34083,253,443,2436,0.933294997,0.066705003,0.012130672
Michigan,HURON,33001,31719,68,644,1282,0.961152692,0.038847308,0.01951456
Michigan,INGHAM,281323,204023,30562,20463,77300,0.725226874,0.274773126,0.072738454
Michigan,IONIA,64149,56942,2390,2827,7207,0.887652185,0.112347815,0.044069276
Michigan,IOSCO,25880,24670,96,418,1210,0.95324575,0.04675425,0.016151468
Michigan,IRON,11837,11370,139,165,467,0.960547436,0.039452564,0.013939343
Michigan,ISABELLA,70186,61310,1700,2288,8876,0.873536033,0.126463967,0.032599094
Michigan,JACKSON,160257,137405,12650,4859,22852,0.857404045,0.142595955,0.030320048
Michigan,KALAMAZOO,250704,200248,27496,10035,50456,0.79874274,0.20125726,0.040027283
Michigan,KALKASKA,17231,16516,93,219,715,0.95850502,0.04149498,0.012709651
Michigan,KENT,605244,459422,56343,58464,145822,0.75906907,0.24093093,0.096595753
Michigan,KEWEENAW,2168,2094,50,8,74,0.965867159,0.034132841,0.003690037
Michigan,LAKE,11543,9878,1034,253,1665,0.855756736,0.144243264,0.021918046
Michigan,LAPEER,88626,82365,956,3682,6261,0.929354817,0.070645183,0.04154537
Michigan,LEELANAU,21677,19670,87,819,2007,0.907413387,0.092586613,0.037781981
Michigan,LENAWEE,99878,87433,2394,7588,12445,0.875397986,0.124602014,0.075972687
Michigan,LIVINGSTON,181678,172989,750,3532,8689,0.952173626,0.047826374,0.019440989
Michigan,LUCE,6590,5277,746,159,1313,0.800758725,0.199241275,0.024127466
Michigan,MACKINAC,11144,8448,88,184,2696,0.758076095,0.241923905,0.016511127
Michigan,MACOMB,841769,704957,72365,19226,136812,0.83747085,0.16252915,0.022839995
Michigan,MANISTEE,24753,22402,681,655,2351,0.905021614,0.094978386,0.026461439
Michigan,MARQUETTE,67178,62486,1064,786,4692,0.930155706,0.069844294,0.011700259
Michigan,MASON,28672,26564,166,1136,2108,0.926478795,0.073521205,0.039620536
Michigan,MECOSTA,42947,39662,1215,766,3285,0.923510373,0.076489627,0.017835937
Michigan,MENOMINEE,24041,22674,50,292,1367,0.943138805,0.056861195,0.012145917
Michigan,MIDLAND,83744,77730,1065,1741,6014,0.9281859,0.0718141,0.020789549
Michigan,MISSAUKEE,14945,14301,46,318,644,0.956908665,0.043091335,0.021278019
Michigan,MONROE,151944,140462,3017,4697,11482,0.924432686,0.075567314,0.030912705
Michigan,MONTCALM,63357,58583,1464,1948,4774,0.92464921,0.07535079,0.030746405
Michigan,MONTMORENCY,9709,9406,29,99,303,0.968791843,0.031208157,0.010196725
Michigan,MUSKEGON,171755,132925,23806,8289,38830,0.773922157,0.226077843,0.048260604
Michigan,NEWAYGO,48517,44110,601,2650,4407,0.909165859,0.090834141,0.05462003
Michigan,OAKLAND,1207097,905208,159981,42251,301889,0.749904937,0.250095063,0.035002158
Michigan,OCEANA,26636,22285,98,3645,4351,0.836649647,0.163350353,0.136844872
Michigan,OGEMAW,21674,20842,62,319,832,0.961612993,0.038387007,0.014718095
Michigan,ONTONAGON,6703,6464,45,64,239,0.964344323,0.035655677,0.009547964
Michigan,OSCEOLA,23486,22468,145,355,1018,0.956655029,0.043344971,0.015115388
Michigan,OSCODA,8709,8436,6,87,273,0.968653117,0.031346883,0.009989666
Michigan,OTSEGO,24175,23184,34,310,991,0.959007239,0.040992761,0.012823164
Michigan,OTTAWA,264835,226513,3133,23062,38322,0.855298582,0.144701418,0.087080635
Michigan,PRESQUE ISLE,13368,12932,38,116,436,0.9673848,0.0326152,0.008677439
Michigan,ROSCOMMON,24447,23581,89,276,866,0.964576431,0.035423569,0.011289729
Michigan,SAGINAW,200017,141017,36402,15543,59000,0.705025073,0.294974927,0.077708395
Michigan,ST. CLAIR,162978,150217,3845,4727,12761,0.921701088,0.078298912,0.029003915
Michigan,ST. JOSEPH,61314,54027,1610,4038,7287,0.881152755,0.118847245,0.065857716
Michigan,SANILAC,43096,40800,185,1468,2296,0.946723594,0.053276406,0.034063486
Michigan,SCHOOLCRAFT,8455,7369,28,66,1086,0.871555293,0.128444707,0.007806032
Michigan,SHIAWASSEE,70402,66949,395,1711,3453,0.950953098,0.049046902,0.024303287
Michigan,TUSCOLA,55616,52400,560,1596,3216,0.942174914,0.057825086,0.028696778
Michigan,VAN BUREN,76149,62802,3117,7734,13347,0.82472521,0.17527479,0.101564039
Michigan,WASHTENAW,346010,249368,41676,13999,96642,0.720695934,0.279304066,0.040458368
Michigan,WAYNE,1822469,903177,734110,95163,919292,0.4955788,0.5044212,0.052216526
Michigan,WEXFORD,32694,31211,150,523,1483,0.954639995,0.045360005,0.015996819
Minnesota,AITKIN,16166,15332,76,154,834,0.948410244,0.051589756,0.009526166
Minnesota,ANOKA,331649,282532,13698,11995,49117,0.851900654,0.148099346,0.036167756
Minnesota,BECKER,32600,28573,113,443,4027,0.876472393,0.123527607,0.013588957
Minnesota,BELTRAMI,44652,33188,343,708,11464,0.743258981,0.256741019,0.015855953
Minnesota,BENTON,38560,36018,825,651,2542,0.934076763,0.065923237,0.01688278
Minnesota,BIG STONE,5250,5130,17,45,120,0.977142857,0.022857143,0.008571429
Minnesota,BLUE EARTH,63991,58197,1571,1633,5794,0.909456017,0.090543983,0.025519214
Minnesota,BROWN,25772,24533,74,861,1239,0.951924569,0.048075431,0.03340835
Minnesota,CARLTON,35304,31423,538,488,3881,0.890069114,0.109930886,0.013822796
Minnesota,CARVER,91355,82722,968,3574,8633,0.90550052,0.09449948,0.039122106
Minnesota,CASS,28519,24289,75,362,4230,0.851677829,0.148322171,0.012693292
Minnesota,CHIPPEWA,12327,11252,43,608,1075,0.912793056,0.087206944,0.049322625
Minnesota,CHISAGO,53526,50616,621,863,2910,0.945633898,0.054366102,0.016123006
Minnesota,CLAY,58937,53317,874,2130,5620,0.904643942,0.095356058,0.036140285
Minnesota,CLEARWATER,8672,7514,51,117,1158,0.86646679,0.13353321,0.013491697
Minnesota,COOK,5206,4551,28,36,655,0.874183634,0.125816366,0.006915098
Minnesota,COTTONWOOD,11665,10398,63,728,1267,0.891384483,0.108615517,0.062408916
Minnesota,CROW WING,62521,59966,446,674,2555,0.959133731,0.040866269,0.010780378
Minnesota,DAKOTA,399443,328654,18870,23839,70789,0.822780722,0.177219278,0.059680605
Minnesota,DODGE,20071,18776,112,920,1295,0.935479049,0.064520951,0.045837278
Minnesota,DOUGLAS,36167,35100,206,373,1067,0.970497968,0.029502032,0.010313269
Minnesota,FARIBAULT,14546,13513,74,808,1033,0.928983913,0.071016087,0.055547917
Minnesota,FILLMORE,20880,20381,35,203,499,0.976101533,0.023898467,0.009722222
Minnesota,FREEBORN,31188,27616,239,2717,3572,0.88546877,0.11453123,0.08711684
Minnesota,GOODHUE,46144,43041,502,1318,3103,0.932753988,0.067246012,0.02856276
Minnesota,GRANT,6016,5829,30,94,187,0.968916223,0.031083777,0.015625
Minnesota,HENNEPIN,1158039,831188,133791,77271,326851,0.717754756,0.282245244,0.066725732
Minnesota,HOUSTON,19001,18455,39,137,546,0.97126467,0.02873533,0.007210147
Minnesota,HUBBARD,20372,19087,46,330,1285,0.936923228,0.063076772,0.016198704
Minnesota,ISANTI,38004,36152,207,599,1852,0.951268288,0.048731712,0.015761499
Minnesota,ITASCA,45052,41920,139,431,3132,0.930480334,0.069519666,0.009566723
Minnesota,JACKSON,10273,9684,28,286,589,0.942665239,0.057334761,0.027839969
Minnesota,KANABEC,16255,15604,88,225,651,0.959950784,0.040049216,0.013841895
Minnesota,KANDIYOHI,42150,35907,886,4653,6243,0.851886121,0.148113879,0.110391459
Minnesota,KITTSON,4547,4417,26,21,130,0.971409721,0.028590279,0.00461843
Minnesota,KOOCHICHING,13293,12485,29,144,808,0.939216129,0.060783871,0.010832769
Minnesota,LAC QUI PARLE,7240,7007,29,118,233,0.96781768,0.03218232,0.016298343
Minnesota,LAKE,10849,10443,10,85,406,0.962577196,0.037422804,0.007834823
Minnesota,LAKE OF THE WOODS,4039,3856,45,0,183,0.954691755,0.045308245,0
Minnesota,LE SUEUR,27744,25706,110,1449,2038,0.926542676,0.073457324,0.052227509
Minnesota,LINCOLN,5876,5734,13,79,142,0.975833901,0.024166099,0.01344452
Minnesota,LYON,25714,22564,534,1539,3150,0.877498639,0.122501361,0.059850665
Minnesota,MCLEOD,36527,33877,166,1841,2650,0.927450927,0.072549073,0.050401073
Minnesota,MAHNOMEN,5442,2706,26,114,2736,0.49724366,0.50275634,0.020948181
Minnesota,MARSHALL,9475,8977,39,343,498,0.947440633,0.052559367,0.036200528
Minnesota,MARTIN,20727,19620,72,763,1107,0.946591403,0.053408597,0.036811888
Minnesota,MEEKER,23262,22170,57,752,1092,0.953056487,0.046943513,0.032327401
Minnesota,MILLE LACS,26004,23539,121,389,2465,0.905206891,0.094793109,0.014959237
Minnesota,MORRISON,33173,32096,146,416,1077,0.967533838,0.032466162,0.012540319
Minnesota,MOWER,39115,32945,783,4075,6170,0.842260003,0.157739997,0.104179982
Minnesota,MURRAY,8690,8283,21,244,407,0.953164557,0.046835443,0.028078251
Minnesota,NICOLLET,32689,29861,721,1203,2828,0.913487718,0.086512282,0.03680137
Minnesota,NOBLES,21349,14252,743,4808,7097,0.667572252,0.332427748,0.225209612
Minnesota,NORMAN,6796,6236,7,278,560,0.917598587,0.082401413,0.040906416
Minnesota,OLMSTED,144507,120545,6794,6071,23962,0.834181043,0.165818957,0.042011806
Minnesota,OTTER TAIL,57381,54266,456,1518,3115,0.945713738,0.054286262,0.02645475
Minnesota,PENNINGTON,13950,12875,189,387,1075,0.922939068,0.077060932,0.027741935
Minnesota,PINE,29564,26751,579,713,2813,0.904850494,0.095149506,0.02411717
Minnesota,PIPESTONE,9536,8816,49,353,720,0.924496644,0.075503356,0.037017617
Minnesota,POLK,31426,28341,242,1722,3085,0.901832877,0.098167123,0.054795392
Minnesota,POPE,10978,10699,46,95,279,0.974585535,0.025414465,0.008653671
Minnesota,RAMSEY,510885,342069,54016,36471,168816,0.669561643,0.330438357,0.071387886
Minnesota,RED LAKE,4100,3873,17,104,227,0.944634146,0.055365854,0.025365854
Minnesota,REDWOOD,16006,14122,91,338,1884,0.88229414,0.11770586,0.021117081
Minnesota,RENVILLE,15653,14254,78,1051,1399,0.910624162,0.089375838,0.067143679
Minnesota,RICE,64171,54386,1978,5051,9785,0.847516791,0.152483209,0.078711568
Minnesota,ROCK,9620,9170,76,197,450,0.953222453,0.046777547,0.02047817
Minnesota,ROSEAU,15665,14736,52,120,929,0.940695819,0.059304181,0.007660389
Minnesota,ST. LOUIS,200150,184721,2802,2466,15429,0.922912815,0.077087185,0.012320759
Minnesota,SCOTT,130689,110353,3347,5823,20336,0.844393943,0.155606057,0.04455616
Minnesota,SHERBURNE,88558,82145,1536,1935,6413,0.927584182,0.072415818,0.021850087
Minnesota,SIBLEY,15189,13799,67,1097,1390,0.908486405,0.091513595,0.07222332
Minnesota,STEARNS,150307,136227,4556,4150,14080,0.906325055,0.093674945,0.027610158
Minnesota,STEELE,36524,32498,779,2290,4026,0.889771109,0.110228891,0.0626985
Minnesota,STEVENS,9712,8893,39,336,819,0.915671334,0.084328666,0.034596376
Minnesota,SWIFT,9764,9209,133,355,555,0.943158542,0.056841458,0.03635805
Minnesota,TODD,24783,22984,70,1237,1799,0.927409918,0.072590082,0.049913247
Minnesota,TRAVERSE,3549,3311,2,50,238,0.932938856,0.067061144,0.014088476
Minnesota,WABASHA,21636,20676,96,595,960,0.955629506,0.044370494,0.027500462
Minnesota,WADENA,13808,13216,57,178,592,0.957126304,0.042873696,0.012891078
Minnesota,WASECA,19089,17242,326,1000,1847,0.903242705,0.096757295,0.052386191
Minnesota,WASHINGTON,238721,204217,8131,8195,34504,0.855463072,0.144536928,0.034328777
Minnesota,WATONWAN,11177,8571,12,2337,2606,0.766842623,0.233157377,0.209090096
Minnesota,WILKIN,6584,6283,15,141,301,0.954283111,0.045716889,0.021415553
Minnesota,WINONA,51481,47809,567,1222,3672,0.928672714,0.071327286,0.023736913
Minnesota,WRIGHT,124737,116620,1115,3100,8117,0.934927087,0.065072913,0.024852289
Minnesota,YELLOW MEDICINE,10357,9503,30,392,854,0.91754369,0.08245631,0.037848798
Mississippi,ADAMS,32391,12532,18633,879,19859,0.386897595,0.613102405,0.027137168
Mississippi,ALCORN,37027,31221,4284,992,5806,0.843195506,0.156804494,0.02679126
Mississippi,AMITE,13139,7477,5576,38,5662,0.569069183,0.430930817,0.002892153
Mississippi,ATTALA,19454,10800,8200,329,8654,0.555155752,0.444844248,0.016911689
Mississippi,BENTON,8725,5254,3133,153,3471,0.60217765,0.39782235,0.017535817
Mississippi,BOLIVAR,34239,11187,22478,160,23052,0.326732673,0.673267327,0.004673034
Mississippi,CALHOUN,14903,9778,4181,800,5125,0.656109508,0.343890492,0.053680467
Mississippi,CARROLL,10553,6825,3536,0,3728,0.646735525,0.353264475,0
Mississippi,CHICKASAW,17458,9203,7283,645,8255,0.527150876,0.472849124,0.036945813
Mississippi,CHOCTAW,8506,5731,2714,27,2775,0.673759699,0.326240301,0.00317423
Mississippi,CLAIBORNE,9681,1386,8112,74,8295,0.143167028,0.856832972,0.007643838
Mississippi,CLARKE,16688,10615,5905,106,6073,0.63608581,0.36391419,0.00635187
Mississippi,CLAY,20633,8197,12101,118,12436,0.397276208,0.602723792,0.005718994
Mississippi,COAHOMA,26099,5952,19522,314,20147,0.228054715,0.771945285,0.012031112
Mississippi,COPIAH,29324,13307,14969,777,16017,0.453792116,0.546207884,0.026497067
Mississippi,COVINGTON,19571,12141,7020,205,7430,0.62035665,0.37964335,0.010474682
Mississippi,DESOTO,161536,113506,32542,7916,48030,0.702666898,0.297333102,0.049004556
Mississippi,FORREST,75378,44095,27298,2570,31283,0.584985009,0.415014991,0.034094829
Mississippi,FRANKLIN,8055,5155,2787,5,2900,0.639975171,0.360024829,0.000620732
Mississippi,GEORGE,22579,19949,1900,471,2630,0.883520085,0.116479915,0.020860091
Mississippi,GREENE,14352,10251,3416,154,4101,0.714255853,0.285744147,0.010730212
Mississippi,GRENADA,21886,12304,9305,15,9582,0.562185872,0.437814128,0.00068537
Mississippi,HANCOCK,44044,37915,3321,1472,6129,0.860843702,0.139156298,0.033421124
Mississippi,HARRISON,188110,126105,41502,9786,62005,0.670379034,0.329620966,0.052022753
Mississippi,HINDS,246335,69132,169745,3681,177203,0.280642215,0.719357785,0.014943065
Mississippi,HOLMES,19207,3063,16027,19,16144,0.159473109,0.840526891,0.000989223
Mississippi,HUMPHREYS,9399,2144,7046,205,7255,0.228109373,0.771890627,0.021810831
Mississippi,ISSAQUENA,1556,518,1033,5,1038,0.332904884,0.667095116,0.003213368
Mississippi,ITAWAMBA,23362,21363,1473,304,1999,0.914433696,0.085566304,0.013012585
Mississippi,JACKSON,139430,97384,29962,6365,42046,0.698443663,0.301556337,0.045650147
Mississippi,JASPER,17033,7809,8795,240,9224,0.458462984,0.541537016,0.014090295
Mississippi,JEFFERSON,7743,1057,6674,6,6686,0.136510396,0.863489604,0.000774893
Mississippi,JEFFERSON DAVIS,12364,4778,7472,23,7586,0.386444516,0.613555484,0.001860239
Mississippi,JONES,67868,44491,19124,3157,23377,0.655551954,0.344448046,0.046516768
Mississippi,KEMPER,10391,3663,6101,158,6728,0.352516601,0.647483399,0.015205466
Mississippi,LAFAYETTE,47586,33580,11447,1054,14006,0.705669735,0.294330265,0.022149372
Mississippi,LAMAR,55580,42454,10700,1184,13126,0.763835912,0.236164088,0.021302627
Mississippi,LAUDERDALE,80204,43348,33889,1475,36856,0.540471797,0.459528203,0.018390604
Mississippi,LAWRENCE,12832,8439,4259,45,4393,0.657652743,0.342347257,0.003506858
Mississippi,LEAKE,23563,11494,9592,1008,12069,0.487798667,0.512201333,0.042778933
Mississippi,LEE,83235,56930,22662,1994,26305,0.683967081,0.316032919,0.023956268
Mississippi,LEFLORE,32196,7979,22949,763,24217,0.247825817,0.752174183,0.023698596
Mississippi,LINCOLN,34850,23620,10634,342,11230,0.677761836,0.322238164,0.009813486
Mississippi,LOWNDES,59584,31737,26014,921,27847,0.532642991,0.467357009,0.01545717
Mississippi,MADISON,95481,53543,36441,2712,41938,0.560771253,0.439228747,0.028403557
Mississippi,MARION,26810,17441,8790,340,9369,0.650540843,0.349459157,0.012681835
Mississippi,MARSHALL,37019,18005,17587,1157,19014,0.486371863,0.513628137,0.031254221
Mississippi,MONROE,36912,24837,11405,353,12075,0.672870611,0.327129389,0.009563286
Mississippi,MONTGOMERY,10866,5720,5086,0,5146,0.526412663,0.473587337,0
Mississippi,NESHOBA,29682,17795,6191,507,11887,0.599521596,0.400478404,0.017081059
Mississippi,NEWTON,21687,13572,6622,303,8115,0.625812699,0.374187301,0.013971504
Mississippi,NOXUBEE,11511,3126,8274,93,8385,0.271566328,0.728433672,0.008079229
Mississippi,OKTIBBEHA,47486,27579,17473,702,19907,0.580781704,0.419218296,0.014783305
Mississippi,PANOLA,34675,16896,17107,505,17779,0.487267484,0.512732516,0.014563807
Mississippi,PEARL RIVER,55886,45943,7067,1633,9943,0.822084243,0.177915757,0.029220198
Mississippi,PERRY,12217,9462,2719,0,2755,0.774494557,0.225505443,0
Mississippi,PIKE,40300,18489,20805,505,21811,0.458784119,0.541215881,0.012531017
Mississippi,PONTOTOC,29962,23578,4257,1780,6384,0.786930111,0.213069889,0.059408584
Mississippi,PRENTISS,25384,21245,3365,308,4139,0.836944532,0.163055468,0.012133627
Mississippi,QUITMAN,8171,2371,5700,67,5800,0.290172561,0.709827439,0.008199731
Mississippi,RANKIN,142136,108345,26882,3662,33791,0.762262903,0.237737097,0.025764057
Mississippi,SCOTT,28207,14357,10647,2923,13850,0.508987131,0.491012869,0.103626759
Mississippi,SHARKEY,4835,1353,3442,33,3482,0.27983454,0.72016546,0.006825233
Mississippi,SIMPSON,27476,17118,9673,417,10358,0.623016451,0.376983549,0.015176882
Mississippi,SMITH,16425,12295,3851,203,4130,0.748554033,0.251445967,0.012359209
Mississippi,STONE,17657,13685,3414,247,3972,0.775046724,0.224953276,0.013988786
Mississippi,SUNFLOWER,29230,7397,21224,405,21833,0.253061923,0.746938077,0.013855628
Mississippi,TALLAHATCHIE,15262,5552,8158,1344,9710,0.363779321,0.636220679,0.088061853
Mississippi,TATE,28580,18897,8764,638,9683,0.661196641,0.338803359,0.022323303
Mississippi,TIPPAH,22095,17327,3263,992,4768,0.784204571,0.215795429,0.044897036
Mississippi,TISHOMINGO,19573,18298,629,552,1275,0.934859245,0.065140755,0.028202115
Mississippi,TUNICA,10716,2460,7828,239,8256,0.22956327,0.77043673,0.022303098
Mississippi,UNION,27175,21682,3704,1188,5493,0.797865685,0.202134315,0.043716651
Mississippi,WALTHALL,15405,8079,6992,238,7326,0.524440117,0.475559883,0.015449529
Mississippi,WARREN,48419,24013,22666,925,24406,0.495941676,0.504058324,0.019104071
Mississippi,WASHINGTON,51010,13729,36158,565,37281,0.269143305,0.730856695,0.01107626
Mississippi,WAYNE,20754,12287,8063,252,8467,0.592030452,0.407969548,0.012142238
Mississippi,WEBSTER,10162,7923,1985,113,2239,0.779669356,0.220330644,0.011119858
Mississippi,WILKINSON,9778,2828,6897,43,6950,0.2892207,0.7107793,0.004397627
Mississippi,WINSTON,19160,9902,9039,183,9258,0.516805846,0.483194154,0.009551148
Mississippi,YALOBUSHA,12647,7570,4809,159,5077,0.598560924,0.401439076,0.012572151
Mississippi,YAZOO,28220,10507,15853,1393,17713,0.372324592,0.627675408,0.049362155
Missouri,ADAIR,25542,23636,492,540,1906,0.925377809,0.074622191,0.021141649
Missouri,ANDREW,17205,16503,101,294,702,0.959197908,0.040802092,0.017088056
Missouri,ATCHISON,5664,5507,62,56,157,0.972281073,0.027718927,0.009887006
Missouri,AUDRAIN,25617,22676,1632,659,2941,0.885193426,0.114806574,0.025725104
Missouri,BARRY,35680,31564,10,2776,4116,0.884641256,0.115358744,0.077802691
Missouri,BARTON,12428,11720,13,242,708,0.943031864,0.056968136,0.01947216
Missouri,BATES,17003,16240,71,289,763,0.955125566,0.044874434,0.016997001
Missouri,BENTON,19021,18187,35,295,834,0.956153725,0.043846275,0.015509174
Missouri,BOLLINGER,12389,12057,73,101,332,0.973202034,0.026797966,0.008152393
Missouri,BOONE,163266,131992,14282,4919,31274,0.808447564,0.191552436,0.030128747
Missouri,BUCHANAN,89162,76753,3973,4687,12409,0.860826361,0.139173639,0.052567237
Missouri,BUTLER,42792,38435,2343,678,4357,0.898181903,0.101818097,0.015844083
Missouri,CALDWELL,9302,8909,65,144,393,0.957751021,0.042248979,0.015480542
Missouri,CALLAWAY,44157,40091,1823,726,4066,0.907919469,0.092080531,0.016441334
Missouri,CAMDEN,43731,41656,174,1007,2075,0.952550822,0.047449178,0.023027143
Missouri,CAPE GIRARDEAU,75690,66557,5325,1514,9133,0.879336768,0.120663232,0.020002642
Missouri,CARROLL,9279,8861,169,119,418,0.954952042,0.045047958,0.012824658
Missouri,CARTER,6225,5933,42,52,292,0.953092369,0.046907631,0.008353414
Missouri,CASS,99394,88914,3217,3937,10480,0.89456104,0.10543896,0.039610037
Missouri,CEDAR,13941,13380,29,215,561,0.959758984,0.040241016,0.015422136
Missouri,CHARITON,7759,7466,193,44,293,0.962237402,0.037762598,0.005670834
Missouri,CHRISTIAN,77474,72926,467,1965,4548,0.941296435,0.058703565,0.025363348
Missouri,CLARK,7082,6915,45,35,167,0.976419091,0.023580909,0.004942107
Missouri,CLAY,222048,186482,10866,13118,35566,0.839827425,0.160172575,0.059077317
Missouri,CLINTON,20687,19544,288,336,1143,0.944747909,0.055252091,0.016242084
Missouri,COLE,75813,62765,8451,1811,13048,0.827892314,0.172107686,0.023887724
Missouri,COOPER,17542,15676,989,238,1866,0.893626724,0.106373276,0.013567438
Missouri,CRAWFORD,24753,23851,44,377,902,0.963559973,0.036440027,0.015230477
Missouri,DADE,7811,7406,54,119,405,0.948150045,0.051849955,0.015234925
Missouri,DALLAS,16825,15991,23,268,834,0.950430906,0.049569094,0.015928678
Missouri,DAVIESS,8341,8105,33,90,236,0.97170603,0.02829397,0.010790073
Missouri,DEKALB,12878,11021,1126,227,1857,0.85580059,0.14419941,0.017626961
Missouri,DENT,15595,14940,45,157,655,0.957999359,0.042000641,0.010067329
Missouri,DOUGLAS,13690,13398,9,115,292,0.978670562,0.021329438,0.008400292
Missouri,DUNKLIN,31970,26493,3154,1751,5477,0.82868314,0.17131686,0.054770097
Missouri,FRANKLIN,101440,97303,1191,1406,4137,0.959217271,0.040782729,0.01386041
Missouri,GASCONADE,15160,14713,47,161,447,0.970514512,0.029485488,0.010620053
Missouri,GENTRY,6773,6633,38,39,140,0.979329691,0.020670309,0.005758157
Missouri,GREENE,275671,246781,7688,8302,28890,0.895201164,0.104798836,0.030115609
Missouri,GRUNDY,10256,9840,92,123,416,0.959438378,0.040561622,0.01199298
Missouri,HARRISON,8901,8599,63,144,302,0.966071228,0.033928772,0.016177958
Missouri,HENRY,22234,21159,267,378,1075,0.951650625,0.048349375,0.017000989
Missouri,HICKORY,9554,8731,36,99,823,0.91385807,0.08614193,0.010362152
Missouri,HOLT,4840,4701,34,12,139,0.971280992,0.028719008,0.002479339
Missouri,HOWARD,10160,9255,533,127,905,0.910925197,0.089074803,0.0125
Missouri,HOWELL,40330,38396,136,698,1934,0.952045624,0.047954376,0.017307215
Missouri,IRON,10563,10088,121,131,475,0.955031714,0.044968286,0.01240178
Missouri,JACKSON,672784,426354,159259,55470,246430,0.633716022,0.366283978,0.082448453
Missouri,JASPER,116493,100389,2178,7891,16104,0.861759934,0.138240066,0.067737976
Missouri,JEFFERSON,218628,208509,1476,3443,10119,0.953715901,0.046284099,0.015748212
Missouri,JOHNSON,52964,46589,2324,1687,6375,0.879635224,0.120364776,0.031851824
Missouri,KNOX,4111,3993,25,16,118,0.971296522,0.028703478,0.003891997
Missouri,LACLEDE,35507,33571,234,707,1936,0.94547554,0.05452446,0.019911567
Missouri,LAFAYETTE,33278,30927,865,740,2351,0.929352726,0.070647274,0.022236913
Missouri,LAWRENCE,38559,35052,125,2420,3507,0.909048471,0.090951529,0.062760964
Missouri,LEWIS,10203,9513,306,157,690,0.932372832,0.067627168,0.015387631
Missouri,LINCOLN,52637,49472,881,1057,3165,0.939871193,0.060128807,0.020080932
Missouri,LINN,12668,12201,75,196,467,0.963135459,0.036864541,0.015472056
Missouri,LIVINGSTON,15068,14246,385,181,822,0.945447306,0.054552694,0.012012211
Missouri,MCDONALD,22970,18572,193,2542,4398,0.808532869,0.191467131,0.110666086
Missouri,MACON,15532,14700,384,158,832,0.94643317,0.05356683,0.010172547
Missouri,MADISON,12334,11885,19,233,449,0.963596562,0.036403438,0.018890871
Missouri,MARIES,9140,8833,41,83,307,0.966411379,0.033588621,0.009080963
Missouri,MARION,28703,26128,1646,396,2575,0.910288123,0.089711877,0.013796467
Missouri,MERCER,3763,3656,19,39,107,0.97156524,0.02843476,0.010364071
Missouri,MILLER,24822,23797,168,364,1025,0.958705987,0.041294013,0.014664411
Missouri,MISSISSIPPI,14231,10416,3405,239,3815,0.731923266,0.268076734,0.016794322
Missouri,MONITEAU,15587,13762,709,616,1825,0.88291525,0.11708475,0.039520113
Missouri,MONROE,8876,8367,295,85,509,0.942654349,0.057345651,0.009576386
Missouri,MONTGOMERY,12181,11585,96,174,596,0.951071341,0.048928659,0.014284541
Missouri,MORGAN,20479,19503,144,358,976,0.952341423,0.047658577,0.017481322
Missouri,NEW MADRID,18780,15221,2944,224,3559,0.810489883,0.189510117,0.011927583
Missouri,NEWTON,58314,51203,464,2574,7111,0.878056727,0.121943273,0.044140344
Missouri,NODAWAY,23305,21797,550,505,1508,0.935292856,0.064707144,0.02166917
Missouri,OREGON,10885,10388,16,140,497,0.954340836,0.045659164,0.012861736
Missouri,OSAGE,13857,13627,109,85,230,0.983401891,0.016598109,0.006134084
Missouri,OZARK,9672,9321,14,132,351,0.963709677,0.036290323,0.013647643
Missouri,PEMISCOT,18288,12712,5039,358,5576,0.695100612,0.304899388,0.019575678
Missouri,PERRY,18986,18265,109,331,721,0.96202465,0.03797535,0.017433899
Missouri,PETTIS,42044,36576,1113,3059,5468,0.869945771,0.130054229,0.072757112
Missouri,PHELPS,44825,40419,882,930,4406,0.901706637,0.098293363,0.020747351
Missouri,PIKE,18574,16510,1207,353,2064,0.888876925,0.111123075,0.019005061
Missouri,PLATTE,89567,75512,5196,4495,14055,0.843078366,0.156921634,0.050185894
Missouri,POLK,31035,29476,248,593,1559,0.949766393,0.050233607,0.019107459
Missouri,PULASKI,51620,37337,5676,4672,14283,0.723304921,0.276695079,0.090507555
Missouri,PUTNAM,4976,4858,25,37,118,0.976286174,0.023713826,0.007435691
Missouri,RALLS,10198,9849,39,103,349,0.965777603,0.034222397,0.01010002
Missouri,RANDOLPH,25388,22705,1644,419,2683,0.894320151,0.105679849,0.01650386
Missouri,RAY,23422,22244,311,431,1178,0.949705405,0.050294595,0.018401503
Missouri,REYNOLDS,6682,6403,59,66,279,0.958246034,0.041753966,0.009877282
Missouri,RIPLEY,14070,13501,49,155,569,0.959559346,0.040440654,0.011016347
Missouri,ST. CHARLES,360695,321309,15732,10060,39386,0.890805251,0.109194749,0.0278906
Missouri,ST. CLAIR,9693,9253,64,167,440,0.954606417,0.045393583,0.017228928
Missouri,STE. GENEVIEVE,18066,17506,137,151,560,0.969002546,0.030997454,0.008358242
Missouri,ST. FRANCOIS,65246,60506,3035,797,4740,0.927351868,0.072648132,0.012215308
Missouri,ST. LOUIS,999147,688471,230273,25016,310676,0.689058767,0.310941233,0.025037357
Missouri,SALINE,23232,19302,1321,1935,3930,0.830836777,0.169163223,0.083290289
Missouri,SCHUYLER,4397,4316,41,3,81,0.981578349,0.018421651,0.000682283
Missouri,SCOTLAND,4843,4760,7,47,83,0.982861862,0.017138138,0.009704728
Missouri,SCOTT,39192,33262,4445,706,5930,0.848693611,0.151306389,0.01801388
Missouri,SHANNON,8407,7973,49,139,434,0.948376353,0.051623647,0.016533841
Missouri,SHELBY,6328,6155,78,46,173,0.972661188,0.027338812,0.007269279
Missouri,STODDARD,29902,28815,426,366,1087,0.963647917,0.036352083,0.012239984
Missouri,STONE,31968,27619,38,568,4349,0.863957708,0.136042292,0.017767768
Missouri,SULLIVAN,6667,5341,22,1212,1326,0.801109945,0.198890055,0.18179091
Missouri,TANEY,51596,47014,90,2481,4582,0.911194666,0.088805334,0.048085123
Missouri,TEXAS,25840,23828,831,441,2012,0.922136223,0.077863777,0.017066563
Missouri,VERNON,20958,19937,127,342,1021,0.951283519,0.048716481,0.016318351
Missouri,WARREN,32440,30094,540,943,2346,0.927681874,0.072318126,0.029069051
Missouri,WASHINGTON,25120,23885,524,264,1235,0.950835987,0.049164013,0.010509554
Missouri,WAYNE,13444,12967,34,151,477,0.964519488,0.035480512,0.011231776
Missouri,WEBSTER,36183,34420,419,618,1763,0.951275461,0.048724539,0.017079844
Missouri,WORTH,2146,2117,0,6,29,0.986486486,0.013513514,0.002795899
Missouri,WRIGHT,18732,18014,118,253,718,0.96166987,0.03833013,0.013506299
Missouri,ST. LOUIS CITY,318527,134581,155495,11005,183946,0.422510494,0.577489506,0.034549661
Montana,BEAVERHEAD,9228,8537,20,337,691,0.925119202,0.074880798,0.036519289
Montana,BIG HORN,12872,3921,1,552,8951,0.304614667,0.695385333,0.042883779
Montana,BLAINE,6514,3133,0,119,3381,0.480964077,0.519035923,0.018268345
Montana,BROADWATER,5575,5268,36,58,307,0.944932735,0.055067265,0.010403587
Montana,CARBON,10057,9623,6,204,434,0.956845978,0.043154022,0.020284379
Montana,CARTER,1276,1252,0,5,24,0.981191223,0.018808777,0.003918495
Montana,CASCADE,81248,70888,836,2810,10360,0.872489169,0.127510831,0.034585467
Montana,CHOUTEAU,5811,4415,0,96,1396,0.759765961,0.240234039,0.016520392
Montana,CUSTER,11706,11005,28,268,701,0.94011618,0.05988382,0.022894242
Montana,DANIELS,1734,1625,0,4,109,0.937139562,0.062860438,0.002306805
Montana,DAWSON,9022,8517,17,190,505,0.944025715,0.055974285,0.021059632
Montana,DEER LODGE,9277,8506,59,262,771,0.916891236,0.083108764,0.028241889
Montana,FALLON,3051,2979,0,11,72,0.97640118,0.02359882,0.003605375
Montana,FERGUS,11507,10989,11,180,518,0.954983923,0.045016077,0.015642652
Montana,FLATHEAD,90967,85418,209,2131,5549,0.938999857,0.061000143,0.023426078
Montana,GALLATIN,90339,84260,344,2508,6079,0.932709018,0.067290982,0.027762096
Montana,GARFIELD,1100,1072,0,4,28,0.974545455,0.025454545,0.003636364
Montana,GLACIER,13422,4202,1,265,9220,0.313068097,0.686931903,0.019743704
Montana,GOLDEN VALLEY,769,757,0,9,12,0.984395319,0.015604681,0.011703511
Montana,GRANITE,3083,2964,4,48,119,0.961401233,0.038598767,0.015569251
Montana,HILL,16157,11718,33,382,4439,0.725258402,0.274741598,0.023643003
Montana,JEFFERSON,11360,10686,73,220,674,0.940669014,0.059330986,0.019366197
Montana,JUDITH BASIN,2052,2011,0,16,41,0.980019493,0.019980507,0.007797271
Montana,LAKE,28794,19625,60,1028,9169,0.681565604,0.318434396,0.035701882
Montana,LEWIS AND CLARK,63432,58616,254,1611,4816,0.924076176,0.075923824,0.025397276
Montana,LIBERTY,2326,2246,8,0,80,0.965606191,0.034393809,0
Montana,LINCOLN,19594,18450,54,467,1144,0.94161478,0.05838522,0.023833827
Montana,MCCONE,1808,1764,0,0,44,0.975663717,0.024336283,0
Montana,MADISON,7688,7322,15,191,366,0.95239334,0.04760666,0.024843913
Montana,MEAGHER,1900,1869,0,15,31,0.983684211,0.016315789,0.007894737
Montana,MINERAL,4203,3922,95,85,281,0.933142993,0.066857007,0.02022365
Montana,MISSOULA,109402,99452,453,2911,9950,0.909051023,0.090948977,0.026608289
Montana,MUSSELSHELL,4597,4330,12,116,267,0.941918643,0.058081357,0.025233848
Montana,PARK,15655,14893,24,340,762,0.951325455,0.048674545,0.021718301
Montana,PETROLEUM,566,515,12,30,51,0.909893993,0.090106007,0.053003534
Montana,PHILLIPS,4203,3622,0,23,581,0.861765406,0.138234594,0.005472282
Montana,PONDERA,6147,5027,30,88,1120,0.817797299,0.182202701,0.014315926
Montana,POWDER RIVER,1639,1548,0,29,91,0.94447834,0.05552166,0.017693716
Montana,POWELL,7067,6444,24,146,623,0.911843781,0.088156219,0.020659403
Montana,PRAIRIE,1193,1137,0,6,56,0.953059514,0.046940486,0.005029338
Montana,RAVALLI,40311,37840,111,1203,2471,0.938701595,0.061298405,0.029842971
Montana,RICHLAND,9961,9267,43,323,694,0.93032828,0.06967172,0.032426463
Montana,ROOSEVELT,10477,3758,5,147,6719,0.358690465,0.641309535,0.014030734
Montana,ROSEBUD,9261,5544,47,318,3717,0.598639456,0.401360544,0.034337545
Montana,SANDERS,11421,10337,26,243,1084,0.90508712,0.09491288,0.021276596
Montana,SHERIDAN,3447,3269,6,22,178,0.948360894,0.051639106,0.006382361
Montana,SILVER BOW,34164,31484,71,1265,2680,0.921554853,0.078445147,0.03702728
Montana,STILLWATER,9096,8659,15,220,437,0.951956904,0.048043096,0.024186456
Montana,SWEET GRASS,3661,3533,0,85,128,0.965036875,0.034963125,0.0232177
Montana,TETON,6082,5777,5,82,305,0.949852022,0.050147978,0.013482407
Montana,TOOLE,5210,4664,17,146,546,0.895201536,0.104798464,0.028023033
Montana,TREASURE,698,600,0,59,98,0.859598854,0.140401146,0.084527221
Montana,VALLEY,7423,6404,9,99,1019,0.862723966,0.137276034,0.013336926
Montana,WHEATLAND,2142,2089,0,9,53,0.975256769,0.024743231,0.004201681
Montana,WIBAUX,899,883,9,7,16,0.982202447,0.017797553,0.007786429
Montana,YELLOWSTONE,148191,130270,853,6991,17921,0.87906823,0.12093177,0.047175604
Nebraska,ADAMS,31299,27743,204,2457,3556,0.886386147,0.113613853,0.078500911
Nebraska,ANTELOPE,6655,6400,10,179,255,0.961682945,0.038317055,0.02689707
Nebraska,ARTHUR,490,487,0,0,3,0.993877551,0.006122449,0
Nebraska,BANNER,778,724,14,29,54,0.93059126,0.06940874,0.037275064
Nebraska,BLAINE,584,568,0,0,16,0.97260274,0.02739726,0
Nebraska,BOONE,5473,5394,1,63,79,0.985565503,0.014434497,0.011511054
Nebraska,BOX BUTTE,11345,9534,11,1183,1811,0.840370207,0.159629793,0.104275011
Nebraska,BOYD,2025,1983,20,12,42,0.979259259,0.020740741,0.005925926
Nebraska,BROWN,3183,3108,4,23,75,0.976437323,0.023562677,0.007225888
Nebraska,BUFFALO,46330,41307,332,3451,5023,0.891582128,0.108417872,0.074487373
Nebraska,BURT,6829,6472,32,145,357,0.947722946,0.052277054,0.021232977
Nebraska,BUTLER,8345,8028,75,206,317,0.962013182,0.037986818,0.02468544
Nebraska,CASS,25214,24041,163,636,1173,0.953478226,0.046521774,0.025224082
Nebraska,CEDAR,8807,8607,12,117,200,0.977290791,0.022709209,0.013284887
Nebraska,CHASE,3964,3507,1,438,457,0.884712412,0.115287588,0.11049445
Nebraska,CHERRY,5722,5155,13,195,567,0.900908773,0.099091227,0.034078993
Nebraska,CHEYENNE,10038,9123,24,600,915,0.908846384,0.091153616,0.059772863
Nebraska,CLAY,6497,5908,14,486,589,0.909342774,0.090657226,0.074803756
Nebraska,COLFAX,10453,6012,89,4257,4441,0.575145891,0.424854109,0.407251507
Nebraska,CUMING,9140,8247,2,759,893,0.902297593,0.097702407,0.083041575
Nebraska,CUSTER,10904,10508,15,221,396,0.963683052,0.036316948,0.020267792
Nebraska,DAKOTA,20869,11611,744,7294,9258,0.556375485,0.443624515,0.349513633
Nebraska,DAWES,9176,8041,190,318,1135,0.876307759,0.123692241,0.034655623
Nebraska,DAWSON,24267,15466,768,7671,8801,0.63732641,0.36267359,0.316108295
Nebraska,DEUEL,1962,1873,7,63,89,0.954638124,0.045361876,0.032110092
Nebraska,DIXON,5982,5262,9,630,720,0.879638917,0.120361083,0.105315948
Nebraska,DODGE,36590,32142,125,3582,4448,0.878436731,0.121563269,0.0978956
Nebraska,DOUGLAS,518271,373503,57937,57608,144768,0.720671232,0.279328768,0.111154203
Nebraska,DUNDY,1996,1872,3,113,124,0.937875752,0.062124248,0.056613226
Nebraska,FILLMORE,5867,5598,37,179,269,0.954150332,0.045849668,0.03050963
Nebraska,FRANKLIN,3196,3113,7,36,83,0.974030038,0.025969962,0.01126408
Nebraska,FRONTIER,2693,2644,7,18,49,0.981804679,0.018195321,0.006683996
Nebraska,FURNAS,4922,4703,7,138,219,0.955505892,0.044494108,0.028037383
Nebraska,GAGE,22209,21298,34,395,911,0.958980593,0.041019407,0.017785582
Nebraska,GARDEN,2011,1845,0,115,166,0.917454003,0.082545997,0.05718548
Nebraska,GARFIELD,2106,2078,13,0,28,0.986704653,0.013295347,0
Nebraska,GOSPER,2020,1908,12,70,112,0.944554455,0.055445545,0.034653465
Nebraska,GRANT,608,600,0,7,8,0.986842105,0.013157895,0.011513158
Nebraska,GREELEY,2515,2428,14,67,87,0.965407555,0.034592445,0.026640159
Nebraska,HALL,58681,42635,1104,13616,16046,0.726555444,0.273444556,0.232034219
Nebraska,HAMILTON,9096,8797,16,191,299,0.967128408,0.032871592,0.020998241
Nebraska,HARLAN,3419,3342,3,39,77,0.977478795,0.022521205,0.011406844
Nebraska,HAYES,1037,978,2,51,59,0.943105111,0.056894889,0.049180328
Nebraska,HITCHCOCK,2898,2805,3,51,93,0.967908903,0.032091097,0.017598344
Nebraska,HOLT,10418,9999,2,310,419,0.959781148,0.040218852,0.029756191
Nebraska,HOOKER,689,670,0,11,19,0.972423803,0.027576197,0.015965167
Nebraska,HOWARD,6294,6077,36,118,217,0.96552272,0.03447728,0.018748014
Nebraska,JEFFERSON,7572,7231,5,213,341,0.954965663,0.045034337,0.028129952
Nebraska,JOHNSON,5188,4300,273,454,888,0.828835775,0.171164225,0.087509638
Nebraska,KEARNEY,6514,6167,4,258,347,0.94673012,0.05326988,0.039607
Nebraska,KEITH,8284,7639,15,465,645,0.922139063,0.077860937,0.056132303
Nebraska,KEYA PAHA,742,731,0,0,11,0.985175202,0.014824798,0
Nebraska,KIMBALL,3789,3408,30,268,381,0.899445764,0.100554236,0.070731064
Nebraska,KNOX,8648,7627,41,161,1021,0.88193802,0.11806198,0.018617021
Nebraska,LANCASTER,286425,241832,10055,16766,44593,0.844311774,0.155688226,0.058535393
Nebraska,LINCOLN,36212,32627,242,2638,3585,0.900999669,0.099000331,0.072848779
Nebraska,LOGAN,724,717,0,7,7,0.990331492,0.009668508,0.009668508
Nebraska,LOUP,534,495,0,18,39,0.926966292,0.073033708,0.033707865
Nebraska,MCPHERSON,348,348,0,0,0,1,0,0
Nebraska,MADISON,34766,29025,431,4457,5741,0.834867399,0.165132601,0.128199965
Nebraska,MERRICK,7779,7327,41,274,452,0.941894845,0.058105155,0.035223036
Nebraska,MORRILL,4993,4222,4,670,771,0.845583817,0.154416183,0.134187863
Nebraska,NANCE,3730,3632,4,78,98,0.973726542,0.026273458,0.020911528
Nebraska,NEMAHA,7224,6899,45,138,325,0.955011074,0.044988926,0.01910299
Nebraska,NUCKOLLS,4490,4325,18,95,165,0.96325167,0.03674833,0.021158129
Nebraska,OTOE,15729,14481,23,899,1248,0.920656113,0.079343887,0.057155573
Nebraska,PAWNEE,2753,2692,0,38,61,0.977842354,0.022157646,0.013803124
Nebraska,PERKINS,2947,2838,0,93,109,0.963013234,0.036986766,0.031557516
Nebraska,PHELPS,9184,8677,11,386,507,0.944795296,0.055204704,0.042029617
Nebraska,PIERCE,7231,7052,6,97,179,0.975245471,0.024754529,0.013414465
Nebraska,PLATTE,32195,27131,33,4449,5064,0.842708495,0.157291505,0.13818916
Nebraska,POLK,5371,5143,8,159,228,0.957549805,0.042450195,0.029603426
Nebraska,RED WILLOW,11013,10299,92,456,714,0.935167529,0.064832471,0.041405612
Nebraska,RICHARDSON,8355,7815,7,114,540,0.935368043,0.064631957,0.013644524
Nebraska,ROCK,1540,1477,12,19,63,0.959090909,0.040909091,0.012337662
Nebraska,SALINE,14278,10879,190,2889,3399,0.761941448,0.238058552,0.202339263
Nebraska,SARPY,159413,133512,6189,11625,25901,0.837522661,0.162477339,0.072923789
Nebraska,SAUNDERS,20696,19899,56,424,797,0.961490143,0.038509857,0.020487051
Nebraska,SCOTTS BLUFF,36835,27766,176,7783,9069,0.753793946,0.246206054,0.211293607
Nebraska,SEWARD,16729,16101,82,285,628,0.962460398,0.037539602,0.017036284
Nebraska,SHERIDAN,5432,4541,9,168,891,0.835972018,0.164027982,0.030927835
Nebraska,SHERMAN,3133,3068,30,26,65,0.979253112,0.020746888,0.008298755
Nebraska,SIOUX,1262,1220,0,33,42,0.966719493,0.033280507,0.02614897
Nebraska,STANTON,6139,5740,23,152,399,0.935005701,0.064994299,0.024759733
Nebraska,THAYER,5195,5035,6,81,160,0.969201155,0.030798845,0.015591915
Nebraska,THOMAS,831,789,6,0,42,0.949458484,0.050541516,0
Nebraska,THURSTON,6926,2681,33,243,4245,0.387092117,0.612907883,0.035085186
Nebraska,VALLEY,4322,4211,1,58,111,0.974317446,0.025682554,0.013419713
Nebraska,WASHINGTON,20201,19364,100,422,837,0.958566408,0.041433592,0.020890055
Nebraska,WAYNE,9542,8826,137,412,716,0.92496332,0.07503668,0.043177531
Nebraska,WEBSTER,3773,3546,4,130,227,0.939835675,0.060164325,0.034455341
Nebraska,WHEELER,725,679,0,42,46,0.936551724,0.063448276,0.057931034
Nebraska,YORK,13727,12786,86,564,941,0.931448969,0.068551031,0.041086909
Nevada,CHURCHILL,24779,18837,411,3037,5942,0.760200169,0.239799831,0.122563461
Nevada,CLARK,1954773,937276,197266,569262,1017497,0.479480738,0.520519262,0.291216423
Nevada,DOUGLAS,47056,39071,189,5127,7985,0.830308569,0.169691431,0.108955287
Nevada,ELKO,49133,33846,431,11299,15287,0.688864918,0.311135082,0.229967639
Nevada,ESMERALDA,916,725,7,144,191,0.791484716,0.208515284,0.15720524
Nevada,EUREKA,1809,1601,11,121,208,0.885019348,0.114980652,0.066887783
Nevada,HUMBOLDT,16511,11386,44,4018,5125,0.689600872,0.310399128,0.243352916
Nevada,LANDER,5751,3949,8,1413,1802,0.686663189,0.313336811,0.245696401
Nevada,LINCOLN,5282,4408,159,380,874,0.834532374,0.165467626,0.071942446
Nevada,LYON,51797,40379,428,7733,11418,0.779562523,0.220437477,0.149294361
Nevada,MINERAL,4718,3348,85,444,1370,0.709622721,0.290377279,0.094107673
Nevada,NYE,43801,34455,1022,5983,9346,0.786625876,0.213374124,0.136595055
Nevada,PERSHING,6707,4547,277,1508,2160,0.677948412,0.322051588,0.22483972
Nevada,STOREY,4010,3682,15,106,328,0.918204489,0.081795511,0.026433915
Nevada,WASHOE,422010,278383,9678,94144,143627,0.659659724,0.340340276,0.223084761
Nevada,WHITE PINE,9967,7597,236,1316,2370,0.762215311,0.237784689,0.132035718
Nevada,CARSON CITY,55184,38910,515,11800,16274,0.70509568,0.29490432,0.213830096
New Hampshire,BELKNAP,60206,57506,349,770,2700,0.955153971,0.044846029,0.012789423
New Hampshire,CARROLL,47761,46207,63,498,1554,0.967462993,0.032537007,0.010426917
New Hampshire,CHESHIRE,77106,73500,429,1119,3606,0.953233211,0.046766789,0.014512489
New Hampshire,COOS,32872,31596,186,398,1276,0.96118277,0.03881723,0.012107569
New Hampshire,GRAFTON,88985,82191,785,1641,6794,0.923650053,0.076349947,0.01844131
New Hampshire,HILLSBOROUGH,401101,351250,7750,21391,49851,0.875714596,0.124285404,0.053330707
New Hampshire,MERRIMACK,146742,138263,1485,2408,8479,0.942218315,0.057781685,0.016409753
New Hampshire,ROCKINGHAM,295872,278258,2042,6349,17614,0.940467499,0.059532501,0.021458604
New Hampshire,STRAFFORD,123295,114270,1044,2276,9025,0.926801573,0.073198427,0.018459792
New Hampshire,SULLIVAN,43534,41834,156,505,1700,0.960950062,0.039049938,0.011600129
New Jersey,ATLANTIC,274402,160449,41207,46303,113953,0.584722415,0.415277585,0.168741481
New Jersey,BERGEN,906781,565170,46744,146451,341611,0.623270668,0.376729332,0.161506472
New Jersey,BURLINGTON,449117,316918,70614,29225,132199,0.705646858,0.294353142,0.06507213
New Jersey,CAMDEN,513660,309269,92997,73288,204391,0.60208893,0.39791107,0.142678036
New Jersey,CAPE MAY,96987,84300,4493,5975,12687,0.869188654,0.130811346,0.061606195
New Jersey,CUMBERLAND,156864,78947,29411,42250,77917,0.503283099,0.496716901,0.269341595
New Jersey,ESSEX,783840,262029,308196,159546,521811,0.334288885,0.665711115,0.203544091
New Jersey,GLOUCESTER,288187,233131,27841,13801,55056,0.808957378,0.191042622,0.047889044
New Jersey,HUDSON,636194,194810,72299,268575,441384,0.306211627,0.693788373,0.422158964
New Jersey,HUNTERDON,127996,112173,3225,6799,15823,0.876378949,0.123621051,0.053118847
New Jersey,MERCER,366442,199493,71618,55297,166949,0.54440539,0.45559461,0.150902462
New Jersey,MIDDLESEX,811064,398992,71921,149204,412072,0.491936518,0.508063482,0.183960822
New Jersey,MONMOUTH,629263,483862,43599,60432,145401,0.768934452,0.231065548,0.096036157
New Jersey,MORRIS,493472,369189,14583,56653,124283,0.748145791,0.251854209,0.114804893
New Jersey,OCEAN,575961,494683,16708,47476,81278,0.858882806,0.141117194,0.082429192
New Jersey,PASSAIC,500168,226183,56037,185476,273985,0.452214056,0.547785944,0.370827402
New Jersey,SALEM,66007,50557,9207,4510,15450,0.765933916,0.234066084,0.068326087
New Jersey,SOMERSET,323650,201972,27315,41986,121678,0.624044493,0.375955507,0.129726556
New Jersey,SUSSEX,148962,132081,2697,9682,16881,0.886675797,0.113324203,0.064996442
New Jersey,UNION,536383,242046,110667,147010,294337,0.451255912,0.548744088,0.274076546
New Jersey,WARREN,108488,92570,3886,7741,15918,0.853274095,0.146725905,0.071353514
New Mexico,BERNALILLO,661924,275166,16329,316307,386758,0.415706335,0.584293665,0.477859996
New Mexico,CATRON,3686,2709,0,798,977,0.734943028,0.265056972,0.216494845
New Mexico,CHAVES,65343,28714,995,34009,36629,0.439434982,0.560565018,0.52046891
New Mexico,CIBOLA,27293,5881,78,10004,21412,0.215476496,0.784523504,0.366540871
New Mexico,COLFAX,13614,6751,23,6464,6863,0.495886587,0.504113413,0.474805347
New Mexico,CURRY,48101,24414,2764,18986,23687,0.507557015,0.492442985,0.394711129
New Mexico,DE BACA,2069,1122,2,904,947,0.542290962,0.457709038,0.436926051
New Mexico,EDDY,53693,27897,262,23702,25796,0.519564934,0.480435066,0.441435569
New Mexico,GRANT,29602,14297,31,14348,15305,0.482974123,0.517025877,0.48469698
New Mexico,GUADALUPE,4655,891,66,3538,3764,0.191407089,0.808592911,0.760042965
New Mexico,HARDING,612,328,0,270,284,0.535947712,0.464052288,0.441176471
New Mexico,HIDALGO,4903,2019,67,2769,2884,0.411788701,0.588211299,0.564756272
New Mexico,LEA,64670,27697,2308,33141,36973,0.428282047,0.571717953,0.512463275
New Mexico,LINCOLN,20440,13420,82,6146,7020,0.656555773,0.343444227,0.300684932
New Mexico,LOS ALAMOS,18008,13642,78,2692,4366,0.757552199,0.242447801,0.149489116
New Mexico,LUNA,25162,8990,196,15526,16172,0.357284795,0.642715205,0.617041571
New Mexico,MCKINLEY,71888,7413,353,9744,64475,0.10311874,0.89688126,0.13554418
New Mexico,MORA,4830,912,1,3874,3918,0.188819876,0.811180124,0.802070393
New Mexico,OTERO,64176,33802,2236,22294,30374,0.526707804,0.473292196,0.347388432
New Mexico,QUAY,8956,4750,97,3804,4206,0.530370701,0.469629299,0.424743189
New Mexico,RIO ARRIBA,40201,5370,149,28714,34831,0.133578767,0.866421233,0.714260839
New Mexico,ROOSEVELT,19840,11011,423,7896,8829,0.554989919,0.445010081,0.397983871
New Mexico,SANDOVAL,131302,61977,2704,46334,69325,0.472018705,0.527981295,0.352881144
New Mexico,SAN JUAN,128600,54218,794,24496,74382,0.421601866,0.578398134,0.190482115
New Mexico,SAN MIGUEL,29225,5752,289,22476,23473,0.196817793,0.803182207,0.769067579
New Mexico,SANTA FE,144209,63298,895,73005,80911,0.438932383,0.561067617,0.506244409
New Mexico,SIERRA,11956,8436,36,3343,3520,0.705587153,0.294412847,0.279608565
New Mexico,SOCORRO,17843,6745,166,8652,11098,0.378019391,0.621980609,0.484896038
New Mexico,TAOS,32775,11854,158,18376,20921,0.361678108,0.638321892,0.560671243
New Mexico,TORRANCE,16285,9427,82,6391,6858,0.578876267,0.421123733,0.392447037
New Mexico,UNION,4460,2494,94,1772,1966,0.559192825,0.440807175,0.397309417
New Mexico,VALENCIA,76172,27543,906,44347,48629,0.36158956,0.63841044,0.582195557
New York,ALBANY,304511,231180,36157,15091,73331,0.759184397,0.240815603,0.049558144
New York,ALLEGANY,48837,46573,556,686,2264,0.953641706,0.046358294,0.014046727
New York,BRONX,1386364,151578,419791,741954,1234786,0.109334922,0.890665078,0.535179794
New York,BROOME,199928,172532,8847,6771,27396,0.862970669,0.137029331,0.033867192
New York,CATTARAUGUS,80166,73650,1068,1385,6516,0.918718659,0.081281341,0.017276651
New York,CAYUGA,79996,73079,3144,1927,6917,0.913533177,0.086466823,0.024088704
New York,CHAUTAUQUA,134599,120074,2825,8257,14525,0.892086865,0.107913135,0.061345181
New York,CHEMUNG,88779,77618,5332,2288,11161,0.874283333,0.125716667,0.02577186
New York,CHENANGO,50490,48268,279,946,2222,0.955991285,0.044008715,0.018736383
New York,CLINTON,82054,74688,3132,2096,7366,0.910229849,0.089770151,0.025544154
New York,COLUMBIA,62881,55482,2683,2456,7399,0.882333296,0.117666704,0.039057903
New York,CORTLAND,49453,46247,626,1145,3206,0.935170768,0.064829232,0.023153297
New York,DELAWARE,47851,44564,720,1557,3287,0.931307601,0.068692399,0.032538505
New York,DUTCHESS,297291,221391,27120,31060,75900,0.744694592,0.255305408,0.104476758
New York,ERIE,919542,714236,119034,41901,205306,0.776730155,0.223269845,0.04556725
New York,ESSEX,39309,36443,1125,1005,2866,0.927090488,0.072909512,0.025566664
New York,FRANKLIN,51698,42597,3190,1595,9101,0.823958374,0.176041626,0.030852257
New York,FULTON,55358,51947,826,1307,3411,0.93838289,0.06161711,0.023609957
New York,GENESEE,59992,54953,1383,1609,5039,0.916005467,0.083994533,0.026820243
New York,GREENE,49122,42759,2684,2459,6363,0.870465372,0.129534628,0.050059037
New York,HAMILTON,4835,4664,39,52,171,0.964632885,0.035367115,0.010754912
New York,HERKIMER,64475,61662,574,1058,2813,0.956370686,0.043629314,0.016409461
New York,JEFFERSON,117011,99527,5326,6651,17484,0.850578151,0.149421849,0.05684081
New York,KINGS,2512740,896464,809821,497620,1616276,0.356767513,0.643232487,0.198038794
New York,LEWIS,27062,26172,243,355,890,0.967112556,0.032887444,0.013118025
New York,LIVINGSTON,65215,60054,1395,1838,5161,0.920861765,0.079138235,0.0281837
New York,MADISON,72977,68485,1215,1334,4492,0.93844636,0.06155364,0.018279732
New York,MONROE,744746,541857,107569,53985,202889,0.727572891,0.272427109,0.072487801
New York,MONTGOMERY,50025,42502,674,5681,7523,0.849615192,0.150384808,0.113563218
New York,NASSAU,1338712,875171,142160,195287,463541,0.653741059,0.346258941,0.145876783
New York,NEW YORK,1596735,762321,207912,409298,834414,0.47742487,0.52257513,0.256334332
New York,NIAGARA,215869,188402,15084,4734,27467,0.872760795,0.127239205,0.021929967
New York,ONEIDA,234336,198819,12529,10884,35517,0.84843558,0.15156442,0.046446129
New York,ONONDAGA,466179,369541,48852,18879,96638,0.792701945,0.207298055,0.04049732
New York,ONTARIO,107728,98745,2072,3759,8983,0.916614065,0.083385935,0.034893435
New York,ORANGE,372951,254662,34472,67082,118289,0.682829648,0.317170352,0.179868133
New York,ORLEANS,42995,37561,2540,1783,5434,0.873613211,0.126386789,0.041469938
New York,OSWEGO,122055,116035,869,2578,6020,0.950677973,0.049322027,0.021121625
New York,OTSEGO,62147,57575,1104,1941,4572,0.926432491,0.073567509,0.031232401
New York,PUTNAM,99702,82530,1980,11596,17172,0.827766745,0.172233255,0.116306594
New York,QUEENS,2235008,616029,395583,614147,1618979,0.275627201,0.724372799,0.274785146
New York,RENSSELAER,159464,136628,8775,6135,22836,0.856795264,0.143204736,0.038472633
New York,RICHMOND,468374,300585,44665,80439,167789,0.641762779,0.358237221,0.171740959
New York,ROCKLAND,312011,203466,35330,48716,108545,0.652111624,0.347888376,0.156135521
New York,ST. LAWRENCE,112060,103921,2780,2224,8139,0.927369266,0.072630734,0.019846511
New York,SARATOGA,219832,203720,2963,5392,16112,0.926707668,0.073292332,0.024527821
New York,SCHENECTADY,154466,119671,14102,8818,34795,0.774740072,0.225259928,0.057086996
New York,SCHOHARIE,32617,30642,419,923,1975,0.939448754,0.060551246,0.028298127
New York,SCHUYLER,18472,17740,184,258,732,0.960372456,0.039627544,0.013967085
New York,SENECA,35306,31960,1576,993,3346,0.905228573,0.094771427,0.028125531
New York,STEUBEN,98992,93469,1641,1388,5523,0.944207613,0.055792387,0.014021335
New York,SUFFOLK,1492360,1068747,103997,245810,423613,0.716145568,0.283854432,0.164712268
New York,SULLIVAN,77340,57720,5926,10526,19620,0.746314973,0.253685027,0.136100336
New York,TIOGA,51067,48958,287,713,2109,0.958701314,0.041298686,0.01396205
New York,TOMPKINS,101570,81147,3690,4379,20423,0.798926848,0.201073152,0.043113124
New York,ULSTER,182516,148919,9585,16044,33597,0.815922988,0.184077012,0.087904622
New York,WARREN,65700,62553,638,1195,3147,0.952100457,0.047899543,0.018188737
New York,WASHINGTON,63108,58878,1720,1464,4230,0.932972048,0.067027952,0.023198327
New York,WAYNE,93476,84992,3177,3462,8484,0.909238735,0.090761265,0.037036245
New York,WESTCHESTER,950227,545910,126805,207229,404317,0.574504829,0.425495171,0.218083679
New York,WYOMING,42092,37906,2268,1261,4186,0.900551174,0.099448826,0.029958187
New York,YATES,25351,24362,180,439,989,0.960987732,0.039012268,0.017316871
North Carolina,ALAMANCE,151170,101594,27033,16684,49576,0.672051333,0.327948667,0.110365813
North Carolina,ALEXANDER,37014,32471,2021,1569,4543,0.877262657,0.122737343,0.042389366
North Carolina,ALLEGHANY,11069,9756,128,991,1313,0.881380432,0.118619568,0.089529316
North Carolina,ANSON,26699,12220,12952,797,14479,0.457695045,0.542304955,0.029851305
North Carolina,ASHE,27099,25260,109,1278,1839,0.932137717,0.067862283,0.047160412
North Carolina,AVERY,17815,15114,687,788,2701,0.848386191,0.151613809,0.044232388
North Carolina,BEAUFORT,47542,31498,12341,3190,16044,0.662529973,0.337470027,0.067098565
North Carolina,BERTIE,21035,7340,13240,197,13695,0.348942239,0.651057761,0.009365343
North Carolina,BLADEN,34922,19119,11873,2418,15803,0.547477235,0.452522765,0.069240021
North Carolina,BRUNSWICK,107925,87435,11886,5412,20490,0.810145935,0.189854065,0.050145935
North Carolina,BUNCOMBE,239000,201957,14767,14191,37043,0.845008368,0.154991632,0.059376569
North Carolina,BURKE,90821,75230,5973,4758,15591,0.828332654,0.171667346,0.052388765
North Carolina,CABARRUS,178396,127546,27037,16743,50850,0.714959977,0.285040023,0.093853001
North Carolina,CALDWELL,82493,73032,3836,3796,9461,0.885311481,0.114688519,0.046016026
North Carolina,CAMDEN,9965,8007,1305,219,1958,0.803512293,0.196487707,0.021976919
North Carolina,CARTERET,66415,58005,4063,2278,8410,0.873371979,0.126628021,0.034299481
North Carolina,CASWELL,23615,14432,7915,757,9183,0.611136989,0.388863011,0.032055897
North Carolina,CATAWBA,154201,120326,12779,12916,33875,0.780319194,0.219680806,0.083760806
North Carolina,CHATHAM,63896,45602,8401,8136,18294,0.713690998,0.286309002,0.127331914
North Carolina,CHEROKEE,27304,25151,206,687,2153,0.921147085,0.078852915,0.025161149
North Carolina,CHOWAN,14825,9015,5064,480,5810,0.608094435,0.391905565,0.03237774
North Carolina,CLAY,10575,10094,82,261,481,0.954515366,0.045484634,0.024680851
North Carolina,CLEVELAND,97890,72696,20406,2791,25194,0.742629482,0.257370518,0.028511595
North Carolina,COLUMBUS,57612,34829,17499,2579,22783,0.604544192,0.395455808,0.04476498
North Carolina,CRAVEN,102904,69033,22181,6303,33871,0.670848558,0.329151442,0.061251263
North Carolina,CUMBERLAND,319329,150579,112201,30374,168750,0.471548153,0.528451847,0.095118201
North Carolina,CURRITUCK,23677,20937,1424,721,2740,0.88427588,0.11572412,0.030451493
North Carolina,DARE,34019,30178,1389,2131,3841,0.887092507,0.112907493,0.062641465
North Carolina,DAVIDSON,162628,133429,14818,10256,29199,0.820455272,0.179544728,0.063064171
North Carolina,DAVIE,41183,35134,2799,2494,6049,0.853119005,0.146880995,0.060558969
North Carolina,DUPLIN,58510,30839,14844,12045,27671,0.527072295,0.472927705,0.205862246
North Carolina,DURHAM,269283,113996,99890,35528,155287,0.423331588,0.576668412,0.131935547
North Carolina,EDGECOMBE,56253,21172,32138,2097,35081,0.376371038,0.623628962,0.037278012
North Carolina,FORSYTH,351368,206789,90942,41351,144579,0.588525421,0.411474579,0.117685731
North Carolina,FRANKLIN,60470,38474,15534,4673,21996,0.63624938,0.36375062,0.077277989
North Carolina,GASTON,206291,156355,30752,12199,49936,0.75793418,0.24206582,0.059134911
North Carolina,GATES,12069,7576,4129,177,4493,0.627723921,0.372276079,0.014665672
North Carolina,GRAHAM,8766,7825,48,200,941,0.892653434,0.107346566,0.022815423
North Carolina,GRANVILLE,59666,34409,19266,4451,25257,0.576693594,0.423306406,0.074598599
North Carolina,GREENE,21386,10117,7902,3006,11269,0.473066492,0.526933508,0.140559244
North Carolina,GUILFORD,489576,265339,157538,34642,224237,0.541977139,0.458022861,0.070759188
North Carolina,HALIFAX,54693,21560,28009,1182,33133,0.394200355,0.605799645,0.021611541
North Carolina,HARNETT,115559,74197,23682,12403,41362,0.642070284,0.357929716,0.107330455
North Carolina,HAYWOOD,58915,55309,554,1944,3606,0.938793177,0.061206823,0.03299669
North Carolina,HENDERSON,106577,89990,3569,10338,16587,0.844366045,0.155633955,0.097000291
North Carolina,HERTFORD,24525,8311,14633,675,16214,0.338878695,0.661121305,0.027522936
North Carolina,HOKE,47368,19365,15626,5820,28003,0.408820301,0.591179699,0.122867759
North Carolina,HYDE,5810,3411,1995,359,2399,0.587091222,0.412908778,0.061790017
North Carolina,IREDELL,159614,124271,19098,10758,35343,0.778572055,0.221427945,0.067400103
North Carolina,JACKSON,39985,32691,751,1943,7294,0.817581593,0.182418407,0.048593222
North Carolina,JOHNSTON,169122,118054,24962,21620,51068,0.698040468,0.301959532,0.12783671
North Carolina,JONES,10144,6208,3216,400,3936,0.611987382,0.388012618,0.039432177
North Carolina,LEE,57876,34303,11379,10645,23573,0.592698182,0.407301818,0.183927708
North Carolina,LENOIR,59372,30460,23879,3873,28912,0.513036448,0.486963552,0.06523277
North Carolina,LINCOLN,78052,66869,4263,5343,11183,0.856723723,0.143276277,0.068454364
North Carolina,MCDOWELL,44926,39908,1631,2374,5018,0.888305213,0.111694787,0.052842452
North Carolina,MACON,33815,30586,308,2132,3229,0.904509833,0.095490167,0.063048943
North Carolina,MADISON,20727,19676,267,430,1051,0.949293192,0.050706808,0.020745887
North Carolina,MARTIN,24298,12583,10497,782,11715,0.517861552,0.482138448,0.032183719
North Carolina,MECKLENBURG,926873,469783,277527,111935,457090,0.506847216,0.493152784,0.120766275
North Carolina,MITCHELL,15539,14600,127,649,939,0.939571401,0.060428599,0.041765879
North Carolina,MONTGOMERY,27741,17727,5204,3950,10014,0.63901806,0.36098194,0.142388522
North Carolina,MOORE,88314,68609,11592,5244,19705,0.776875694,0.223124306,0.059379034
North Carolina,NASH,95545,51599,35318,5949,43946,0.540049191,0.459950809,0.062263855
North Carolina,NEW HANOVER,203276,156269,29573,10468,47007,0.768752829,0.231247171,0.051496488
North Carolina,NORTHAMPTON,21959,8530,12546,319,13429,0.388451205,0.611548795,0.014527073
North Carolina,ONSLOW,176461,121089,28222,17985,55372,0.686208284,0.313791716,0.101920538
North Carolina,ORANGE,133958,94971,15593,10714,38987,0.708961018,0.291038982,0.079980292
North Carolina,PAMLICO,13145,9799,2537,397,3346,0.745454545,0.254545455,0.030201598
North Carolina,PASQUOTANK,40551,22362,15594,1650,18189,0.551453725,0.448546275,0.040689502
North Carolina,PENDER,52447,38725,9590,3176,13722,0.738364444,0.261635556,0.060556371
North Carolina,PERQUIMANS,13414,9548,3464,278,3866,0.711793648,0.288206352,0.020724616
North Carolina,PERSON,39322,26183,10749,1581,13139,0.66586135,0.33413865,0.0402065
North Carolina,PITT,167951,96177,56573,9118,71774,0.572649166,0.427350834,0.054289644
North Carolina,POLK,20386,18037,1038,1105,2349,0.884773864,0.115226136,0.054203865
North Carolina,RANDOLPH,141568,115140,7699,14678,26428,0.813319394,0.186680606,0.103681623
North Carolina,RICHMOND,46608,27361,14228,2748,19247,0.587045142,0.412954858,0.058959835
North Carolina,ROBESON,133920,36212,32159,10771,97708,0.270400239,0.729599761,0.080428614
North Carolina,ROCKINGHAM,93264,68597,17232,5091,24667,0.735514239,0.264485761,0.054586979
North Carolina,ROWAN,138189,101503,22019,10494,36686,0.734523008,0.265476992,0.075939474
North Carolina,RUTHERFORD,67446,56838,6686,2359,10608,0.842718619,0.157281381,0.034976129
North Carolina,SAMPSON,63408,33679,16761,10499,29729,0.531147489,0.468852511,0.165578476
North Carolina,SCOTLAND,36266,16613,13958,806,19653,0.458087465,0.541912535,0.022224673
North Carolina,STANLY,60489,49772,6274,2168,10717,0.822827291,0.177172709,0.035841227
North Carolina,STOKES,47224,43298,1992,1253,3926,0.916864306,0.083135694,0.026533119
North Carolina,SURRY,73551,62549,2646,7115,11002,0.850416718,0.149583282,0.096735598
North Carolina,SWAIN,13995,9152,362,557,4843,0.653947839,0.346052161,0.039799929
North Carolina,TRANSYLVANIA,32825,29788,1166,923,3037,0.907479056,0.092520944,0.028118812
North Carolina,TYRRELL,4367,2339,1494,298,2028,0.535607969,0.464392031,0.068239066
North Carolina,UNION,201617,150325,23286,21054,51292,0.745596849,0.254403151,0.104425718
North Carolina,VANCE,45183,18939,22488,3027,26244,0.419162074,0.580837926,0.066994223
North Carolina,WAKE,905573,563473,185926,87549,342100,0.622228136,0.377771864,0.096678015
North Carolina,WARREN,20860,7883,10603,696,12977,0.377900288,0.622099712,0.033365292
North Carolina,WASHINGTON,13085,5912,6561,476,7173,0.451815055,0.548184945,0.036377532
North Carolina,WATAUGA,51103,47354,582,1670,3749,0.926638358,0.073361642,0.032679099
North Carolina,WAYNE,122419,67974,38538,11983,54445,0.555256945,0.444743055,0.097885132
North Carolina,WILKES,69265,61533,2990,3785,7732,0.88837075,0.11162925,0.054645203
North Carolina,WILSON,81020,40142,30968,7621,40878,0.495457912,0.504542088,0.094063194
North Carolina,YADKIN,38254,32842,1275,3745,5412,0.858524599,0.141475401,0.097898259
North Carolina,YANCEY,17814,16646,172,824,1168,0.934433592,0.065566408,0.046255754
North Dakota,ADAMS,2325,2241,0,29,84,0.963870968,0.036129032,0.012473118
North Dakota,BARNES,11047,10559,58,131,488,0.955825111,0.044174889,0.011858423
North Dakota,BENSON,6677,2899,6,75,3778,0.434177026,0.565822974,0.011232589
North Dakota,BILLINGS,838,811,0,4,27,0.96778043,0.03221957,0.00477327
North Dakota,BOTTINEAU,6449,6070,32,70,379,0.941231199,0.058768801,0.010854396
North Dakota,BOWMAN,3154,3031,0,88,123,0.961001902,0.038998098,0.027901078
North Dakota,BURKE,2011,1917,25,50,94,0.953257086,0.046742914,0.024863252
North Dakota,BURLEIGH,81941,75590,431,1087,6351,0.922493013,0.077506987,0.013265642
North Dakota,CASS,150240,135977,3456,3108,14263,0.905065229,0.094934771,0.020686901
North Dakota,CAVALIER,3974,3858,0,0,116,0.970810267,0.029189733,0
North Dakota,DICKEY,5280,5001,60,107,279,0.947159091,0.052840909,0.020265152
North Dakota,DIVIDE,2095,2035,0,21,60,0.971360382,0.028639618,0.010023866
North Dakota,DUNN,3648,3091,5,75,557,0.847313596,0.152686404,0.020559211
North Dakota,EDDY,2393,2249,5,78,144,0.939824488,0.060175512,0.032595069
North Dakota,EMMONS,3544,3513,0,8,31,0.991252822,0.008747178,0.002257336
North Dakota,FOSTER,3368,3282,1,43,86,0.974465558,0.025534442,0.012767221
North Dakota,GOLDEN VALLEY,1646,1585,1,23,61,0.962940462,0.037059538,0.013973269
North Dakota,GRAND FORKS,66890,59234,1412,2027,7656,0.88554343,0.11445657,0.030303483
North Dakota,GRANT,2380,2252,11,1,128,0.946218487,0.053781513,0.000420168
North Dakota,GRIGGS,2393,2333,0,21,60,0.97492687,0.02507313,0.008775595
North Dakota,HETTINGER,2502,2444,9,15,58,0.976818545,0.023181455,0.005995204
North Dakota,KIDDER,2426,2309,0,100,117,0.951772465,0.048227535,0.041220115
North Dakota,LAMOURE,4141,4092,9,22,49,0.988167109,0.011832891,0.005312726
North Dakota,LOGAN,1972,1944,2,26,28,0.985801217,0.014198783,0.013184584
North Dakota,MCHENRY,5478,5285,3,88,193,0.964768164,0.035231836,0.016064257
North Dakota,MCINTOSH,2813,2725,5,23,88,0.968716673,0.031283327,0.008176324
North Dakota,MCKENZIE,6692,5044,12,178,1648,0.753735804,0.246264196,0.026598924
North Dakota,MCLEAN,9020,8172,2,120,848,0.905986696,0.094013304,0.013303769
North Dakota,MERCER,8400,7970,60,122,430,0.948809524,0.051190476,0.01452381
North Dakota,MORTON,27439,25510,89,408,1929,0.929698604,0.070301396,0.014869347
North Dakota,MOUNTRAIL,7830,5044,32,299,2786,0.644189017,0.355810983,0.038186462
North Dakota,NELSON,3115,3001,40,35,114,0.963402889,0.036597111,0.011235955
North Dakota,OLIVER,1875,1801,0,38,74,0.960533333,0.039466667,0.020266667
North Dakota,PEMBINA,7383,6921,6,193,462,0.937423811,0.062576189,0.026141135
North Dakota,PIERCE,4378,4086,4,110,292,0.933302878,0.066697122,0.025125628
North Dakota,RAMSEY,11450,9965,90,146,1485,0.870305677,0.129694323,0.012751092
North Dakota,RANSOM,5498,5321,12,69,177,0.967806475,0.032193525,0.012550018
North Dakota,RENVILLE,2468,2393,0,0,75,0.969611021,0.030388979,0
North Dakota,RICHLAND,16295,15318,63,291,977,0.940042958,0.059957042,0.017858239
North Dakota,ROLETTE,14015,2873,58,80,11142,0.204994649,0.795005351,0.00570817
North Dakota,SARGENT,3876,3734,28,63,142,0.963364293,0.036635707,0.01625387
North Dakota,SHERIDAN,1282,1236,5,0,46,0.964118565,0.035881435,0
North Dakota,SIOUX,4193,527,11,44,3666,0.125685667,0.874314333,0.01049368
North Dakota,SLOPE,768,764,0,4,4,0.994791667,0.005208333,0.005208333
North Dakota,STARK,24682,23147,146,530,1535,0.93780893,0.06219107,0.021473138
North Dakota,STEELE,1976,1942,0,27,34,0.982793522,0.017206478,0.013663968
North Dakota,STUTSMAN,20965,19838,91,362,1127,0.94624374,0.05375626,0.017266873
North Dakota,TOWNER,2264,2191,6,9,73,0.967756184,0.032243816,0.003975265
North Dakota,TRAILL,8105,7674,22,206,431,0.946822949,0.053177051,0.02541641
North Dakota,WALSH,11131,9795,18,992,1336,0.879974845,0.120025155,0.089120474
North Dakota,WARD,62013,54787,1576,2018,7226,0.883476045,0.116523955,0.032541564
North Dakota,WELLS,4228,4147,0,0,81,0.980842006,0.019157994,0
North Dakota,WILLIAMS,23287,21000,54,531,2287,0.901790699,0.098209301,0.022802422
Ohio,ADAMS,28524,27693,88,239,831,0.970866639,0.029133361,0.008378909
Ohio,ALLEN,106079,87293,12515,2529,18786,0.82290557,0.17709443,0.023840722
Ohio,ASHLAND,53203,51403,407,517,1800,0.966167321,0.033832679,0.009717497
Ohio,ASHTABULA,101262,91701,3598,3455,9561,0.905581561,0.094418439,0.034119413
Ohio,ATHENS,64592,58654,1859,1048,5938,0.908069111,0.091930889,0.016224919
Ohio,AUGLAIZE,45934,44557,142,543,1377,0.970022206,0.029977794,0.011821309
Ohio,BELMONT,70182,65640,2446,465,4542,0.935282551,0.064717449,0.006625631
Ohio,BROWN,44666,43263,405,284,1403,0.968589083,0.031410917,0.006358304
Ohio,BUTLER,368029,309983,26746,14408,58046,0.842278733,0.157721267,0.039149089
Ohio,CARROLL,28828,28042,204,242,786,0.972734841,0.027265159,0.008394616
Ohio,CHAMPAIGN,39982,37645,828,472,2337,0.941548697,0.058451303,0.011805312
Ohio,CLARK,138278,117973,11745,3741,20305,0.853158131,0.146841869,0.027054195
Ohio,CLERMONT,197543,187265,2769,2987,10278,0.947970822,0.052029178,0.015120759
Ohio,CLINTON,42161,39511,845,605,2650,0.937145703,0.062854297,0.014349755
Ohio,COLUMBIANA,107598,102007,2377,1389,5591,0.948038068,0.051961932,0.012909162
Ohio,COSHOCTON,36880,35557,422,294,1323,0.964126898,0.035873102,0.0079718
Ohio,CRAWFORD,43623,42025,298,529,1598,0.963367948,0.036632052,0.01212663
Ohio,CUYAHOGA,1278024,784944,374200,61370,493080,0.614185649,0.385814351,0.048019443
Ohio,DARKE,52776,51163,253,653,1613,0.969436865,0.030563135,0.012373048
Ohio,DEFIANCE,38975,34176,513,3464,4799,0.876869788,0.123130212,0.088877486
Ohio,DELAWARE,174454,153847,6150,3754,20607,0.881877171,0.118122829,0.021518566
Ohio,ERIE,76952,65345,6397,2620,11607,0.849165714,0.150834286,0.034047198
Ohio,FAIRFIELD,146138,130306,8044,2543,15832,0.891664044,0.108335956,0.01740136
Ohio,FAYETTE,28931,27114,548,524,1817,0.937195396,0.062804604,0.01811206
Ohio,FRANKLIN,1167484,785807,243942,55133,381677,0.673077318,0.326922682,0.047223774
Ohio,FULTON,42635,38535,172,3312,4100,0.903834877,0.096165123,0.077682655
Ohio,GALLIA,30877,29071,697,282,1806,0.941509862,0.058490138,0.009133012
Ohio,GEAUGA,93485,89873,1044,1027,3612,0.961362785,0.038637215,0.01098572
Ohio,GREENE,161936,137726,11760,3590,24210,0.850496492,0.149503508,0.022169252
Ohio,GUERNSEY,40056,38183,759,363,1873,0.953240463,0.046759537,0.009062313
Ohio,HAMILTON,801350,542177,204691,20407,259173,0.676579522,0.323420478,0.025465777
Ohio,HANCOCK,75043,68155,1195,3409,6888,0.908212625,0.091787375,0.045427288
Ohio,HARDIN,31986,30681,241,421,1305,0.9592009,0.0407991,0.013162008
Ohio,HARRISON,15818,15101,419,91,717,0.954671893,0.045328107,0.00575294
Ohio,HENRY,28246,25880,126,1870,2366,0.916235927,0.083764073,0.066204064
Ohio,HIGHLAND,43454,41736,432,97,1718,0.960463939,0.039536061,0.002232246
Ohio,HOCKING,29372,28494,212,204,878,0.970107585,0.029892415,0.00694539
Ohio,HOLMES,42501,41731,169,338,770,0.981882779,0.018117221,0.007952754
Ohio,HURON,59628,54574,547,3350,5054,0.915241162,0.084758838,0.05618166
Ohio,JACKSON,33134,31950,211,272,1184,0.964266313,0.035733687,0.00820909
Ohio,JEFFERSON,69343,63114,3688,782,6229,0.910171178,0.089828822,0.011277274
Ohio,KNOX,60791,58355,426,752,2436,0.959928279,0.040071721,0.012370252
Ohio,LAKE,229873,208776,7490,7771,21097,0.908223236,0.091776764,0.033805623
Ohio,LAWRENCE,62441,59438,1506,470,3003,0.9519066,0.0480934,0.007527106
Ohio,LICKING,166135,153536,5311,2335,12599,0.924164083,0.075835917,0.014054835
Ohio,LOGAN,45816,43337,658,544,2479,0.945892265,0.054107735,0.011873581
Ohio,LORAIN,301108,241380,23896,25301,59728,0.801639279,0.198360721,0.084026329
Ohio,LUCAS,441198,313424,82824,26947,127774,0.710393066,0.289606934,0.061076886
Ohio,MADISON,43213,38829,2751,618,4384,0.898549048,0.101450952,0.014301252
Ohio,MAHONING,238352,184815,36837,11135,53537,0.775386823,0.224613177,0.046716621
Ohio,MARION,66514,59695,3338,1483,6819,0.89748023,0.10251977,0.022296058
Ohio,MEDINA,172334,163235,2091,2799,9099,0.947201365,0.052798635,0.016241717
Ohio,MEIGS,23664,22992,316,117,672,0.971602434,0.028397566,0.004944219
Ohio,MERCER,40866,39530,112,604,1336,0.967307786,0.032692214,0.014780013
Ohio,MIAMI,102657,96034,2313,1337,6623,0.935484185,0.064515815,0.013023954
Ohio,MONROE,14679,14361,36,73,318,0.978336399,0.021663601,0.004973091
Ohio,MONTGOMERY,535626,389265,111574,12192,146361,0.726747768,0.273252232,0.022762151
Ohio,MORGAN,15042,13976,458,99,1066,0.929131764,0.070868236,0.006581572
Ohio,MORROW,34895,33811,217,396,1084,0.968935378,0.031064622,0.011348331
Ohio,MUSKINGUM,85996,79583,2825,664,6413,0.925426764,0.074573236,0.007721289
Ohio,NOBLE,14643,13297,1025,146,1346,0.908078946,0.091921054,0.009970634
Ohio,OTTAWA,41445,38726,381,1797,2719,0.934394981,0.065605019,0.043358668
Ohio,PAULDING,19522,18253,148,839,1269,0.934996414,0.065003586,0.042977154
Ohio,PERRY,36086,35203,86,209,883,0.975530677,0.024469323,0.00579172
Ohio,PICKAWAY,55795,52225,1841,610,3570,0.936015772,0.063984228,0.010932879
Ohio,PIKE,28652,27552,185,211,1100,0.961608265,0.038391735,0.007364233
Ohio,PORTAGE,161178,147096,6169,2126,14082,0.912630756,0.087369244,0.013190386
Ohio,PREBLE,42240,41078,166,250,1162,0.97249053,0.02750947,0.005918561
Ohio,PUTNAM,34445,32190,86,1891,2255,0.934533314,0.065466686,0.054899115
Ohio,RICHLAND,124286,107604,10889,1754,16682,0.86577732,0.13422268,0.014112611
Ohio,ROSS,77741,70044,3508,777,7697,0.900991755,0.099008245,0.009994726
Ohio,SANDUSKY,60842,52487,1613,5395,8355,0.862677098,0.137322902,0.088672299
Ohio,SCIOTO,79122,74191,2033,875,4931,0.937678522,0.062321478,0.011058871
Ohio,SENECA,56630,51654,1487,2532,4976,0.912131379,0.087868621,0.044711284
Ohio,SHELBY,49359,46386,795,658,2973,0.939767823,0.060232177,0.013330902
Ohio,STARK,375593,329524,26914,6030,46069,0.877343294,0.122656706,0.016054612
Ohio,SUMMIT,541788,431033,77170,8781,110755,0.795575022,0.204424978,0.016207446
Ohio,TRUMBULL,209942,185142,16795,2842,24800,0.881872136,0.118127864,0.013537072
Ohio,TUSCARAWAS,92532,88648,868,1753,3884,0.958025332,0.041974668,0.018944797
Ohio,UNION,52153,48066,1086,661,4087,0.921634422,0.078365578,0.012674247
Ohio,VAN WERT,28808,27417,325,737,1391,0.951714801,0.048285199,0.025583171
Ohio,VINTON,13397,13058,8,13,339,0.974695827,0.025304173,0.000970366
Ohio,WARREN,213146,189681,7020,4815,23465,0.889911141,0.110088859,0.022590149
Ohio,WASHINGTON,61751,59217,476,487,2534,0.958964227,0.041035773,0.007886512
Ohio,WAYNE,114644,108637,1717,1762,6007,0.947603015,0.052396985,0.015369317
Ohio,WILLIAMS,37779,35415,366,1410,2364,0.937425554,0.062574446,0.037322322
Ohio,WOOD,126254,113564,2887,5781,12690,0.899488333,0.100511667,0.045788648
Ohio,WYANDOT,22626,21730,65,508,896,0.96039954,0.03960046,0.022452046
Oklahoma,ADAIR,22470,9508,67,1221,12962,0.423141967,0.576858033,0.054339119
Oklahoma,ALFALFA,5631,4700,129,238,931,0.834665246,0.165334754,0.042266027
Oklahoma,ATOKA,14133,10285,566,430,3848,0.727729428,0.272270572,0.030425246
Oklahoma,BEAVER,5587,4296,33,1110,1291,0.768927868,0.231072132,0.198675497
Oklahoma,BECKHAM,22519,17618,772,2730,4901,0.782361561,0.217638439,0.121230961
Oklahoma,BLAINE,10651,7485,605,1592,3166,0.702750915,0.297249085,0.149469533
Oklahoma,BRYAN,42494,31369,649,2114,11125,0.738198334,0.261801666,0.0497482
Oklahoma,CADDO,29403,17447,829,2978,11956,0.593374826,0.406625174,0.101282182
Oklahoma,CANADIAN,116299,92579,2697,7998,23720,0.796042958,0.203957042,0.068771013
Oklahoma,CARTER,47603,34484,3218,2594,13119,0.724408126,0.275591874,0.054492364
Oklahoma,CHEROKEE,47165,23681,674,2983,23484,0.502088413,0.497911587,0.063246051
Oklahoma,CHOCTAW,15172,9624,1506,448,5548,0.634326391,0.365673609,0.029528078
Oklahoma,CIMARRON,2451,1889,14,497,562,0.770705834,0.229294166,0.202774378
Oklahoma,CLEVELAND,256550,193805,10242,18027,62745,0.755427792,0.244572208,0.070267004
Oklahoma,COAL,5906,4275,13,167,1631,0.723840163,0.276159837,0.028276329
Oklahoma,COMANCHE,123101,72409,20449,13876,50692,0.588208057,0.411791943,0.112720449
Oklahoma,COTTON,6171,4874,131,370,1297,0.789823367,0.210176633,0.059957867
Oklahoma,CRAIG,14922,9755,468,380,5167,0.653732744,0.346267256,0.025465755
Oklahoma,CREEK,69934,54653,1556,2245,15281,0.78149398,0.21850602,0.032101696
Oklahoma,CUSTER,27583,20134,874,3932,7449,0.729942356,0.270057644,0.142551572
Oklahoma,DELAWARE,41332,27195,132,1242,14137,0.657964773,0.342035227,0.030049356
Oklahoma,DEWEY,4775,4084,13,242,691,0.855287958,0.144712042,0.050680628
Oklahoma,ELLIS,4095,3690,12,258,405,0.901098901,0.098901099,0.063003663
Oklahoma,GARFIELD,60272,48497,1665,5372,11775,0.804635652,0.195364348,0.089129281
Oklahoma,GARVIN,27471,21659,701,1737,5812,0.788431437,0.211568563,0.063230316
Oklahoma,GRADY,52451,43705,1171,2479,8746,0.833253894,0.166746106,0.04726316
Oklahoma,GRANT,4536,4138,26,161,398,0.912257496,0.087742504,0.035493827
Oklahoma,GREER,6185,4820,439,623,1365,0.77930477,0.22069523,0.100727567
Oklahoma,HARMON,2888,1813,215,742,1075,0.627770083,0.372229917,0.256925208
Oklahoma,HARPER,3672,2981,11,634,691,0.811819172,0.188180828,0.172657952
Oklahoma,HASKELL,12761,9361,92,420,3400,0.7335632,0.2664368,0.032912781
Oklahoma,HUGHES,13762,9180,708,534,4582,0.667054207,0.332945793,0.0388025
Oklahoma,JACKSON,26275,17267,1755,5539,9008,0.657164605,0.342835395,0.210808754
Oklahoma,JEFFERSON,6445,5169,35,544,1276,0.802017067,0.197982933,0.084406517
Oklahoma,JOHNSTON,10938,7829,148,441,3109,0.715761565,0.284238435,0.040318157
Oklahoma,KAY,46288,35824,820,3045,10464,0.77393709,0.22606291,0.065783788
Oklahoma,KINGFISHER,14965,11988,94,1988,2977,0.801069161,0.198930839,0.132843301
Oklahoma,KIOWA,9421,7252,441,860,2169,0.769769664,0.230230336,0.091285426
Oklahoma,LATIMER,11099,7668,98,306,3431,0.690873052,0.309126948,0.027570051
Oklahoma,LE FLORE,50056,36626,1082,3397,13430,0.731700495,0.268299505,0.067863992
Oklahoma,LINCOLN,34106,28826,649,844,5280,0.84518853,0.15481147,0.024746379
Oklahoma,LOGAN,41982,32956,3685,2172,9026,0.785003097,0.214996903,0.051736458
Oklahoma,LOVE,9404,7145,218,1128,2259,0.759783071,0.240216929,0.119948958
Oklahoma,MCCLAIN,34471,27930,251,2408,6541,0.810246294,0.189753706,0.069855821
Oklahoma,MCCURTAIN,33144,21742,2841,1564,11402,0.655986,0.344014,0.047188028
Oklahoma,MCINTOSH,20266,14012,696,402,6254,0.691404323,0.308595677,0.019836179
Oklahoma,MAJOR,7563,6638,20,572,925,0.877694037,0.122305963,0.075631363
Oklahoma,MARSHALL,15774,10955,169,2249,4819,0.694497274,0.305502726,0.142576392
Oklahoma,MAYES,41162,27470,117,1141,13692,0.667363102,0.332636898,0.027719742
Oklahoma,MURRAY,13460,10183,139,662,3277,0.75653789,0.24346211,0.049182764
Oklahoma,MUSKOGEE,70635,41183,7887,3663,29452,0.58303957,0.41696043,0.051858144
Oklahoma,NOBLE,11540,9599,211,303,1941,0.831802426,0.168197574,0.026256499
Oklahoma,NOWATA,10627,7169,232,258,3458,0.674602428,0.325397572,0.024277783
Oklahoma,OKFUSKEE,12203,7736,956,369,4467,0.633942473,0.366057527,0.030238466
Oklahoma,OKLAHOMA,721088,428335,107157,108092,292753,0.594012104,0.405987896,0.14990126
Oklahoma,OKMULGEE,39770,25652,3410,1332,14118,0.645008801,0.354991199,0.033492582
Oklahoma,OSAGE,47650,30808,5409,1409,16842,0.646547744,0.353452256,0.02956978
Oklahoma,OTTAWA,31940,21557,218,1515,10383,0.674921728,0.325078272,0.047432686
Oklahoma,PAWNEE,16573,13151,139,363,3422,0.79351958,0.20648042,0.021903095
Oklahoma,PAYNE,77125,61246,2529,3001,15879,0.794113452,0.205886548,0.038910859
Oklahoma,PITTSBURG,45570,32747,1512,1810,12823,0.718608734,0.281391266,0.039719113
Oklahoma,PONTOTOC,37438,25964,901,1515,11474,0.693519953,0.306480047,0.040466905
Oklahoma,POTTAWATOMIE,69676,51884,1879,2919,17792,0.74464665,0.25535335,0.041893909
Oklahoma,PUSHMATAHA,11449,8442,107,294,3007,0.737356974,0.262643026,0.025679099
Oklahoma,ROGER MILLS,3678,3206,28,176,472,0.871669386,0.128330614,0.047852094
Oklahoma,ROGERS,87031,64252,687,3281,22779,0.738265675,0.261734325,0.037699211
Oklahoma,SEMINOLE,25394,16984,1223,931,8410,0.668819406,0.331180594,0.036662204
Oklahoma,SEQUOYAH,41945,27328,764,1468,14617,0.651519847,0.348480153,0.034998212
Oklahoma,STEPHENS,44848,36987,929,2800,7861,0.824719051,0.175280949,0.062433107
Oklahoma,TEXAS,20620,10762,199,8741,9858,0.521920466,0.478079534,0.423908826
Oklahoma,TILLMAN,7981,5137,563,1802,2844,0.643653677,0.356346323,0.225786242
Oklahoma,TULSA,602692,393582,61964,65889,209110,0.653040027,0.346959973,0.109324497
Oklahoma,WAGONER,73067,53777,2516,3493,19290,0.73599573,0.26400427,0.047805439
Oklahoma,WASHINGTON,51112,38665,1213,2568,12447,0.756475974,0.243524026,0.050242604
Oklahoma,WASHITA,11616,9961,101,939,1655,0.857524105,0.142475895,0.080836777
Oklahoma,WOODS,8741,7491,267,419,1250,0.856995767,0.143004233,0.047935019
Oklahoma,WOODWARD,20232,16732,238,2071,3500,0.827006722,0.172993278,0.102362594
Oregon,BAKER,16092,14897,32,559,1195,0.925739498,0.074260502,0.034737758
Oregon,BENTON,85501,71390,818,5486,14111,0.834960995,0.165039005,0.064162992
Oregon,CLACKAMAS,377206,318687,2679,29137,58519,0.844861959,0.155138041,0.077244264
Oregon,CLATSOP,37068,32308,204,2820,4760,0.871587353,0.128412647,0.0760764
Oregon,COLUMBIA,49317,44513,111,2035,4804,0.902589371,0.097410629,0.041263662
Oregon,COOS,62937,54647,200,3456,8290,0.868280979,0.131719021,0.054912055
Oregon,CROOK,21102,18772,46,1544,2330,0.889583926,0.110416074,0.07316842
Oregon,CURRY,22344,19755,27,1258,2589,0.884129968,0.115870032,0.056301468
Oregon,DESCHUTES,158884,140410,458,11827,18474,0.883726492,0.116273508,0.074437955
Oregon,DOUGLAS,107391,96074,339,5042,11317,0.89461873,0.10538127,0.046949931
Oregon,GILLIAM,1904,1716,15,120,188,0.901260504,0.098739496,0.06302521
Oregon,GRANT,7366,6857,16,217,509,0.930898724,0.069101276,0.02945968
Oregon,HARNEY,7359,6581,16,299,778,0.894279114,0.105720886,0.04063052
Oregon,HOOD RIVER,22207,14662,105,6546,7545,0.660242266,0.339757734,0.294771919
Oregon,JACKSON,203613,170315,1063,21894,33298,0.836464273,0.163535727,0.107527515
Oregon,JEFFERSON,21746,13354,146,4286,8392,0.614089948,0.385910052,0.197093718
Oregon,JOSEPHINE,82636,73175,288,5274,9461,0.885509947,0.114490053,0.063822063
Oregon,KLAMATH,66350,53730,419,6990,12620,0.809796534,0.190203466,0.105350414
Oregon,LAKE,7886,6860,22,560,1026,0.869896018,0.130103982,0.07101192
Oregon,LANE,351794,297479,3125,26125,54315,0.845605667,0.154394333,0.07426221
Oregon,LINCOLN,45992,38730,129,3662,7262,0.842102974,0.157897026,0.079622543
Oregon,LINN,116871,101743,496,9097,15128,0.870558137,0.129441863,0.077837958
Oregon,MALHEUR,31057,19735,293,9793,11322,0.635444505,0.364555495,0.315323438
Oregon,MARION,315391,215437,2865,76429,99954,0.683079099,0.316920901,0.242330948
Oregon,MORROW,11146,7196,16,3515,3950,0.645612776,0.354387224,0.31535977
Oregon,MULTNOMAH,737110,532082,40843,79791,205028,0.721848842,0.278151158,0.10824843
Oregon,POLK,75448,60811,313,9122,14637,0.805998834,0.194001166,0.120904464
Oregon,SHERMAN,1865,1676,2,112,189,0.898659517,0.101340483,0.060053619
Oregon,TILLAMOOK,25254,21904,153,2262,3350,0.867347747,0.132652253,0.089569969
Oregon,UMATILLA,75846,52782,545,17966,23064,0.695910134,0.304089866,0.23687472
Oregon,UNION,25670,23284,84,1016,2386,0.907051032,0.092948968,0.039579275
Oregon,WALLOWA,6938,6553,38,157,385,0.944508504,0.055491496,0.022629
Oregon,WASCO,25113,19442,88,3784,5671,0.774180703,0.225819297,0.150678931
Oregon,WASHINGTON,531818,371106,8883,83085,160712,0.697806392,0.302193608,0.156228259
Oregon,WHEELER,1287,1225,0,24,62,0.951825952,0.048174048,0.018648019
Oregon,YAMHILL,99119,78468,735,14598,20651,0.791654476,0.208345524,0.147277515
Pennsylvania,ADAMS,101352,91623,1531,6081,9729,0.904007814,0.095992186,0.059998816
Pennsylvania,ALLEGHENY,1224772,986370,158292,19487,238402,0.805349894,0.194650106,0.015910716
Pennsylvania,ARMSTRONG,68942,67311,635,393,1631,0.976342433,0.023657567,0.005700444
Pennsylvania,BEAVER,170614,154234,10166,2039,16380,0.903993811,0.096006189,0.011950954
Pennsylvania,BEDFORD,49680,48450,275,461,1230,0.975241546,0.024758454,0.009279388
Pennsylvania,BERKS,411094,315714,16326,67258,95380,0.767984938,0.232015062,0.16360735
Pennsylvania,BLAIR,127133,121510,2209,1260,5623,0.955770728,0.044229272,0.009910881
Pennsylvania,BRADFORD,62628,60525,317,748,2103,0.96642077,0.03357923,0.01194354
Pennsylvania,BUCKS,625485,542919,21904,26768,82566,0.867996834,0.132003166,0.042795591
Pennsylvania,BUTLER,183946,176240,2015,1985,7706,0.958107271,0.041892729,0.01079121
Pennsylvania,CAMBRIA,143305,133658,4890,2059,9647,0.932682042,0.067317958,0.014367956
Pennsylvania,CAMERON,5058,4949,31,23,109,0.97844998,0.02155002,0.004547252
Pennsylvania,CARBON,65101,61015,736,2196,4086,0.937235987,0.062764013,0.033732201
Pennsylvania,CENTRE,153758,134923,4477,3789,18835,0.877502309,0.122497691,0.02464262
Pennsylvania,CHESTER,499548,410125,29502,32149,89423,0.820992177,0.179007823,0.064356178
Pennsylvania,CLARION,39991,38719,503,257,1272,0.968192843,0.031807157,0.006426446
Pennsylvania,CLEARFIELD,81668,76998,1687,1913,4670,0.94281726,0.05718274,0.023424107
Pennsylvania,CLINTON,39261,37640,574,440,1621,0.958712208,0.041287792,0.01120705
Pennsylvania,COLUMBIA,66984,63162,1140,1400,3822,0.942941598,0.057058402,0.020900514
Pennsylvania,CRAWFORD,88492,84552,1412,860,3940,0.955476201,0.044523799,0.009718393
Pennsylvania,CUMBERLAND,235314,210212,7031,6507,25102,0.893325514,0.106674486,0.027652413
Pennsylvania,DAUPHIN,267891,187130,46013,18828,80761,0.698530372,0.301469628,0.070282316
Pennsylvania,DELAWARE,558874,397231,108782,16560,161643,0.710770227,0.289229773,0.029631008
Pennsylvania,ELK,31981,31323,153,189,658,0.979425284,0.020574716,0.005909759
Pennsylvania,ERIE,280181,242541,19020,9512,37640,0.865658271,0.134341729,0.033949483
Pennsylvania,FAYETTE,136914,127147,5764,1111,9767,0.928663248,0.071336752,0.008114583
Pennsylvania,FOREST,7664,5974,1235,326,1690,0.779488518,0.220511482,0.042536534
Pennsylvania,FRANKLIN,149554,134973,4896,6423,14581,0.902503444,0.097496556,0.042947698
Pennsylvania,FULTON,14829,14369,172,128,460,0.968979702,0.031020298,0.008631735
Pennsylvania,GREENE,38614,35275,2004,671,3339,0.913528772,0.086471228,0.017377117
Pennsylvania,HUNTINGDON,45931,42145,2395,742,3786,0.91757201,0.08242799,0.016154667
Pennsylvania,INDIANA,88648,83654,2207,984,4994,0.943664832,0.056335168,0.011100081
Pennsylvania,JEFFERSON,45051,44059,145,295,992,0.977980511,0.022019489,0.006548134
Pennsylvania,JUNIATA,24664,23615,156,613,1049,0.957468375,0.042531625,0.024854038
Pennsylvania,LACKAWANNA,214353,192431,4674,10546,21922,0.897729446,0.102270554,0.049199218
Pennsylvania,LANCASTER,519913,440648,16199,45177,79265,0.8475418,0.1524582,0.086893384
Pennsylvania,LAWRENCE,90885,84610,3509,938,6275,0.930956704,0.069043296,0.010320735
Pennsylvania,LEBANON,133578,115786,2169,12492,17792,0.866804414,0.133195586,0.093518394
Pennsylvania,LEHIGH,350165,249834,17068,66074,100331,0.713475076,0.286524924,0.188693901
Pennsylvania,LUZERNE,320555,282555,10038,21679,38000,0.8814556,0.1185444,0.06762958
Pennsylvania,LYCOMING,116447,106998,5029,1595,9449,0.918855788,0.081144212,0.013697218
Pennsylvania,MCKEAN,43451,41032,1017,769,2419,0.944328094,0.055671906,0.017698097
Pennsylvania,MERCER,116474,106048,6365,1260,10426,0.91048646,0.08951354,0.010817865
Pennsylvania,MIFFLIN,46694,45228,302,533,1466,0.968604103,0.031395897,0.011414743
Pennsylvania,MONROE,169346,119007,19665,22338,50339,0.702744677,0.297255323,0.131907456
Pennsylvania,MONTGOMERY,799886,632040,67668,33775,167846,0.790162598,0.209837402,0.042224767
Pennsylvania,MONTOUR,18243,17117,267,337,1126,0.938277696,0.061722304,0.018472839
Pennsylvania,NORTHAMPTON,297519,240627,12810,31405,56892,0.808778599,0.191221401,0.105556284
Pennsylvania,NORTHUMBERLAND,94441,89050,2019,2284,5391,0.942916742,0.057083258,0.024184411
Pennsylvania,PERRY,45791,44233,312,602,1558,0.965975847,0.034024153,0.013146688
Pennsylvania,PHILADELPHIA,1525811,561646,644938,188061,964165,0.368096704,0.631903296,0.123253142
Pennsylvania,PIKE,57437,47659,2833,5188,9778,0.829761304,0.170238696,0.090325052
Pennsylvania,POTTER,17466,16997,63,177,469,0.97314783,0.02685217,0.010133975
Pennsylvania,SCHUYLKILL,147935,137912,3665,4106,10023,0.932247271,0.067752729,0.027755433
Pennsylvania,SNYDER,39620,38042,401,667,1578,0.96017163,0.03982837,0.016834932
Pennsylvania,SOMERSET,77638,74172,1749,837,3466,0.955356913,0.044643087,0.010780803
Pennsylvania,SULLIVAN,6453,6101,126,86,352,0.945451728,0.054548272,0.013327135
Pennsylvania,SUSQUEHANNA,43171,41927,199,578,1244,0.97118436,0.02881564,0.013388617
Pennsylvania,TIOGA,42081,40656,345,450,1425,0.966136736,0.033863264,0.010693662
Pennsylvania,UNION,44944,38245,3056,2376,6699,0.850947846,0.149052154,0.052865789
Pennsylvania,VENANGO,54865,52912,419,494,1953,0.964403536,0.035596464,0.009003919
Pennsylvania,WARREN,41613,40610,186,319,1003,0.975896955,0.024103045,0.007665874
Pennsylvania,WASHINGTON,207916,194369,6556,2394,13547,0.934843879,0.065156121,0.011514265
Pennsylvania,WAYNE,52299,48112,1485,1815,4187,0.919941108,0.080058892,0.034704296
Pennsylvania,WESTMORELAND,364877,345745,8265,3252,19132,0.947565892,0.052434108,0.008912592
Pennsylvania,WYOMING,28221,27187,204,439,1034,0.963360618,0.036639382,0.015555792
Pennsylvania,YORK,434579,374577,21259,24401,60002,0.861930742,0.138069258,0.056148594
Rhode Island,BRISTOL,49796,46904,199,1021,2892,0.941923046,0.058076954,0.020503655
Rhode Island,KENT,166066,151808,2339,5429,14258,0.91414257,0.08585743,0.032691821
Rhode Island,NEWPORT,82503,72500,2847,3550,10003,0.878755924,0.121244076,0.043028738
Rhode Island,PROVIDENCE,627414,415657,47471,118206,211757,0.662492389,0.337507611,0.188401916
Rhode Island,WASHINGTON,126692,116933,1739,3110,9759,0.922970669,0.077029331,0.024547722
South Carolina,ABBEVILLE,25387,17523,7144,267,7864,0.69023516,0.30976484,0.010517194
South Carolina,AIKEN,160169,108696,39693,7794,51473,0.678633194,0.321366806,0.048661102
South Carolina,ALLENDALE,10399,2459,7668,248,7940,0.236465045,0.763534955,0.023848447
South Carolina,ANDERSON,187228,147252,29685,5496,39976,0.786484927,0.213515073,0.029354584
South Carolina,BAMBERG,15941,5669,10017,128,10272,0.355623863,0.644376137,0.008029609
South Carolina,BARNWELL,22523,11674,10136,426,10849,0.518314612,0.481685388,0.018913999
South Carolina,BEAUFORT,162316,107613,30851,19056,54703,0.662984549,0.337015451,0.117400626
South Carolina,BERKELEY,179773,114871,44706,10513,64902,0.638978045,0.361021955,0.058479304
South Carolina,CALHOUN,15134,7986,6426,452,7148,0.527686005,0.472313995,0.029866526
South Carolina,CHARLESTON,352548,219204,104406,18392,133344,0.621770653,0.378229347,0.052168783
South Carolina,CHEROKEE,55351,40962,11119,2020,14389,0.74004083,0.25995917,0.036494372
South Carolina,CHESTER,33028,19510,12329,496,13518,0.590710912,0.409289088,0.015017561
South Carolina,CHESTERFIELD,46462,28668,15154,1646,17794,0.617020361,0.382979639,0.0354268
South Carolina,CLARENDON,34746,16079,17364,921,18667,0.462758303,0.537241697,0.026506648
South Carolina,COLLETON,38665,21532,15414,1071,17133,0.556886073,0.443113927,0.02769947
South Carolina,DARLINGTON,68500,37962,28228,1146,30538,0.554189781,0.445810219,0.016729927
South Carolina,DILLON,31733,14946,14871,821,16787,0.470992342,0.529007658,0.025872121
South Carolina,DORCHESTER,136836,89967,34237,6021,46869,0.657480488,0.342519512,0.044001579
South Carolina,EDGEFIELD,26763,15022,10123,1397,11741,0.561297313,0.438702687,0.052198931
South Carolina,FAIRFIELD,23804,9087,14372,82,14717,0.381742564,0.618257436,0.003444799
South Carolina,FLORENCE,136714,74003,56012,3036,62711,0.541297892,0.458702108,0.022206943
South Carolina,GEORGETOWN,60285,37448,20382,1844,22837,0.621182715,0.378817285,0.03058804
South Carolina,GREENVILLE,452931,318543,80959,36453,134388,0.703292554,0.296707446,0.080482458
South Carolina,GREENWOOD,69531,42674,21082,3773,26857,0.613740634,0.386259366,0.054263566
South Carolina,HAMPTON,20987,8687,11278,748,12300,0.413922905,0.586077095,0.035641111
South Carolina,HORRY,270943,209283,36423,16365,61660,0.772424458,0.227575542,0.060400158
South Carolina,JASPER,24792,9254,11172,3609,15538,0.37326557,0.62673443,0.145571152
South Carolina,KERSHAW,61583,42842,15465,2281,18741,0.695679002,0.304320998,0.037039443
South Carolina,LANCASTER,76364,53252,18194,3378,23112,0.697344298,0.302655702,0.044235504
South Carolina,LAURENS,66623,45976,16649,2707,20647,0.69009201,0.30990799,0.040631614
South Carolina,LEE,19160,6239,12340,368,12921,0.325626305,0.674373695,0.019206681
South Carolina,LEXINGTON,262424,202091,36919,14255,60333,0.770093437,0.229906563,0.054320489
South Carolina,MCCORMICK,10140,4885,4938,88,5255,0.481755424,0.518244576,0.008678501
South Carolina,MARION,33038,13226,18657,826,19812,0.400326896,0.599673104,0.025001513
South Carolina,MARLBORO,28750,11574,14535,798,17176,0.402573913,0.597426087,0.027756522
South Carolina,NEWBERRY,37432,22628,11036,2733,14804,0.604509511,0.395490489,0.073012396
South Carolina,OCONEE,74038,63648,5568,3288,10390,0.859666658,0.140333342,0.044409627
South Carolina,ORANGEBURG,92229,31262,57308,1729,60967,0.338960631,0.661039369,0.018746815
South Carolina,PICKENS,119167,103852,7586,3735,15315,0.871482877,0.128517123,0.03134257
South Carolina,RICHLAND,384596,174074,174644,18412,210522,0.452615212,0.547384788,0.047873613
South Carolina,SALUDA,19758,11536,5211,2814,8222,0.583864764,0.416135236,0.142423322
South Carolina,SPARTANBURG,284540,198956,57712,16640,85584,0.699219793,0.300780207,0.058480354
South Carolina,SUMTER,107279,50484,49819,3551,56795,0.470586042,0.529413958,0.033100607
South Carolina,UNION,28804,19050,8886,286,9754,0.661366477,0.338633523,0.009929177
South Carolina,WILLIAMSBURG,34361,10734,22617,691,23627,0.312389046,0.687610954,0.020110008
South Carolina,YORK,226576,164707,41959,10125,61869,0.726939305,0.273060695,0.044686992
South Dakota,AURORA,2726,2532,6,114,194,0.928833456,0.071166544,0.041819516
South Dakota,BEADLE,17372,14903,86,1289,2469,0.857874741,0.142125259,0.074199862
South Dakota,BENNETT,3432,919,24,71,2513,0.267773893,0.732226107,0.020687646
South Dakota,BON HOMME,7041,6260,50,209,781,0.889078256,0.110921744,0.029683284
South Dakota,BROOKINGS,31973,29509,247,639,2464,0.922934976,0.077065024,0.019985613
South Dakota,BROWN,36562,33824,259,527,2738,0.925113506,0.074886494,0.014413872
South Dakota,BRULE,5236,4590,0,82,646,0.876623377,0.123376623,0.01566081
South Dakota,BUFFALO,1950,339,9,0,1611,0.173846154,0.826153846,0
South Dakota,BUTTE,10122,9369,47,310,753,0.925607587,0.074392413,0.030626358
South Dakota,CAMPBELL,1419,1400,0,0,19,0.986610289,0.013389711,0
South Dakota,CHARLES MIX,9127,5872,0,174,3255,0.643365838,0.356634162,0.019064315
South Dakota,CLARK,3653,3467,29,66,186,0.949082946,0.050917054,0.018067342
South Dakota,CLAY,13966,12584,123,286,1382,0.901045396,0.098954604,0.020478304
South Dakota,CODINGTON,27284,25793,85,429,1491,0.945352588,0.054647412,0.015723501
South Dakota,CORSON,4046,1241,7,106,2805,0.306722689,0.693277311,0.026198715
South Dakota,CUSTER,8219,7596,26,187,623,0.924200024,0.075799976,0.02275216
South Dakota,DAVISON,19513,18265,77,315,1248,0.936042638,0.063957362,0.016143084
South Dakota,DAY,5673,4975,0,57,698,0.876961044,0.123038956,0.010047594
South Dakota,DEUEL,4376,4226,28,93,150,0.965722121,0.034277879,0.021252285
South Dakota,DEWEY,5358,1152,24,115,4206,0.215005599,0.784994401,0.021463233
South Dakota,DOUGLAS,2992,2874,0,25,118,0.960561497,0.039438503,0.008355615
South Dakota,EDMUNDS,4050,3952,0,37,98,0.975802469,0.024197531,0.009135802
South Dakota,FALL RIVER,7028,6141,19,185,887,0.873790552,0.126209448,0.026323278
South Dakota,FAULK,2374,2302,0,58,72,0.969671441,0.030328559,0.02443134
South Dakota,GRANT,7324,7033,52,168,291,0.960267613,0.039732387,0.022938285
South Dakota,GREGORY,4251,3805,0,40,446,0.89508351,0.10491649,0.009409551
South Dakota,HAAKON,1852,1790,4,14,62,0.966522678,0.033477322,0.007559395
South Dakota,HAMLIN,5875,5653,15,144,222,0.962212766,0.037787234,0.024510638
South Dakota,HAND,3394,3361,0,22,33,0.990276959,0.009723041,0.006482027
South Dakota,HANSON,3366,3267,0,38,99,0.970588235,0.029411765,0.011289364
South Dakota,HARDING,1367,1293,3,16,74,0.945866862,0.054133138,0.011704462
South Dakota,HUGHES,17064,14300,94,348,2764,0.838021566,0.161978434,0.020393812
South Dakota,HUTCHINSON,7283,7022,2,116,261,0.96416312,0.03583688,0.015927502
South Dakota,HYDE,1437,1253,0,14,184,0.871955463,0.128044537,0.009742519
South Dakota,JACKSON,3067,1561,0,45,1506,0.508966417,0.491033583,0.014672318
South Dakota,JERAULD,2047,1936,0,79,111,0.945774304,0.054225696,0.038593063
South Dakota,JONES,1084,1023,13,2,61,0.943726937,0.056273063,0.001845018
South Dakota,KINGSBURY,5159,4977,14,83,182,0.964721845,0.035278155,0.016088389
South Dakota,LAKE,11364,10839,70,187,525,0.953801478,0.046198522,0.016455473
South Dakota,LAWRENCE,24063,22257,57,642,1806,0.924947014,0.075052986,0.026679965
South Dakota,LINCOLN,45055,42803,289,622,2252,0.950016646,0.049983354,0.013805349
South Dakota,LYMAN,3752,2174,0,3,1578,0.579424307,0.420575693,0.000799574
South Dakota,MCCOOK,5592,5412,5,106,180,0.967811159,0.032188841,0.018955651
South Dakota,MCPHERSON,2485,2415,1,48,70,0.971830986,0.028169014,0.019315895
South Dakota,MARSHALL,4631,3918,2,303,713,0.846037573,0.153962427,0.065428633
South Dakota,MEADE,25456,22866,208,820,2590,0.898255814,0.101744186,0.032212445
South Dakota,MELLETTE,2057,778,0,36,1279,0.37822071,0.62177929,0.017501215
South Dakota,MINER,2365,2288,1,20,77,0.96744186,0.03255814,0.00845666
South Dakota,MINNEHAHA,170342,146761,6423,7096,23581,0.86156673,0.13843327,0.041657372
South Dakota,MOODY,6474,5223,0,116,1251,0.806765524,0.193234476,0.017917825
South Dakota,PENNINGTON,101240,82710,1027,4131,18530,0.816969577,0.183030423,0.04080403
South Dakota,PERKINS,2890,2800,0,25,90,0.968858131,0.031141869,0.008650519
South Dakota,POTTER,2327,2281,0,0,46,0.980232058,0.019767942,0
South Dakota,ROBERTS,10158,6188,44,135,3970,0.609175034,0.390824966,0.013290018
South Dakota,SANBORN,2357,2298,0,42,59,0.97496818,0.02503182,0.017819262
South Dakota,SHANNON,13683,451,18,347,13232,0.032960608,0.967039392,0.025359936
South Dakota,SPINK,6483,6287,0,78,196,0.969767083,0.030232917,0.012031467
South Dakota,STANLEY,2940,2549,0,41,391,0.867006803,0.132993197,0.013945578
South Dakota,SULLY,1382,1297,0,20,85,0.938494935,0.061505065,0.01447178
South Dakota,TODD,9711,918,20,270,8793,0.094531974,0.905468026,0.027803522
South Dakota,TRIPP,5608,4650,44,13,958,0.829172611,0.170827389,0.002318117
South Dakota,TURNER,8344,8054,30,118,290,0.965244487,0.034755513,0.014141898
South Dakota,UNION,14377,13533,93,329,844,0.941295124,0.058704876,0.022883773
South Dakota,WALWORTH,5443,4468,0,13,975,0.820870843,0.179129157,0.002388389
South Dakota,YANKTON,22434,20493,401,628,1941,0.91347954,0.08652046,0.027993225
South Dakota,ZIEBACH,2796,639,14,86,2157,0.228540773,0.771459227,0.030758226
Tennessee,ANDERSON,75039,68016,2834,1749,7023,0.906408667,0.093591333,0.02330788
Tennessee,BEDFORD,45060,35407,3061,5036,9653,0.785774523,0.214225477,0.111762095
Tennessee,BENTON,16420,15460,413,306,960,0.941534714,0.058465286,0.01863581
Tennessee,BLEDSOE,12898,11946,539,263,952,0.926190107,0.073809893,0.020390758
Tennessee,BLOUNT,123086,113172,3599,3417,9914,0.91945469,0.08054531,0.027761078
Tennessee,BRADLEY,99229,87758,4109,4674,11471,0.884398714,0.115601286,0.047103165
Tennessee,CAMPBELL,40629,39365,190,481,1264,0.968889217,0.031110783,0.011838834
Tennessee,CANNON,13797,13169,200,220,628,0.954482859,0.045517141,0.015945495
Tennessee,CARROLL,28486,24422,2899,594,4064,0.857333427,0.142666573,0.020852349
Tennessee,CARTER,57531,54976,726,901,2555,0.955589161,0.044410839,0.015661122
Tennessee,CHEATHAM,39103,36895,597,930,2208,0.943533744,0.056466256,0.023783341
Tennessee,CHESTER,17043,14724,1734,366,2319,0.863932406,0.136067594,0.021475092
Tennessee,CLAIBORNE,32025,30806,282,284,1219,0.961935988,0.038064012,0.008868072
Tennessee,CLAY,7842,7507,213,122,335,0.957281306,0.042718694,0.015557256
Tennessee,COCKE,35631,33487,620,659,2144,0.939827678,0.060172322,0.018495131
Tennessee,COFFEE,52853,47564,1400,2012,5289,0.899929995,0.100070005,0.038067849
Tennessee,CROCKETT,14567,11181,1976,1292,3386,0.767556806,0.232443194,0.088693623
Tennessee,CUMBERLAND,56144,53698,138,1349,2446,0.956433457,0.043566543,0.024027501
Tennessee,DAVIDSON,629113,362161,173601,60357,266952,0.575669236,0.424330764,0.095939839
Tennessee,DECATUR,11732,10901,301,315,831,0.929168087,0.070831913,0.026849642
Tennessee,DEKALB,18770,17036,301,1235,1734,0.90761854,0.09238146,0.065796484
Tennessee,DICKSON,49704,44923,2099,1510,4781,0.903810559,0.096189441,0.030379849
Tennessee,DYER,38234,30919,5594,1009,7315,0.80867814,0.19132186,0.026390124
Tennessee,FAYETTE,38370,26125,10778,885,12245,0.680870472,0.319129528,0.023064894
Tennessee,FENTRESS,17945,17496,39,120,449,0.974979103,0.025020897,0.006687099
Tennessee,FRANKLIN,40972,36766,1964,1031,4206,0.897344528,0.102655472,0.025163526
Tennessee,GIBSON,49594,38430,9286,1039,11164,0.774892124,0.225107876,0.020950115
Tennessee,GILES,29439,25163,3195,473,4276,0.854750501,0.145249499,0.016067122
Tennessee,GRAINGER,22613,21682,108,524,931,0.958828992,0.041171008,0.023172511
Tennessee,GREENE,68755,64552,1504,1720,4203,0.9388699,0.0611301,0.025016362
Tennessee,GRUNDY,13751,11347,95,122,2404,0.825176351,0.174823649,0.008872082
Tennessee,HAMBLEN,62528,51949,2571,6597,10579,0.830811796,0.169188204,0.105504734
Tennessee,HAMILTON,337023,242892,67889,14854,94131,0.720698587,0.279301413,0.044074143
Tennessee,HANCOCK,6759,6616,20,14,143,0.978843024,0.021156976,0.002071312
Tennessee,HARDEMAN,27193,15100,11235,376,12093,0.555289964,0.444710036,0.013827088
Tennessee,HARDIN,25987,24047,895,491,1940,0.925347289,0.074652711,0.018894062
Tennessee,HAWKINS,56725,54343,773,685,2382,0.958007933,0.041992067,0.012075804
Tennessee,HAYWOOD,18673,8409,9150,720,10264,0.450329353,0.549670647,0.038558346
Tennessee,HENDERSON,27835,24553,2257,541,3282,0.882090893,0.117909107,0.019435962
Tennessee,HENRY,32271,28407,2574,576,3864,0.880264014,0.119735986,0.017848843
Tennessee,HICKMAN,24481,22451,1280,340,2030,0.917078551,0.082921449,0.013888322
Tennessee,HOUSTON,8375,7858,159,141,517,0.938268657,0.061731343,0.016835821
Tennessee,HUMPHREYS,18428,17378,541,303,1050,0.943021489,0.056978511,0.01644237
Tennessee,JACKSON,11526,11147,37,173,379,0.967117821,0.032882179,0.015009544
Tennessee,JEFFERSON,51541,47891,1320,1625,3650,0.929182592,0.070817408,0.031528298
Tennessee,JOHNSON,18199,17314,501,271,885,0.951370954,0.048629046,0.014890928
Tennessee,KNOX,433207,362900,39142,14991,70307,0.837705762,0.162294238,0.034604704
Tennessee,LAKE,7780,5327,2026,245,2453,0.68470437,0.31529563,0.031491003
Tennessee,LAUDERDALE,27772,17005,9788,576,10767,0.61230736,0.38769264,0.020740314
Tennessee,LAWRENCE,41779,39624,710,702,2155,0.948419062,0.051580938,0.0168027
Tennessee,LEWIS,12050,11392,263,273,658,0.945394191,0.054605809,0.022655602
Tennessee,LINCOLN,33295,29341,1594,878,3954,0.88124343,0.11875657,0.026370326
Tennessee,LOUDON,48586,43798,398,3344,4788,0.901453093,0.098546907,0.068826411
Tennessee,MCMINN,52325,47392,2143,1479,4933,0.905723841,0.094276159,0.028265647
Tennessee,MCNAIRY,26001,23604,1462,405,2397,0.907811238,0.092188762,0.015576324
Tennessee,MACON,22265,20853,79,940,1412,0.936582079,0.063417921,0.042218729
Tennessee,MADISON,97976,56883,35375,3290,41093,0.580580959,0.419419041,0.033579652
Tennessee,MARION,28184,26224,388,361,1960,0.930456997,0.069543003,0.012808686
Tennessee,MARSHALL,30585,26500,1714,1397,4085,0.866437796,0.133562204,0.045675985
Tennessee,MAURY,80965,64833,10010,3935,16132,0.800753412,0.199246588,0.048601247
Tennessee,MEIGS,11696,11195,195,37,501,0.957164843,0.042835157,0.003163475
Tennessee,MONROE,44680,41248,844,1484,3432,0.923187108,0.076812892,0.033213966
Tennessee,MONTGOMERY,173138,116026,32675,14019,57112,0.670135961,0.329864039,0.080970093
Tennessee,MOORE,6349,5931,148,25,418,0.93416286,0.06583714,0.003937628
Tennessee,MORGAN,21882,20535,698,197,1347,0.938442556,0.061557444,0.009002833
Tennessee,OBION,31721,26927,3315,1015,4794,0.848869834,0.151130166,0.03199773
Tennessee,OVERTON,22040,21391,150,217,649,0.970553539,0.029446461,0.009845735
Tennessee,PERRY,7856,7422,295,65,434,0.944755601,0.055244399,0.008273931
Tennessee,PICKETT,5108,5049,23,0,59,0.988449491,0.011550509,0
Tennessee,POLK,16756,16168,30,240,588,0.964908093,0.035091907,0.014323228
Tennessee,PUTNAM,72172,64937,1634,3841,7235,0.899753367,0.100246633,0.053220085
Tennessee,RHEA,31817,29322,806,1177,2495,0.921582802,0.078417198,0.036992803
Tennessee,ROANE,54027,50620,1441,737,3407,0.936938938,0.063061062,0.013641327
Tennessee,ROBERTSON,66143,56065,4935,3866,10078,0.847633158,0.152366842,0.058449118
Tennessee,RUTHERFORD,263815,199593,33185,17587,64222,0.756564259,0.243435741,0.06666414
Tennessee,SCOTT,22196,21759,21,194,437,0.980311768,0.019688232,0.008740314
Tennessee,SEQUATCHIE,14173,12709,31,455,1464,0.896705002,0.103294998,0.032103295
Tennessee,SEVIER,90218,82732,557,4639,7486,0.91702321,0.08297679,0.051419894
Tennessee,SHELBY,929437,359705,480367,51719,569732,0.387013859,0.612986141,0.055645514
Tennessee,SMITH,19157,17978,523,170,1179,0.938455917,0.061544083,0.008874041
Tennessee,STEWART,13262,12378,224,264,884,0.933343387,0.066656613,0.0199065
Tennessee,SULLIVAN,156675,147842,2631,2329,8833,0.943622148,0.056377852,0.014865167
Tennessee,SUMNER,161206,140264,10723,6227,20942,0.870091684,0.129908316,0.038627595
Tennessee,TIPTON,61038,46625,11092,1296,14413,0.76386841,0.23613159,0.021232675
Tennessee,TROUSDALE,7827,6726,773,34,1101,0.859333078,0.140666922,0.004343938
Tennessee,UNICOI,18287,17286,186,699,1001,0.945261661,0.054738339,0.038223875
Tennessee,UNION,19179,18819,11,245,360,0.98122947,0.01877053,0.012774389
Tennessee,VAN BUREN,5552,5369,40,20,183,0.967038905,0.032961095,0.003602305
Tennessee,WARREN,39767,34674,1111,3245,5093,0.871928986,0.128071014,0.081600322
Tennessee,WASHINGTON,122840,110899,4708,3575,11941,0.90279225,0.09720775,0.029102898
Tennessee,WAYNE,17015,15511,972,402,1504,0.911607405,0.088392595,0.023626212
Tennessee,WEAKLEY,34802,30495,2732,695,4307,0.876242745,0.123757255,0.019970117
Tennessee,WHITE,25863,24489,465,440,1374,0.946873913,0.053126087,0.017012721
Tennessee,WILLIAMSON,184225,159609,7907,8203,24616,0.866380784,0.133619216,0.044527073
Tennessee,WILSON,114618,100251,7681,3706,14367,0.874653196,0.125346804,0.03233349
Texas,ANDERSON,58269,35593,12344,9277,22676,0.610839383,0.389160617,0.159209871
Texas,ANDREWS,15006,7067,174,7432,7939,0.470944955,0.529055045,0.495268559
Texas,ANGELINA,86550,54716,13163,17128,31834,0.632189486,0.367810514,0.197897169
Texas,ARANSAS,23391,16381,150,5850,7010,0.700312086,0.299687914,0.250096191
Texas,ARCHER,8944,8055,37,692,889,0.900603757,0.099396243,0.077370304
Texas,ARMSTRONG,1820,1586,18,185,234,0.871428571,0.128571429,0.101648352
Texas,ATASCOSA,45091,16299,268,27942,28792,0.361469029,0.638530971,0.619680202
Texas,AUSTIN,28372,18600,2716,6680,9772,0.65557592,0.34442408,0.235443395
Texas,BAILEY,7096,2982,129,3971,4114,0.420236753,0.579763247,0.559611048
Texas,BANDERA,20477,16571,138,3433,3906,0.809249402,0.190750598,0.167651511
Texas,BASTROP,74023,42318,5753,24082,31705,0.571687178,0.428312822,0.325331316
Texas,BAYLOR,3706,3263,59,370,443,0.880464112,0.119535888,0.0998381
Texas,BEE,32083,10860,2815,18090,21223,0.338497023,0.661502977,0.563850014
Texas,BELL,310155,157080,62800,67384,153075,0.506456449,0.493543551,0.217259112
Texas,BEXAR,1719902,520225,118165,1010015,1199677,0.302473629,0.697526371,0.587251483
Texas,BLANCO,10425,8199,93,1950,2226,0.78647482,0.21352518,0.18705036
Texas,BORDEN,642,549,0,86,93,0.855140187,0.144859813,0.133956386
Texas,BOSQUE,18114,14603,250,2918,3511,0.806172022,0.193827978,0.161090869
Texas,BOWIE,92460,61251,21592,6103,31209,0.662459442,0.337540558,0.066006922
Texas,BRAZORIA,313813,166698,37432,87042,147115,0.531201703,0.468798297,0.277369006
Texas,BRAZOS,194087,114703,20705,45163,79384,0.590987547,0.409012453,0.232694616
Texas,BREWSTER,9175,4893,117,3943,4282,0.533297003,0.466702997,0.429754768
Texas,BRISCOE,1674,1145,9,444,529,0.683990442,0.316009558,0.265232975
Texas,BROOKS,7236,491,6,6636,6745,0.067855169,0.932144831,0.91708126
Texas,BROWN,38018,28338,1428,7505,9680,0.745383766,0.254616234,0.197406492
Texas,BURLESON,17160,11616,1970,3176,5544,0.676923077,0.323076923,0.185081585
Texas,BURNET,42946,32707,868,8648,10239,0.761584315,0.238415685,0.201369161
Texas,CALDWELL,38152,16798,2746,18041,21354,0.440291466,0.559708534,0.472871671
Texas,CALHOUN,21366,9744,534,9959,11622,0.456051671,0.543948329,0.466114387
Texas,CALLAHAN,13521,11967,88,1089,1554,0.885067673,0.114932327,0.08054138
Texas,CAMERON,405819,43439,1358,357174,362380,0.107040331,0.892959669,0.88013129
Texas,CAMP,12389,7268,2245,2619,5121,0.586649447,0.413350553,0.211397207
Texas,CARSON,6215,5444,52,551,771,0.875945294,0.124054706,0.088656476
Texas,CASS,30324,23366,5212,1085,6958,0.770544783,0.229455217,0.03578024
Texas,CASTRO,7984,2733,162,4755,5251,0.342309619,0.657690381,0.595566132
Texas,CHAMBERS,34562,24233,2672,6678,10329,0.701145767,0.298854233,0.193217985
Texas,CHEROKEE,50690,31818,7651,10445,18872,0.627697771,0.372302229,0.206056421
Texas,CHILDRESS,7047,4553,808,1606,2494,0.646090535,0.353909465,0.227898396
Texas,CLAY,10718,9859,59,503,859,0.91985445,0.08014555,0.046930397
Texas,COCHRAN,3087,1278,115,1661,1809,0.413994169,0.586005831,0.538062844
Texas,COKE,3298,2582,42,632,716,0.782898727,0.217101273,0.191631292
Texas,COLEMAN,8817,7011,187,1449,1806,0.795168425,0.204831575,0.164341613
Texas,COLLIN,788580,496688,65028,116000,291892,0.629851125,0.370148875,0.14709985
Texas,COLLINGSWORTH,3050,1869,111,960,1181,0.612786885,0.387213115,0.314754098
Texas,COLORADO,20784,12436,2772,5430,8348,0.598344881,0.401655119,0.261258661
Texas,COMAL,108985,77358,1755,27415,31627,0.709804101,0.290195899,0.251548378
Texas,COMANCHE,13875,10061,63,3580,3814,0.725117117,0.274882883,0.258018018
Texas,CONCHO,4073,1856,23,2167,2217,0.455683771,0.544316229,0.532040265
Texas,COOKE,38427,30132,994,5996,8295,0.784136154,0.215863846,0.15603612
Texas,CORYELL,75728,46643,12210,12203,29085,0.615928058,0.384071942,0.16114251
Texas,COTTLE,1600,1108,217,195,492,0.6925,0.3075,0.121875
Texas,CRANE,4359,1750,123,2412,2609,0.401468227,0.598531773,0.553337922
Texas,CROCKETT,3669,1550,0,2097,2119,0.422458436,0.577541564,0.57154538
Texas,CROSBY,6100,2614,199,3205,3486,0.42852459,0.57147541,0.525409836
Texas,CULBERSON,2386,444,13,1854,1942,0.186085499,0.813914501,0.777032691
Texas,DALLAM,6734,3758,75,2726,2976,0.558063558,0.441936442,0.404811405
Texas,DALLAS,2379214,788657,515041,908199,1590557,0.331477959,0.668522041,0.381722283
Texas,DAWSON,13761,5342,914,7354,8419,0.388198532,0.611801468,0.534408837
Texas,DEAF SMITH,19275,5889,63,13007,13386,0.305525292,0.694474708,0.674811933
Texas,DELTA,5240,4338,417,302,902,0.827862595,0.172137405,0.057633588
Texas,DENTON,667934,429832,53298,121560,238102,0.64352466,0.35647534,0.181994029
Texas,DEWITT,20156,11576,1786,6513,8580,0.574320302,0.425679698,0.323129589
Texas,DICKENS,2399,1616,116,659,783,0.673614006,0.326385994,0.274697791
Texas,DIMMIT,10054,1398,32,8624,8656,0.139049135,0.860950865,0.857768053
Texas,DONLEY,3652,3096,175,317,556,0.847754655,0.152245345,0.086801752
Texas,DUVAL,11821,1236,62,10411,10585,0.104559682,0.895440318,0.880720751
Texas,EASTLAND,18519,15141,315,2712,3378,0.817592743,0.182407257,0.146444192
Texas,ECTOR,138193,56329,5656,73284,81864,0.407611095,0.592388905,0.530301824
Texas,EDWARDS,2023,892,5,1126,1131,0.440929313,0.559070687,0.55659911
Texas,ELLIS,149712,98029,12959,35244,51683,0.654783852,0.345216148,0.235411991
Texas,EL PASO,801115,107028,21818,655623,694087,0.133598797,0.866401203,0.818388122
Texas,ERATH,38192,29537,399,7300,8655,0.77338186,0.22661814,0.191139506
Texas,FALLS,17756,9330,4362,3698,8426,0.525456184,0.474543816,0.208267628
Texas,FANNIN,33867,27301,2276,3270,6566,0.806123955,0.193876045,0.096554168
Texas,FAYETTE,24557,18098,1763,4573,6459,0.736979273,0.263020727,0.186219815
Texas,FISHER,3963,2634,171,1100,1329,0.664647994,0.335352006,0.277567499
Texas,FLOYD,6439,2732,144,3442,3707,0.424289486,0.575710514,0.534555055
Texas,FOARD,1273,1022,10,234,251,0.802827965,0.197172035,0.183817753
Texas,FORT BEND,587666,212865,124038,139823,374801,0.362221058,0.637778942,0.237929368
Texas,FRANKLIN,10593,8569,503,1348,2024,0.808930426,0.191069574,0.127253847
Texas,FREESTONE,19631,13467,3190,2705,6164,0.686006826,0.313993174,0.137792267
Texas,FRIO,17265,3247,504,13418,14018,0.188068346,0.811931654,0.777179264
Texas,GAINES,17572,10575,178,6528,6997,0.601809697,0.398190303,0.371500114
Texas,GALVESTON,292874,172872,40188,65767,120002,0.590260658,0.409739342,0.224557318
Texas,GARZA,6295,2459,290,3502,3836,0.390627482,0.609372518,0.556314535
Texas,GILLESPIE,24777,19371,81,4983,5406,0.781813779,0.218186221,0.201113936
Texas,GLASSCOCK,1255,872,33,350,383,0.694820717,0.305179283,0.278884462
Texas,GOLIAD,7223,4269,265,2515,2954,0.591028658,0.408971342,0.348193271
Texas,GONZALES,19773,8825,1474,9352,10948,0.446315683,0.553684317,0.472968189
Texas,GRAY,22731,15618,1080,5424,7113,0.687079319,0.312920681,0.238616867
Texas,GRAYSON,120641,94791,6861,13564,25850,0.785727903,0.214272097,0.112432755
Texas,GREGG,121451,74090,24184,19839,47361,0.610040263,0.389959737,0.163349828
Texas,GRIMES,26564,16066,4292,5680,10498,0.604803493,0.395196507,0.213823219
Texas,GUADALUPE,131945,72021,7948,47280,59924,0.54584107,0.45415893,0.358331123
Texas,HALE,36153,13492,1636,20262,22661,0.373191713,0.626808287,0.560451415
Texas,HALL,3337,1980,191,1097,1357,0.593347318,0.406652682,0.328738388
Texas,HAMILTON,8448,7465,39,891,983,0.883641098,0.116358902,0.10546875
Texas,HANSFORD,5556,3057,9,2408,2499,0.550215983,0.449784017,0.433405328
Texas,HARDEMAN,4124,2877,347,831,1247,0.697623666,0.302376334,0.201503395
Texas,HARDIN,54497,47893,3190,2459,6604,0.878819018,0.121180982,0.04512175
Texas,HARRIS,4101752,1354869,760521,1671262,2746883,0.330314705,0.669685295,0.407450767
Texas,HARRISON,65958,42808,14931,7253,23150,0.649019073,0.350980927,0.109963916
Texas,HARTLEY,6015,4112,424,1402,1903,0.683624273,0.316375727,0.233083957
Texas,HASKELL,5891,4133,255,1424,1758,0.701578679,0.298421321,0.241724665
Texas,HAYS,158464,92516,5184,56102,65948,0.583829766,0.416170234,0.354036248
Texas,HEMPHILL,3863,2574,5,1171,1289,0.666321512,0.333678488,0.303132281
Texas,HENDERSON,78558,63428,4915,8554,15130,0.807403447,0.192596553,0.108887701
Texas,HIDALGO,774820,60160,2784,702135,714660,0.07764384,0.92235616,0.906191115
Texas,HILL,35079,25733,2313,6454,9346,0.733572793,0.266427207,0.18398472
Texas,HOCKLEY,22988,11694,611,10116,11294,0.508700191,0.491299809,0.440055681
Texas,HOOD,51161,44291,291,5299,6870,0.865718027,0.134281973,0.103574989
Texas,HOPKINS,35088,26492,2652,5314,8596,0.75501596,0.24498404,0.151447788
Texas,HOUSTON,23512,14623,6194,2365,8889,0.621937734,0.378062266,0.100586934
Texas,HOWARD,34927,18598,1809,13386,16329,0.532482034,0.467517966,0.383256506
Texas,HUDSPETH,3407,633,54,2700,2774,0.185793954,0.814206046,0.792486058
Texas,HUNT,85955,64104,7514,11800,21851,0.745785585,0.254214415,0.137281135
Texas,HUTCHINSON,21992,16233,547,4420,5759,0.738132048,0.261867952,0.200982175
Texas,IRION,1596,1067,47,460,529,0.668546366,0.331453634,0.288220551
Texas,JACK,9027,7249,407,1303,1778,0.803035338,0.196964662,0.144344744
Texas,JACKSON,14075,8807,1035,4113,5268,0.625719361,0.374280639,0.292220249
Texas,JASPER,35703,26890,5891,2035,8813,0.753157998,0.246842002,0.056998011
Texas,JEFF DAVIS,2319,1229,3,1033,1090,0.529969815,0.470030185,0.445450625
Texas,JEFFERSON,251627,112240,83688,42769,139387,0.446057061,0.553942939,0.169969836
Texas,JIM HOGG,5257,156,78,4909,5101,0.029674719,0.970325281,0.933802549
Texas,JIM WELLS,41014,8046,171,32365,32968,0.196176915,0.803823085,0.789120788
Texas,JOHNSON,151174,115663,3867,27366,35511,0.765098496,0.234901504,0.181023192
Texas,JONES,20137,11823,2836,5056,8314,0.587128172,0.412871828,0.251080101
Texas,KARNES,14936,5967,1321,7466,8969,0.399504553,0.600495447,0.499866095
Texas,KAUFMAN,103385,72220,9727,17768,31165,0.698553949,0.301446051,0.171862456
Texas,KENDALL,33745,25945,140,6962,7800,0.768854645,0.231145355,0.206312046
Texas,KENEDY,451,113,1,337,338,0.250554324,0.749445676,0.747228381
Texas,KENT,829,761,0,65,68,0.917973462,0.082026538,0.07840772
Texas,KERR,49469,35675,847,11922,13794,0.721158705,0.278841295,0.240999414
Texas,KIMBLE,4577,3347,5,1199,1230,0.731265021,0.268734979,0.261961984
Texas,KING,227,207,0,20,20,0.911894273,0.088105727,0.088105727
Texas,KINNEY,3574,1425,46,2057,2149,0.398712927,0.601287073,0.575545607
Texas,KLEBERG,31925,7399,1131,22377,24526,0.231761942,0.768238058,0.700924041
Texas,KNOX,3713,2333,248,1117,1380,0.628332884,0.371667116,0.300834904
Texas,LAMAR,49740,37867,6537,3212,11873,0.761298754,0.238701246,0.064575794
Texas,LAMB,13996,6010,534,7281,7986,0.429408402,0.570591598,0.520220063
Texas,LAMPASAS,19837,14941,705,3478,4896,0.753188486,0.246811514,0.175328931
Texas,LA SALLE,6850,993,77,5743,5857,0.144963504,0.855036496,0.838394161
Texas,LAVACA,19269,14644,1414,3124,4625,0.759977165,0.240022835,0.162125694
Texas,LEE,16591,10828,1805,3690,5763,0.652642999,0.347357001,0.22240974
Texas,LEON,16827,13055,1262,2242,3772,0.775836453,0.224163547,0.133238248
Texas,LIBERTY,75662,52096,8381,13650,23566,0.688535857,0.311464143,0.180407602
Texas,LIMESTONE,23350,14421,4082,4448,8929,0.617601713,0.382398287,0.190492505
Texas,LIPSCOMB,3324,2238,9,946,1086,0.673285199,0.326714801,0.284596871
Texas,LIVE OAK,11526,6628,531,4137,4898,0.575047718,0.424952282,0.358927642
Texas,LLANO,19115,17069,157,1573,2046,0.892963641,0.107036359,0.082291394
Texas,LOVING,85,43,0,32,42,0.505882353,0.494117647,0.376470588
Texas,LUBBOCK,278339,159437,18763,89120,118902,0.572815883,0.427184117,0.320185098
Texas,LYNN,5886,2962,99,2735,2924,0.503227999,0.496772001,0.46466191
Texas,MCCULLOCH,8281,5533,89,2502,2748,0.66815602,0.33184398,0.302137423
Texas,MCLENNAN,234626,138247,34058,55370,96379,0.589222848,0.410777152,0.235992601
Texas,MCMULLEN,696,396,0,291,300,0.568965517,0.431034483,0.418103448
Texas,MADISON,13590,7937,2838,2721,5653,0.584032377,0.415967623,0.200220751
Texas,MARION,10544,7527,2538,338,3017,0.713865706,0.286134294,0.032056146
Texas,MARTIN,4804,2522,120,2155,2282,0.524979184,0.475020816,0.448584513
Texas,MASON,3978,3117,0,848,861,0.783559578,0.216440422,0.213172448
Texas,MATAGORDA,36653,17350,3861,14055,19303,0.473358252,0.526641748,0.383461108
Texas,MAVERICK,54107,1610,47,51692,52497,0.029755854,0.970244146,0.955366219
Texas,MEDINA,46009,21258,1003,22941,24751,0.462040036,0.537959964,0.498619835
Texas,MENARD,2232,1490,25,667,742,0.667562724,0.332437276,0.298835125
Texas,MIDLAND,138472,73350,8775,52702,65122,0.529709977,0.470290023,0.380596799
Texas,MILAM,24691,16131,2266,5807,8560,0.653314973,0.346685027,0.23518691
Texas,MILLS,4880,4012,28,830,868,0.822131148,0.177868852,0.170081967
Texas,MITCHELL,9367,4693,929,3471,4674,0.501014199,0.498985801,0.370556208
Texas,MONTAGUE,19737,17326,24,1928,2411,0.877843644,0.122156356,0.097684552
Texas,MONTGOMERY,458339,326244,18025,94933,132095,0.711796291,0.288203709,0.207123985
Texas,MOORE,21765,8249,345,11470,13516,0.379002986,0.620997014,0.526992878
Texas,MORRIS,12914,8621,2972,1015,4293,0.667570079,0.332429921,0.078596872
Texas,MOTLEY,1153,983,24,138,170,0.852558543,0.147441457,0.119687771
Texas,NACOGDOCHES,64647,39878,11910,11293,24769,0.616857704,0.383142296,0.174687147
Texas,NAVARRO,47739,28614,6910,11309,19125,0.599384151,0.400615849,0.236892268
Texas,NEWTON,14372,10688,2950,424,3684,0.743668244,0.256331756,0.029501809
Texas,NOLAN,15104,9071,590,5116,6033,0.600569386,0.399430614,0.33871822
Texas,NUECES,340568,111696,12442,206798,228872,0.327969745,0.672030255,0.607215006
Texas,OCHILTREE,10314,5092,32,5032,5222,0.493697886,0.506302114,0.487880551
Texas,OLDHAM,2048,1698,20,216,350,0.829101563,0.170898438,0.10546875
Texas,ORANGE,82306,68243,7254,4866,14063,0.829137608,0.170862392,0.059120842
Texas,PALO PINTO,28010,21837,660,5012,6173,0.779614423,0.220385577,0.178936094
Texas,PANOLA,23814,17544,3962,1950,6270,0.736709499,0.263290501,0.081884606
Texas,PARKER,116820,99302,2056,12451,17518,0.850042801,0.149957199,0.106582777
Texas,PARMER,10172,3933,93,6069,6239,0.386649626,0.613350374,0.596637829
Texas,PECOS,15510,4086,809,10427,11424,0.26344294,0.73655706,0.672275951
Texas,POLK,45618,33042,5098,5958,12576,0.724319348,0.275680652,0.13060634
Texas,POTTER,121099,59315,11664,42878,61784,0.489805861,0.510194139,0.35407394
Texas,PRESIDIO,7678,1172,40,6365,6506,0.152643918,0.847356082,0.828991925
Texas,RAINS,10976,9531,292,872,1445,0.868349125,0.131650875,0.079446064
Texas,RANDALL,121090,94239,2739,20070,26851,0.778255843,0.221744157,0.165744488
Texas,REAGAN,3384,1095,93,2188,2289,0.32358156,0.67641844,0.646572104
Texas,REAL,3326,2630,2,675,696,0.790739627,0.209260373,0.202946482
Texas,RED RIVER,12795,9450,2203,848,3345,0.738569754,0.261430246,0.066275889
Texas,REEVES,13606,2703,477,10088,10903,0.198662355,0.801337645,0.741437601
Texas,REFUGIO,7352,3292,394,3494,4060,0.447769314,0.552230686,0.475244831
Texas,ROBERTS,992,944,0,31,48,0.951612903,0.048387097,0.03125
Texas,ROBERTSON,16596,9709,3616,3029,6887,0.585020487,0.414979513,0.182513859
Texas,ROCKWALL,78749,58336,3945,12582,20413,0.74078401,0.25921599,0.159773457
Texas,RUNNELS,10473,6778,214,3402,3695,0.647188007,0.352811993,0.324835291
Texas,RUSK,53211,35176,9468,7620,18035,0.661066321,0.338933679,0.143203473
Texas,SABINE,10642,9316,946,335,1326,0.875399361,0.124600639,0.031479045
Texas,SAN AUGUSTINE,8898,6175,2271,319,2723,0.693976174,0.306023826,0.035850753
Texas,SAN JACINTO,26482,20281,2866,2849,6201,0.765840949,0.234159051,0.107582509
Texas,SAN PATRICIO,65352,27604,1186,35419,37748,0.422389521,0.577610479,0.541972702
Texas,SAN SABA,6037,4061,134,1702,1976,0.672685108,0.327314892,0.28192811
Texas,SCHLEICHER,3327,1736,12,1560,1591,0.521791404,0.478208596,0.468890893
Texas,SCURRY,16855,9656,754,6156,7199,0.572886384,0.427113616,0.365232869
Texas,SHACKELFORD,3346,2933,46,334,413,0.876569038,0.123430962,0.099820681
Texas,SHELBY,25602,16683,4482,4155,8919,0.651628779,0.348371221,0.162292008
Texas,SHERMAN,3040,1770,5,1237,1270,0.582236842,0.417763158,0.406907895
Texas,SMITH,209691,130494,37736,36002,79197,0.622315693,0.377684307,0.171690726
Texas,SOMERVELL,8444,6680,107,1600,1764,0.791094268,0.208905732,0.189483657
Texas,STARR,60882,803,49,59862,60079,0.013189448,0.986810552,0.98324628
Texas,STEPHENS,9561,7226,236,2002,2335,0.755778684,0.244221316,0.209392323
Texas,STERLING,1223,835,2,386,388,0.682747343,0.317252657,0.315617334
Texas,STONEWALL,1447,1222,40,169,225,0.844505874,0.155494126,0.116793366
Texas,SUTTON,4123,1551,42,2527,2572,0.376182391,0.623817609,0.612903226
Texas,SWISHER,7816,3988,424,3154,3828,0.510235415,0.489764585,0.403531218
Texas,TARRANT,1814667,939447,265263,484241,875220,0.517696635,0.482303365,0.266848408
Texas,TAYLOR,131425,87738,9095,29150,43687,0.66758988,0.33241012,0.221799505
Texas,TERRELL,1001,346,0,616,655,0.345654346,0.654345654,0.615384615
Texas,TERRY,12561,5622,607,6227,6939,0.44757583,0.55242417,0.495740785
Texas,THROCKMORTON,1626,1513,2,102,113,0.930504305,0.069495695,0.062730627
Texas,TITUS,32045,15762,3094,12652,16283,0.491870807,0.508129193,0.394819785
Texas,TOM GREEN,110434,63644,4210,39629,46790,0.576308021,0.423691979,0.358847819
Texas,TRAVIS,1034842,522664,84942,345955,512178,0.505066474,0.494933526,0.334307073
Texas,TRINITY,14466,11653,1510,1156,2813,0.805544034,0.194455966,0.079911517
Texas,TYLER,21638,17341,2373,1481,4297,0.801414179,0.198585821,0.068444403
Texas,UPSHUR,39386,32280,3345,2600,7106,0.819580562,0.180419438,0.066013304
Texas,UPTON,3300,1676,83,1527,1624,0.507878788,0.492121212,0.462727273
Texas,UVALDE,26434,7671,139,18351,18763,0.290194447,0.709805553,0.694219566
Texas,VAL VERDE,48578,8440,632,38989,40138,0.1737412,0.8262588,0.802606118
Texas,VAN ZANDT,52507,44957,1240,4877,7550,0.856209648,0.143790352,0.092882854
Texas,VICTORIA,87188,41704,5054,38323,45484,0.478322705,0.521677295,0.439544433
Texas,WALKER,67447,39361,15224,11351,28086,0.583584148,0.416415852,0.168295106
Texas,WALLER,42894,19205,10234,12402,23689,0.447731617,0.552268383,0.289131347
Texas,WARD,10705,4898,482,5156,5807,0.457543204,0.542456796,0.481644092
Texas,WASHINGTON,33628,22311,5915,4586,11317,0.66346497,0.33653503,0.13637445
Texas,WEBB,250320,8759,346,239295,241561,0.034991211,0.965008789,0.955956376
Texas,WHARTON,41153,19567,5698,15443,21586,0.475469589,0.524530411,0.375258183
Texas,WHEELER,5414,3847,126,1339,1567,0.710565201,0.289434799,0.247321758
Texas,WICHITA,131019,89567,13342,21835,41452,0.683618406,0.316381594,0.166655218
Texas,WILBARGER,13451,8468,1058,3514,4983,0.629544272,0.370455728,0.261244517
Texas,WILLACY,21983,2178,392,19179,19805,0.099076559,0.900923441,0.872446891
Texas,WILLIAMSON,426296,271314,25882,98808,154982,0.636445099,0.363554901,0.231782611
Texas,WILSON,42999,25150,679,16558,17849,0.584897323,0.415102677,0.385078723
Texas,WINKLER,7137,3048,173,3854,4089,0.427070198,0.572929802,0.540002802
Texas,WISE,59351,47298,594,10079,12053,0.796920018,0.203079982,0.169820222
Texas,WOOD,41927,35566,2027,3537,6361,0.848283922,0.151716078,0.084360913
Texas,YOAKUM,7918,3067,69,4668,4851,0.387345289,0.612654711,0.589542814
Texas,YOUNG,18368,14792,244,2989,3576,0.805313589,0.194686411,0.162728659
Texas,ZAPATA,14014,955,7,13052,13059,0.06814614,0.93185386,0.93135436
Texas,ZAVALA,11753,766,20,10967,10987,0.065174849,0.934825151,0.933123458
Utah,BEAVER,6527,5731,10,688,796,0.878045044,0.121954956,0.105408304
Utah,BOX ELDER,49660,43828,109,4146,5832,0.882561418,0.117438582,0.083487716
Utah,CACHE,112095,95676,582,11151,16419,0.853526027,0.146473973,0.099478121
Utah,CARBON,21153,17775,90,2624,3378,0.84030634,0.15969366,0.124048598
Utah,DAGGETT,897,798,0,57,99,0.889632107,0.110367893,0.063545151
Utah,DAVIS,306664,262989,3446,25821,43675,0.857580283,0.142419717,0.084199645
Utah,DUCHESNE,18537,16135,71,1138,2402,0.87042132,0.12957868,0.061390732
Utah,EMERY,10902,10036,47,651,866,0.920565034,0.079434966,0.059713814
Utah,GARFIELD,5107,4674,17,237,433,0.915214412,0.084785588,0.046406893
Utah,GRAND,9183,7730,33,859,1453,0.841772841,0.158227159,0.093542415
Utah,IRON,45984,40124,181,3549,5860,0.87256437,0.12743563,0.077179019
Utah,JUAB,10233,9595,11,394,638,0.937652692,0.062347308,0.038502883
Utah,KANE,7093,6757,10,264,336,0.952629353,0.047370647,0.037219794
Utah,MILLARD,12436,10540,49,1592,1896,0.847539402,0.152460598,0.128015439
Utah,MORGAN,9485,9092,0,231,393,0.958566157,0.041433843,0.024354244
Utah,PIUTE,1699,1554,3,131,145,0.91465568,0.08534432,0.077104179
Utah,RICH,2264,2179,3,51,85,0.96245583,0.03754417,0.022526502
Utah,SALT LAKE,1032226,764255,14685,176023,267971,0.74039503,0.25960497,0.170527578
Utah,SAN JUAN,14707,6561,22,721,8146,0.446114095,0.553885905,0.049024274
Utah,SANPETE,27645,24019,235,2574,3626,0.868837041,0.131162959,0.093109061
Utah,SEVIER,20759,19230,94,943,1529,0.9263452,0.0736548,0.04542608
Utah,SUMMIT,36598,31291,101,4162,5307,0.854992076,0.145007924,0.113722061
Utah,TOOELE,58158,49059,532,6712,9099,0.84354689,0.15645311,0.115409746
Utah,UINTAH,32809,27161,41,2334,5648,0.827852114,0.172147886,0.071139017
Utah,UTAH,516571,434416,2710,55498,82155,0.840960875,0.159039125,0.107435377
Utah,WASATCH,23661,20074,57,3057,3587,0.848400321,0.151599679,0.129199949
Utah,WASHINGTON,139484,119625,590,13528,19859,0.857625247,0.142374753,0.096986034
Utah,WAYNE,2756,2586,23,114,170,0.938316401,0.061683599,0.041364296
Utah,WEBER,230940,180546,3043,38643,50394,0.781787477,0.218212523,0.167329176
Vermont,ADDISON,36814,34681,313,674,2133,0.942060086,0.057939914,0.018308252
Vermont,BENNINGTON,36990,35317,163,554,1673,0.95477156,0.04522844,0.014977021
Vermont,CALEDONIA,31170,29857,179,344,1313,0.957876163,0.042123837,0.011036253
Vermont,CHITTENDEN,156696,142596,2812,2945,14100,0.910016848,0.089983152,0.018794353
Vermont,ESSEX,6316,6087,29,63,229,0.963742875,0.036257125,0.009974668
Vermont,FRANKLIN,47853,45222,207,582,2631,0.945019121,0.054980879,0.012162247
Vermont,GRAND ISLE,7032,6658,10,90,374,0.946814562,0.053185438,0.012798635
Vermont,LAMOILLE,24471,23393,133,320,1078,0.955947857,0.044052143,0.013076703
Vermont,ORANGE,28980,27884,77,306,1096,0.962180814,0.037819186,0.010559006
Vermont,ORLEANS,27198,26123,204,308,1075,0.960475035,0.039524965,0.011324362
Vermont,RUTLAND,61599,59368,288,706,2231,0.96378188,0.03621812,0.011461225
Vermont,WASHINGTON,59462,56399,522,1009,3063,0.94848811,0.05151189,0.01696882
Vermont,WINDHAM,44310,41730,430,828,2580,0.941773866,0.058226134,0.018686527
Vermont,WINDSOR,56607,54035,255,723,2572,0.954563923,0.045436077,0.012772272
Virginia,ACCOMACK,33454,20430,9620,2902,13024,0.610689305,0.389310695,0.08674598
Virginia,ALBEMARLE,99484,77470,9487,5343,22014,0.778718186,0.221281814,0.053707129
Virginia,ALLEGHANY,16297,15057,801,165,1240,0.923912377,0.076087623,0.010124563
Virginia,AMELIA,12674,9200,3052,84,3474,0.725895534,0.274104466,0.006627742
Virginia,AMHERST,32301,24374,5992,636,7927,0.754589641,0.245410359,0.019689793
Virginia,APPOMATTOX,14952,11448,3206,20,3504,0.76565008,0.23434992,0.001337614
Virginia,ARLINGTON,209077,133346,17518,31505,75731,0.637784166,0.362215834,0.150686111
Virginia,AUGUSTA,73662,67911,2959,1576,5751,0.921927181,0.078072819,0.02139502
Virginia,BATH,4713,4367,169,143,346,0.926586039,0.073413961,0.030341608
Virginia,BEDFORD,68750,61964,3813,1125,6786,0.901294545,0.098705455,0.016363636
Virginia,BLAND,6827,6598,189,20,229,0.966456716,0.033543284,0.002929544
Virginia,BOTETOURT,33074,31074,1074,386,2000,0.93952954,0.06047046,0.011670799
Virginia,BRUNSWICK,17372,6956,9955,306,10416,0.40041446,0.59958554,0.017614552
Virginia,BUCHANAN,24071,23114,478,90,957,0.960242616,0.039757384,0.003738939
Virginia,BUCKINGHAM,17071,10432,6166,189,6639,0.611094839,0.388905161,0.011071408
Virginia,CAMPBELL,54797,44433,7922,936,10364,0.810865558,0.189134442,0.017081227
Virginia,CAROLINE,28510,18141,8412,992,10369,0.636303052,0.363696948,0.034794809
Virginia,CARROLL,29989,28749,247,791,1240,0.958651506,0.041348494,0.026376338
Virginia,CHARLES CITY,7226,2940,3563,99,4286,0.406864102,0.593135898,0.013700526
Virginia,CHARLOTTE,12546,8338,3758,247,4208,0.664594293,0.335405707,0.01968755
Virginia,CHESTERFIELD,316895,207288,69010,22613,109607,0.654122028,0.345877972,0.071358021
Virginia,CLARKE,14143,12448,799,493,1695,0.880152726,0.119847274,0.034858234
Virginia,CRAIG,5186,5080,10,0,106,0.979560355,0.020439645,0
Virginia,CULPEPER,46894,33616,6867,4121,13278,0.71685077,0.28314923,0.087879046
Virginia,CUMBERLAND,9951,6235,3399,121,3716,0.626570194,0.373429806,0.012159582
Virginia,DICKENSON,15877,15621,68,74,256,0.983876047,0.016123953,0.00466083
Virginia,DINWIDDIE,27926,17575,9225,690,10351,0.629341832,0.370658168,0.024708157
Virginia,ESSEX,11130,6216,4300,350,4914,0.558490566,0.441509434,0.031446541
Virginia,FAIRFAX,1083770,592200,96134,167774,491570,0.546425902,0.453574098,0.154805909
Virginia,FAUQUIER,65495,53516,5341,4237,11979,0.817100542,0.182899458,0.064691961
Virginia,FLOYD,15268,14385,186,410,883,0.942166623,0.057833377,0.02685355
Virginia,FLUVANNA,25749,20317,3896,763,5432,0.789040351,0.210959649,0.029632219
Virginia,FRANKLIN,56012,48994,4749,1424,7018,0.87470542,0.12529458,0.025423124
Virginia,FREDERICK,78397,67394,3145,5257,11003,0.859650242,0.140349758,0.067056137
Virginia,GILES,17149,16443,230,206,706,0.958831419,0.041168581,0.012012362
Virginia,GLOUCESTER,36821,31516,3277,954,5305,0.855924608,0.144075392,0.025909128
Virginia,GOOCHLAND,21496,16442,4408,447,5054,0.764886491,0.235113509,0.020794566
Virginia,GRAYSON,15535,14617,354,425,918,0.940907628,0.059092372,0.02735758
Virginia,GREENE,18453,15858,1244,785,2595,0.85937246,0.14062754,0.042540508
Virginia,GREENSVILLE,12127,4565,7211,176,7562,0.376432753,0.623567247,0.01451307
Virginia,HALIFAX,36140,21717,13484,597,14423,0.600913116,0.399086884,0.016519092
Virginia,HANOVER,99964,85173,9197,2172,14791,0.852036733,0.147963267,0.021727822
Virginia,HENRICO,307576,175827,88616,14907,131749,0.571653835,0.428346165,0.04846607
Virginia,HENRY,53971,38562,11741,2594,15409,0.714494821,0.285505179,0.048062849
Virginia,HIGHLAND,2317,2295,0,5,22,0.990504963,0.009495037,0.002157963
Virginia,ISLE OF WIGHT,35240,24959,8720,683,10281,0.708257662,0.291742338,0.019381385
Virginia,JAMES CITY,66939,51949,8921,3078,14990,0.776064775,0.223935225,0.045982163
Virginia,KING AND QUEEN,6968,4582,2142,197,2386,0.657577497,0.342422503,0.028272101
Virginia,KING GEORGE,23739,17679,4411,863,6060,0.744723872,0.255276128,0.03635368
Virginia,KING WILLIAM,15861,12041,3003,321,3820,0.759157682,0.240842318,0.02023832
Virginia,LANCASTER,11371,7902,3209,111,3469,0.694925688,0.305074312,0.009761674
Virginia,LEE,25528,23848,929,410,1680,0.934189909,0.065810091,0.016060796
Virginia,LOUDOUN,314980,196435,22756,38826,118545,0.623642771,0.376357229,0.123264969
Virginia,LOUISA,33083,25561,5917,752,7522,0.77263247,0.22736753,0.022730708
Virginia,LUNENBURG,12838,7656,4502,478,5182,0.596354572,0.403645428,0.037233214
Virginia,MADISON,13270,11269,1524,81,2001,0.849208742,0.150791258,0.006103994
Virginia,MATHEWS,8965,7741,875,119,1224,0.863469046,0.136530954,0.013273843
Virginia,MECKLENBURG,32548,19186,11962,804,13362,0.589467863,0.410532137,0.024701979
Virginia,MIDDLESEX,10855,8497,2146,173,2358,0.782772916,0.217227084,0.015937356
Virginia,MONTGOMERY,94179,80677,3625,2527,13502,0.856634706,0.143365294,0.026831884
Virginia,NELSON,15000,12266,2370,160,2734,0.817733333,0.182266667,0.010666667
Virginia,NEW KENT,18460,14816,2949,208,3644,0.802600217,0.197399783,0.011267606
Virginia,NORTHAMPTON,12408,6736,4734,873,5672,0.542875564,0.457124436,0.070357834
Virginia,NORTHUMBERLAND,12389,8696,3592,92,3693,0.701912987,0.298087013,0.007425942
Virginia,NOTTOWAY,15875,8771,6310,621,7104,0.552503937,0.447496063,0.03911811
Virginia,ORANGE,33625,27119,4342,1176,6506,0.806513011,0.193486989,0.034973978
Virginia,PAGE,24038,22837,356,397,1201,0.950037441,0.049962559,0.016515517
Virginia,PATRICK,18513,16687,1250,450,1826,0.901366607,0.098633393,0.024307244
Virginia,PITTSYLVANIA,63318,47003,13783,1355,16315,0.742332354,0.257667646,0.021399918
Virginia,POWHATAN,28003,23214,3877,496,4789,0.828982609,0.171017391,0.017712388
Virginia,PRINCE EDWARD,23017,14250,7829,516,8767,0.619107616,0.380892384,0.022418213
Virginia,PRINCE GEORGE,36013,20861,11475,2189,15152,0.579263044,0.420736956,0.060783606
Virginia,PRINCE WILLIAM,404011,195815,77814,82387,208196,0.484677397,0.515322603,0.203922665
Virginia,PULASKI,34869,31904,1818,455,2965,0.91496745,0.08503255,0.01304884
Virginia,RAPPAHANNOCK,7440,6676,366,224,764,0.897311828,0.102688172,0.030107527
Virginia,RICHMOND,9234,5720,2790,508,3514,0.619449859,0.380550141,0.055014078
Virginia,ROANOKE,92432,81631,4809,2015,10801,0.883146529,0.116853471,0.02179981
Virginia,ROCKBRIDGE,22357,20931,687,301,1426,0.936216845,0.063783155,0.013463345
Virginia,ROCKINGHAM,76353,69667,1207,4085,6686,0.912433041,0.087566959,0.0535015
Virginia,RUSSELL,28773,27978,403,119,795,0.97236993,0.02763007,0.004135822
Virginia,SCOTT,23061,22469,150,238,592,0.974328954,0.025671046,0.010320454
Virginia,SHENANDOAH,42076,37997,793,2560,4079,0.903056374,0.096943626,0.060842285
Virginia,SMYTH,32103,30547,625,516,1556,0.95153101,0.04846899,0.016073264
Virginia,SOUTHAMPTON,18576,11072,6910,207,7504,0.596037898,0.403962102,0.011143411
Virginia,SPOTSYLVANIA,122854,88536,18982,9399,34318,0.720660296,0.279339704,0.076505445
Virginia,STAFFORD,129446,87496,21936,12060,41950,0.675926641,0.324073359,0.093166262
Virginia,SURRY,6988,3543,3273,88,3445,0.507012021,0.492987979,0.012593017
Virginia,SUSSEX,12095,4675,7041,266,7420,0.386523357,0.613476643,0.021992559
Virginia,TAZEWELL,44846,42428,1201,310,2418,0.946082148,0.053917852,0.006912545
Virginia,WARREN,37567,33363,1467,1322,4204,0.888093273,0.111906727,0.03519046
Virginia,WASHINGTON,54691,52610,673,712,2081,0.961949864,0.038050136,0.013018595
Virginia,WESTMORELAND,17468,11080,5120,1006,6388,0.634302725,0.365697275,0.057591024
Virginia,WISE,41361,38177,2092,477,3184,0.923019269,0.076980731,0.011532603
Virginia,WYTHE,29203,27584,1098,279,1619,0.94456049,0.05543951,0.009553813
Virginia,YORK,65503,48550,8820,3023,16953,0.741187427,0.258812573,0.046150558
Virginia,ALEXANDRIA CITY,140337,75252,29577,22438,65085,0.536223519,0.463776481,0.159886559
Virginia,BEDFORD CITY,6103,4542,1314,106,1561,0.744224152,0.255775848,0.017368507
Virginia,BRISTOL CITY,17747,16028,1053,147,1719,0.903138559,0.096861441,0.00828309
Virginia,BUENA VISTA CITY,6679,6012,535,65,667,0.900134751,0.099865249,0.009731996
Virginia,CHARLOTTESVILLE CITY,43223,28701,8511,2134,14522,0.66402147,0.33597853,0.049371862
Virginia,CHESAPEAKE CITY,223233,134475,65883,9754,88758,0.602397495,0.397602505,0.043694257
Virginia,COLONIAL HEIGHTS CITY,17426,13968,2039,703,3458,0.801560886,0.198439114,0.040342018
Virginia,COVINGTON CITY,5903,4891,715,110,1012,0.828561748,0.171438252,0.018634593
Virginia,DANVILLE CITY,43185,20063,20819,1235,23122,0.46458261,0.53541739,0.028597893
Virginia,EMPORIA CITY,5825,1808,3729,197,4017,0.310386266,0.689613734,0.033819742
Virginia,FAIRFAX CITY,22712,13866,1031,3536,8846,0.610514266,0.389485734,0.155688623
Virginia,FALLS CHURCH CITY,12300,9074,634,1095,3226,0.737723577,0.262276423,0.08902439
Virginia,FRANKLIN CITY,8531,3333,4905,57,5198,0.390692768,0.609307232,0.006681514
Virginia,FREDERICKSBURG CITY,24932,15038,5716,2607,9894,0.603160597,0.396839403,0.104564415
Virginia,GALAX CITY,6942,5618,270,976,1324,0.809276865,0.190723135,0.140593489
Virginia,HAMPTON CITY,137471,56639,67918,6317,80832,0.412006896,0.587993104,0.04595151
Virginia,HARRISONBURG CITY,49043,35353,3049,7816,13690,0.720857207,0.279142793,0.159370348
Virginia,HOPEWELL CITY,22501,11985,8724,1415,10516,0.532642994,0.467357006,0.062886094
Virginia,LEXINGTON CITY,6990,5448,601,386,1542,0.779399142,0.220600858,0.055221745
Virginia,LYNCHBURG CITY,75657,47785,21736,2275,27872,0.631600513,0.368399487,0.030069921
Virginia,MANASSAS CITY,37943,18103,5198,11898,19840,0.477110402,0.522889598,0.313575627
Virginia,MANASSAS PARK CITY,14409,6072,1837,4819,8337,0.42140329,0.57859671,0.33444375
Virginia,MARTINSVILLE CITY,13854,6751,6135,550,7103,0.487296088,0.512703912,0.039699726
Virginia,NEWPORT NEWS CITY,180831,83369,71497,13440,97462,0.461032677,0.538967323,0.07432354
Virginia,NORFOLK CITY,243056,107835,102437,16202,135221,0.443663189,0.556336811,0.066659535
Virginia,NORTON CITY,3971,3576,290,55,395,0.900528834,0.099471166,0.013850416
Virginia,PETERSBURG CITY,32226,4894,25564,1192,27332,0.151864954,0.848135046,0.036988767
Virginia,POQUOSON CITY,12110,11360,51,221,750,0.938067713,0.061932287,0.018249381
Virginia,PORTSMOUTH CITY,95786,38606,50307,2940,57180,0.403044286,0.596955714,0.030693421
Virginia,RADFORD CITY,16511,14130,1338,388,2381,0.855793108,0.144206892,0.023499485
Virginia,RICHMOND CITY,205348,80335,102038,12539,125013,0.391213939,0.608786061,0.061062197
Virginia,ROANOKE CITY,96742,60048,26685,5153,36694,0.620702487,0.379297513,0.053265386
Virginia,SALEM CITY,24792,21635,1779,615,3157,0.872660536,0.127339464,0.024806389
Virginia,STAUNTON CITY,23906,19716,2940,532,4190,0.824730193,0.175269807,0.022253827
Virginia,SUFFOLK CITY,84216,42927,35008,2466,41289,0.509724993,0.490275007,0.029281847
Virginia,VIRGINIA BEACH CITY,439528,283418,81852,29365,156110,0.644823538,0.355176462,0.066810306
Virginia,WAYNESBORO CITY,21030,16714,2276,1345,4316,0.794769377,0.205230623,0.063956253
Virginia,WILLIAMSBURG CITY,14207,10064,2038,933,4143,0.708383191,0.291616809,0.065671852
Virginia,WINCHESTER CITY,26330,18337,2838,3984,7993,0.696429928,0.303570072,0.151310292
Washington,ADAMS,18575,7223,24,10992,11352,0.388855989,0.611144011,0.591763122
Washington,ASOTIN,21658,19976,104,665,1682,0.922338166,0.077661834,0.03070459
Washington,BENTON,175424,130743,2397,32471,44681,0.745297109,0.254702891,0.1851001
Washington,CHELAN,72431,51207,247,18658,21224,0.706976295,0.293023705,0.257596885
Washington,CLALLAM,71411,60482,565,3659,10929,0.846956351,0.153043649,0.051238605
Washington,CLARK,426984,349159,8057,32401,77825,0.817733217,0.182266783,0.075883405
Washington,COLUMBIA,4001,3586,9,247,415,0.896275931,0.103724069,0.061734566
Washington,COWLITZ,102138,87539,454,7902,14599,0.85706593,0.14293407,0.077365917
Washington,DOUGLAS,38369,26095,43,10869,12274,0.680106336,0.319893664,0.283275561
Washington,FERRY,7584,5675,51,260,1909,0.748285865,0.251714135,0.0342827
Washington,FRANKLIN,78680,34155,1350,40090,44525,0.434100153,0.565899847,0.509532283
Washington,GARFIELD,2246,2087,0,55,159,0.92920748,0.07079252,0.024487979
Washington,GRANT,88885,51160,696,33901,37725,0.575575181,0.424424819,0.381402936
Washington,GRAYS HARBOR,72272,58828,758,6255,13444,0.813980518,0.186019482,0.086548041
Washington,ISLAND,78707,64871,1432,4444,13836,0.824208774,0.175791226,0.056462576
Washington,JEFFERSON,29802,26592,279,876,3210,0.892289108,0.107710892,0.029394
Washington,KING,1940777,1257665,115660,171701,683112,0.648021385,0.351978615,0.088470236
Washington,KITSAP,251400,198293,6632,15837,53107,0.788754972,0.211245028,0.062995227
Washington,KITTITAS,40954,35194,311,3164,5760,0.859354398,0.140645602,0.077257411
Washington,KLICKITAT,20421,17076,107,2198,3345,0.836198031,0.163801969,0.107634298
Washington,LEWIS,75399,64838,459,6540,10561,0.859931829,0.140068171,0.086738551
Washington,LINCOLN,10536,9824,30,248,712,0.932422172,0.067577828,0.023538345
Washington,MASON,60545,50135,609,4800,10410,0.828061772,0.171938228,0.079279874
Washington,OKANOGAN,40959,27932,192,7204,13027,0.681950243,0.318049757,0.1758832
Washington,PACIFIC,20945,17688,94,1700,3257,0.844497493,0.155502507,0.081164956
Washington,PEND OREILLE,12976,11667,13,399,1309,0.899121455,0.100878545,0.030749075
Washington,PIERCE,798528,561274,52546,73070,237254,0.70288581,0.29711419,0.091505871
Washington,SAN JUAN,15740,14207,73,853,1533,0.902604828,0.097395172,0.054193139
Washington,SKAGIT,117087,89980,632,19542,27107,0.768488389,0.231511611,0.166901535
Washington,SKAMANIA,11053,9815,11,579,1238,0.88799421,0.11200579,0.052383968
Washington,SNOHOMISH,714443,531207,15936,63586,183236,0.743526076,0.256473924,0.089000802
Washington,SPOKANE,470375,407597,7960,21372,62778,0.866536274,0.133463726,0.045436088
Washington,STEVENS,43498,38266,180,1207,5232,0.879718608,0.120281392,0.027748402
Washington,THURSTON,252410,198760,6523,17982,53650,0.787448992,0.212551008,0.071241234
Washington,WAHKIAKUM,4003,3693,7,154,310,0.922558081,0.077441919,0.038471147
Washington,WALLA WALLA,58643,43483,933,11599,15160,0.741486622,0.258513378,0.197790018
Washington,WHATCOM,201404,164724,1779,15845,36680,0.817878493,0.182121507,0.078672718
Washington,WHITMAN,44997,36743,901,2121,8254,0.816565549,0.183434451,0.047136476
Washington,YAKIMA,242454,115823,1537,108920,126631,0.477711236,0.522288764,0.449239856
West Virginia,BARBOUR,16472,15882,68,100,590,0.964181642,0.035818358,0.006070908
West Virginia,BERKELEY,104410,89617,7149,3940,14793,0.858318169,0.141681831,0.037735849
West Virginia,BOONE,24617,24187,232,88,430,0.982532396,0.017467604,0.003574765
West Virginia,BRAXTON,14531,14205,86,91,326,0.977565205,0.022434795,0.006262473
West Virginia,BROOKE,24021,23199,412,153,822,0.965779943,0.034220057,0.006369427
West Virginia,CABELL,96240,87440,4433,1074,8800,0.908561929,0.091438071,0.011159601
West Virginia,CALHOUN,7613,7443,17,1,170,0.977669775,0.022330225,0.000131354
West Virginia,CLAY,9432,9284,17,15,148,0.984308736,0.015691264,0.001590331
West Virginia,DODDRIDGE,8147,7866,45,142,281,0.965508776,0.034491224,0.017429729
West Virginia,FAYETTE,46000,42591,2257,409,3409,0.925891304,0.074108696,0.008891304
West Virginia,GILMER,8623,6936,932,373,1687,0.804360431,0.195639569,0.043256407
West Virginia,GRANT,11929,11602,69,84,327,0.972587811,0.027412189,0.007041663
West Virginia,GREENBRIER,35572,33367,1010,431,2205,0.938013044,0.061986956,0.012116271
West Virginia,HAMPSHIRE,23791,22914,254,247,877,0.963137321,0.036862679,0.010382077
West Virginia,HANCOCK,30594,29066,548,316,1528,0.950055566,0.049944434,0.010328823
West Virginia,HARDY,13912,13040,344,470,872,0.937320299,0.062679701,0.033783784
West Virginia,HARRISON,68959,65499,1047,879,3460,0.949825258,0.050174742,0.012746705
West Virginia,JACKSON,29206,28545,149,190,661,0.977367664,0.022632336,0.006505513
West Virginia,JEFFERSON,53545,45511,3308,2509,8034,0.849957979,0.150042021,0.046857783
West Virginia,KANAWHA,192572,170370,7911,1945,22202,0.884708057,0.115291943,0.010100118
West Virginia,LEWIS,16389,15965,44,40,424,0.974128989,0.025871011,0.002440661
West Virginia,LINCOLN,21714,21409,51,15,305,0.985953763,0.014046237,0.000690799
West Virginia,LOGAN,36508,35037,823,273,1471,0.959707461,0.040292539,0.007477813
West Virginia,MCDOWELL,21966,19496,2288,21,2470,0.887553492,0.112446508,0.000956023
West Virginia,MARION,56460,52885,1925,549,3575,0.936680836,0.063319164,0.009723698
West Virginia,MARSHALL,32993,32119,209,269,874,0.973509532,0.026490468,0.008153245
West Virginia,MASON,27242,26532,174,123,710,0.973937303,0.026062697,0.004515087
West Virginia,MERCER,62251,56653,3566,493,5598,0.910073734,0.089926266,0.007919551
West Virginia,MINERAL,28049,26569,920,200,1480,0.947235196,0.052764804,0.007130379
West Virginia,MINGO,26660,25734,593,67,926,0.965266317,0.034733683,0.002513128
West Virginia,MONONGALIA,96417,86381,3200,1739,10036,0.895910472,0.104089528,0.018036238
West Virginia,MONROE,13528,13121,117,88,407,0.969914252,0.030085748,0.006505027
West Virginia,MORGAN,17507,16894,131,187,613,0.964985434,0.035014566,0.010681442
West Virginia,NICHOLAS,26201,25618,3,50,583,0.977748941,0.022251059,0.001908324
West Virginia,OHIO,44307,41090,1664,382,3217,0.927392963,0.072607037,0.008621662
West Virginia,PENDLETON,7666,7304,229,43,362,0.952778502,0.047221498,0.005609183
West Virginia,PLEASANTS,7630,7383,69,25,247,0.967627785,0.032372215,0.00327654
West Virginia,POCAHONTAS,8750,8490,119,22,260,0.970285714,0.029714286,0.002514286
West Virginia,PRESTON,33471,31593,1042,423,1878,0.943891727,0.056108273,0.012637806
West Virginia,PUTNAM,55660,53543,655,493,2117,0.961965505,0.038034495,0.008857348
West Virginia,RALEIGH,78852,69159,6631,1023,9693,0.877073505,0.122926495,0.012973672
West Virginia,RANDOLPH,29361,28412,292,202,949,0.967678213,0.032321787,0.006879875
West Virginia,RITCHIE,10391,10212,27,60,179,0.982773554,0.017226446,0.005774228
West Virginia,ROANE,14884,13918,1,111,966,0.935098092,0.064901908,0.007457673
West Virginia,SUMMERS,13813,13125,428,113,688,0.950191848,0.049808152,0.008180699
West Virginia,TAYLOR,16889,16357,176,97,532,0.968500207,0.031499793,0.005743383
West Virginia,TUCKER,7109,6979,24,28,130,0.981713321,0.018286679,0.003938669
West Virginia,TYLER,9188,9042,24,52,146,0.984109708,0.015890292,0.005659556
West Virginia,UPSHUR,24210,23445,185,210,765,0.968401487,0.031598513,0.008674102
West Virginia,WAYNE,42273,41472,69,224,801,0.981051735,0.018948265,0.005298891
West Virginia,WEBSTER,9158,8994,4,67,164,0.98209216,0.01790784,0.007316008
West Virginia,WETZEL,16526,16251,48,69,275,0.983359555,0.016640445,0.004175239
West Virginia,WIRT,5769,5585,20,0,184,0.968105391,0.031894609,0
West Virginia,WOOD,86835,83239,967,739,3596,0.958588127,0.041411873,0.008510393
West Virginia,WYOMING,23668,23150,244,72,518,0.978113909,0.021886091,0.003042082
Wisconsin,ADAMS,20898,19011,634,783,1887,0.909704278,0.090295722,0.0374677
Wisconsin,ASHLAND,16113,13456,59,303,2657,0.835102091,0.164897909,0.018804692
Wisconsin,BARRON,45882,43487,484,896,2395,0.947800881,0.052199119,0.019528355
Wisconsin,BAYFIELD,15078,12989,70,167,2089,0.861453774,0.138546226,0.011075739
Wisconsin,BROWN,248526,208123,4978,17930,40403,0.837429484,0.162570516,0.072145369
Wisconsin,BUFFALO,13544,13103,36,241,441,0.967439457,0.032560543,0.017793857
Wisconsin,BURNETT,15528,14133,93,205,1395,0.910162287,0.089837713,0.013201958
Wisconsin,CALUMET,48960,45334,96,1703,3626,0.925939542,0.074060458,0.034783497
Wisconsin,CHIPPEWA,62362,58947,904,782,3415,0.945239088,0.054760912,0.012539688
Wisconsin,CLARK,34610,32772,77,1263,1838,0.946893961,0.053106039,0.036492343
Wisconsin,COLUMBIA,56596,53367,728,1443,3229,0.942946498,0.057053502,0.025496502
Wisconsin,CRAWFORD,16677,16003,328,157,674,0.959585057,0.040414943,0.009414163
Wisconsin,DANE,490379,401585,23938,28848,88794,0.818927809,0.181072191,0.058827968
Wisconsin,DODGE,88741,81273,2403,3532,7468,0.915844987,0.084155013,0.039801219
Wisconsin,DOOR,27872,26567,140,671,1305,0.953178817,0.046821183,0.02407434
Wisconsin,DOUGLAS,43963,40676,577,511,3287,0.925232582,0.074767418,0.011623411
Wisconsin,DUNN,43788,41135,222,635,2653,0.939412624,0.060587376,0.01450169
Wisconsin,EAU CLAIRE,98952,91026,921,1899,7926,0.919900558,0.080099442,0.019191123
Wisconsin,FLORENCE,4486,4226,0,34,260,0.942041908,0.057958092,0.007579135
Wisconsin,FOND DU LAC,101577,93371,1003,4373,8206,0.919213995,0.080786005,0.043051084
Wisconsin,FOREST,9361,7666,79,144,1695,0.818929602,0.181070398,0.015382972
Wisconsin,GRANT,51055,49140,569,637,1915,0.962491431,0.037508569,0.012476741
Wisconsin,GREEN,36800,35099,202,992,1701,0.953777174,0.046222826,0.026956522
Wisconsin,GREEN LAKE,19064,17970,91,761,1094,0.942614352,0.057385648,0.03991817
Wisconsin,IOWA,23712,22927,70,338,785,0.966894399,0.033105601,0.014254386
Wisconsin,IRON,5978,5822,27,27,156,0.973904316,0.026095684,0.004516561
Wisconsin,JACKSON,20436,17938,474,545,2498,0.877764729,0.122235271,0.026668624
Wisconsin,JEFFERSON,83751,75960,536,5574,7791,0.906974245,0.093025755,0.066554429
Wisconsin,JUNEAU,26701,24741,406,699,1960,0.92659451,0.07340549,0.026178795
Wisconsin,KENOSHA,166373,129738,11118,19510,36635,0.779802011,0.220197989,0.117266624
Wisconsin,KEWAUNEE,20600,19744,91,469,856,0.958446602,0.041553398,0.02276699
Wisconsin,LA CROSSE,114718,104549,1775,1755,10169,0.911356544,0.088643456,0.015298384
Wisconsin,LAFAYETTE,16836,16063,80,533,773,0.954086481,0.045913519,0.031658351
Wisconsin,LANGLADE,19951,19066,102,340,885,0.955641321,0.044358679,0.017041752
Wisconsin,LINCOLN,28710,27721,232,342,989,0.965552072,0.034447928,0.011912226
Wisconsin,MANITOWOC,81266,75059,387,2530,6207,0.923621195,0.076378805,0.031132331
Wisconsin,MARATHON,134041,120848,668,2966,13193,0.901574891,0.098425109,0.022127558
Wisconsin,MARINETTE,41704,40171,98,540,1533,0.963240936,0.036759064,0.012948398
Wisconsin,MARQUETTE,15366,14633,46,394,733,0.95229728,0.04770272,0.025641026
Wisconsin,MENOMINEE,4274,591,35,105,3683,0.13827796,0.86172204,0.02456715
Wisconsin,MILWAUKEE,946584,514826,247324,125377,431758,0.543877775,0.456122225,0.132452059
Wisconsin,MONROE,44714,41290,504,1648,3424,0.923424431,0.076575569,0.036856466
Wisconsin,OCONTO,37632,36118,65,527,1514,0.959768282,0.040231718,0.014004039
Wisconsin,ONEIDA,36029,34568,159,396,1461,0.959449332,0.040550668,0.010991146
Wisconsin,OUTAGAMIE,176777,158364,1856,6337,18413,0.895840522,0.104159478,0.035847424
Wisconsin,OZAUKEE,86429,80515,1136,2000,5914,0.931573893,0.068426107,0.023140381
Wisconsin,PEPIN,7458,7286,31,77,172,0.976937517,0.023062483,0.010324484
Wisconsin,PIERCE,40842,39029,234,632,1813,0.955609422,0.044390578,0.015474267
Wisconsin,POLK,44094,42346,136,658,1748,0.960357418,0.039642582,0.014922665
Wisconsin,PORTAGE,70027,64822,205,1883,5205,0.925671527,0.074328473,0.026889628
Wisconsin,PRICE,14141,13614,37,155,527,0.96273248,0.03726752,0.010961035
Wisconsin,RACINE,195024,144968,20465,22474,50056,0.743334154,0.256665846,0.115237099
Wisconsin,RICHLAND,18020,17288,73,366,732,0.959378468,0.040621532,0.020310766
Wisconsin,ROCK,160356,135656,6176,12092,24700,0.845967722,0.154032278,0.075407219
Wisconsin,RUSK,14670,14182,91,172,488,0.966734833,0.033265167,0.011724608
Wisconsin,ST. CROIX,84363,79853,653,1677,4510,0.946540545,0.053459455,0.019878383
Wisconsin,SAUK,61953,57361,316,2618,4592,0.925879296,0.074120704,0.042257841
Wisconsin,SAWYER,16580,13028,39,267,3552,0.785765983,0.214234017,0.016103739
Wisconsin,SHAWANO,41820,36860,159,919,4960,0.881396461,0.118603539,0.021975132
Wisconsin,SHEBOYGAN,115377,100422,1568,6300,14955,0.870381445,0.129618555,0.054603604
Wisconsin,TAYLOR,20631,20034,65,324,597,0.971062964,0.028937036,0.015704522
Wisconsin,TREMPEALEAU,28853,26812,76,1615,2041,0.929262122,0.070737878,0.055973382
Wisconsin,VERNON,29827,28911,96,398,916,0.96928957,0.03071043,0.013343615
Wisconsin,VILAS,21489,18609,184,277,2880,0.865977942,0.134022058,0.012890316
Wisconsin,WALWORTH,102310,88533,939,10526,13777,0.865340631,0.134659369,0.102883394
Wisconsin,WASHBURN,15893,15177,53,215,716,0.95494872,0.04505128,0.013527968
Wisconsin,WASHINGTON,131840,124226,1296,3391,7614,0.94224818,0.05775182,0.02572057
Wisconsin,WAUKESHA,389740,352795,4760,16200,36945,0.905206035,0.094793965,0.041566172
Wisconsin,WAUPACA,52377,50113,165,1302,2264,0.95677492,0.04322508,0.024858239
Wisconsin,WAUSHARA,24565,22334,459,1366,2231,0.909179727,0.090820273,0.055607572
Wisconsin,WINNEBAGO,166984,151472,2799,5793,15512,0.907104872,0.092895128,0.034691947
Wisconsin,WOOD,74591,70029,357,1649,4562,0.938839806,0.061160194,0.022107225
Wyoming,ALBANY,36186,30694,369,3200,5492,0.848228597,0.151771403,0.08843199
Wyoming,BIG HORN,11636,10383,2,985,1253,0.892316947,0.107683053,0.084651083
Wyoming,CAMPBELL,45840,40767,250,3464,5073,0.889332461,0.110667539,0.07556719
Wyoming,CARBON,15781,12582,124,2633,3199,0.797287878,0.202712122,0.166846207
Wyoming,CONVERSE,13779,12536,29,886,1243,0.909790261,0.090209739,0.064300748
Wyoming,CROOK,7036,6847,4,146,189,0.973138147,0.026861853,0.020750426
Wyoming,FREMONT,40103,28616,143,2312,11487,0.713562576,0.286437424,0.057651547
Wyoming,GOSHEN,13277,11623,38,1319,1654,0.875423665,0.124576335,0.099344731
Wyoming,HOT SPRINGS,4791,4576,11,112,215,0.955124191,0.044875809,0.023377166
Wyoming,JOHNSON,8564,8021,1,295,543,0.936595049,0.063404951,0.03444652
Wyoming,LARAMIE,91719,73793,2413,12141,17926,0.804555218,0.195444782,0.132371701
Wyoming,LINCOLN,17960,16799,13,748,1161,0.935356347,0.064643653,0.041648107
Wyoming,NATRONA,75876,67282,639,5352,8594,0.886736254,0.113263746,0.070536138
Wyoming,NIOBRARA,2478,2289,21,55,189,0.923728814,0.076271186,0.022195319
Wyoming,PARK,28203,26051,87,1387,2152,0.923696061,0.076303939,0.049179165
Wyoming,PLATTE,8677,8039,1,591,638,0.926472283,0.073527717,0.068111098
Wyoming,SHERIDAN,29097,26959,100,1050,2138,0.926521635,0.073478365,0.036086194
Wyoming,SUBLETTE,10065,8648,1,683,1417,0.859215102,0.140784898,0.067858917
Wyoming,SWEETWATER,43890,35446,191,6654,8444,0.807609934,0.192390066,0.151606288
Wyoming,TETON,21326,17611,40,3107,3715,0.825799494,0.174200506,0.145690706
Wyoming,UINTA,20942,18547,18,1816,2395,0.88563652,0.11436348,0.086715691
Wyoming,WASHAKIE,8425,7049,30,1154,1376,0.836676558,0.163323442,0.136973294
Wyoming,WESTON,7152,6684,4,223,468,0.934563758,0.065436242,0.031180089