state,county,total_pop,white,black,latino,non_white,pct_white,pct_latino,pct_nonwhite
Alabama,AUTAUGA,55221,41848,10236,1440,13373,0.757827638,0.026077036,0.242172362
Alabama,BALDWIN,195121,162153,18533,8776,32968,0.831038176,0.044977219,0.168961824
Alabama,BARBOUR,26932,12454,12579,1241,14478,0.462423882,0.046079014,0.537576118
Alabama,BIBB,22604,16840,4838,502,5764,0.745000885,0.022208459,0.254999115
Alabama,BLOUNT,57710,50700,884,4980,7010,0.878530584,0.086293537,0.121469416
Alabama,BULLOCK,10678,2372,7550,473,8306,0.222138977,0.044296685,0.777861023
Alabama,BUTLER,20354,10856,8924,240,9498,0.533359536,0.011791294,0.466640464
Alabama,CALHOUN,116648,85184,23703,4075,31464,0.730265414,0.034934161,0.269734586
Alabama,CHAMBERS,34079,19522,13728,152,14557,0.572845447,0.004460225,0.427154553
Alabama,CHEROKEE,26008,23854,1236,391,2154,0.917179329,0.015033836,0.082820671
Alabama,CHILTON,43819,35289,4471,3350,8530,0.805335585,0.076450855,0.194664415
Alabama,CHOCTAW,13395,7487,5753,48,5908,0.558939903,0.003583427,0.441060097
Alabama,CLARKE,25070,13376,11346,85,11694,0.533546071,0.003390507,0.466453929
Alabama,CLAY,13537,10821,1948,430,2716,0.799364704,0.031764793,0.200635296
Alabama,CLEBURNE,15002,13877,442,345,1125,0.925009999,0.022996934,0.074990001
Alabama,COFFEE,50884,36392,8753,3276,14492,0.715195346,0.064381731,0.284804654
Alabama,COLBERT,54444,42957,8478,1321,11487,0.789012563,0.024263463,0.210987437
Alabama,CONECUH,12865,6557,5748,210,6308,0.509677419,0.016323358,0.490322581
Alabama,COOSA,11027,7190,3384,237,3837,0.652035912,0.0214927,0.347964088
Alabama,COVINGTON,37886,31577,4912,580,6309,0.833474107,0.015309085,0.166525893
Alabama,CRENSHAW,13938,9825,3277,237,4113,0.704907447,0.017003874,0.295092553
Alabama,CULLMAN,80965,74635,857,3493,6330,0.92181807,0.043142098,0.07818193
Alabama,DALE,49866,34829,9678,2980,15037,0.698451851,0.059760157,0.301548149
Alabama,DALLAS,42154,12045,29159,130,30109,0.285738008,0.00308393,0.714261992
Alabama,DEKALB,71068,57485,1270,9957,13583,0.808873192,0.140105251,0.191126808
Alabama,ELMORE,80763,59479,16991,2229,21284,0.73646348,0.027599272,0.26353652
Alabama,ESCAMBIA,37935,23023,12660,466,14912,0.606906551,0.01228417,0.393093449
Alabama,ETOWAH,103766,81479,15947,3740,22287,0.785218665,0.036042634,0.214781335
Alabama,FAYETTE,16896,14413,2033,126,2483,0.85304214,0.007457386,0.14695786
Alabama,FRANKLIN,31634,24833,1301,4958,6801,0.7850098,0.156730101,0.2149902
Alabama,GENEVA,26815,22534,2342,973,4281,0.84035055,0.036285661,0.15964945
Alabama,GREENE,8697,1547,7011,61,7150,0.177877429,0.007013913,0.822122571
Alabama,HALE,15256,6095,8873,170,9161,0.399514945,0.011143157,0.600485055
Alabama,HENRY,17252,11788,4891,429,5464,0.683283098,0.024866682,0.316716902
Alabama,HOUSTON,103534,70069,27121,3338,33465,0.676772848,0.032240617,0.323227152
Alabama,JACKSON,52860,47279,1635,1450,5581,0.894419221,0.02743095,0.105580779
Alabama,JEFFERSON,659026,336064,277830,24991,322962,0.509940427,0.037921114,0.490059573
Alabama,LAMAR,14133,12154,1565,196,1979,0.859973113,0.013868252,0.140026887
Alabama,LAUDERDALE,92737,78773,9156,2229,13964,0.849423639,0.024035714,0.150576361
Alabama,LAWRENCE,33586,25703,3837,697,7883,0.765289109,0.020752695,0.234710891
Alabama,LEE,150982,102965,34698,5615,48017,0.681968712,0.037189864,0.318031288
Alabama,LIMESTONE,88805,68756,11385,5137,20049,0.774235685,0.057845842,0.225764315
Alabama,LOWNDES,10742,2716,7955,36,8026,0.252839322,0.003351331,0.747160678
Alabama,MACON,20018,3220,16186,313,16798,0.16085523,0.015635928,0.83914477
Alabama,MADISON,346438,227290,82732,16214,119148,0.656076989,0.046802025,0.343923011
Alabama,MARENGO,20306,9293,10413,459,11013,0.457647986,0.022604156,0.542352014
Alabama,MARION,30387,27898,1118,726,2489,0.918089973,0.023891796,0.081910027
Alabama,MARSHALL,94318,77992,1805,11944,16326,0.826904727,0.126635425,0.173095273
Alabama,MOBILE,414251,240830,144839,10917,173421,0.581362507,0.026353588,0.418637493
Alabama,MONROE,22217,12183,9282,242,10034,0.548363866,0.01089256,0.451636134
Alabama,MONTGOMERY,228138,84081,127411,7791,144057,0.368553244,0.034150383,0.631446756
Alabama,MORGAN,119786,92013,14543,9358,27773,0.768144858,0.078122652,0.231855142
Alabama,PERRY,10038,3011,6829,93,7027,0.299960151,0.009264794,0.700039849
Alabama,PICKENS,19856,10967,8408,325,8889,0.552326753,0.016367849,0.447673247
Alabama,PIKE,33155,18941,12652,289,14214,0.571286382,0.008716634,0.428713618
Alabama,RANDOLPH,22648,17029,4429,668,5619,0.751898622,0.029494878,0.248101378
Alabama,RUSSELL,58302,29036,24252,2824,29266,0.498027512,0.048437446,0.501972488
Alabama,ST. CLAIR,85864,74082,8047,1913,11782,0.862783006,0.022279419,0.137216994
Alabama,SHELBY,203530,160416,23890,11902,43114,0.78816882,0.058477866,0.21183118
Alabama,SUMTER,13341,3312,9660,53,10029,0.248257252,0.003972716,0.751742748
Alabama,TALLADEGA,81437,51883,25976,1768,29554,0.637093704,0.021710034,0.362906296
Alabama,TALLAPOOSA,41153,28408,11266,1017,12745,0.690302044,0.024712658,0.309697956
Alabama,TUSCALOOSA,200458,127351,61240,6446,73107,0.635300163,0.032156362,0.364699837
Alabama,WALKER,65923,59054,3730,1493,6869,0.895802679,0.022647634,0.104197321
Alabama,WASHINGTON,16997,11077,4224,214,5920,0.651703242,0.012590457,0.348296758
Alabama,WILCOX,11235,3073,8092,66,8162,0.273520249,0.005874499,0.726479751
Alabama,WINSTON,24130,22754,122,667,1376,0.942975549,0.027641939,0.057024451
Alaska,ALEUTIANS EAST BOROUGH,3304,495,303,398,2809,0.149818402,0.120460048,0.850181598
Alaska,ALEUTIANS WEST CENSUS AREA,5684,1578,262,623,4106,0.277621393,0.109605911,0.722378607
Alaska,ANCHORAGE MUNICIPALITY,299107,180457,16535,25690,118650,0.603319214,0.085888996,0.396680786
Alaska,BETHEL CENSUS AREA,17776,2016,142,325,15760,0.113411341,0.018283078,0.886588659
Alaska,BRISTOL BAY BOROUGH,970,518,5,69,452,0.534020619,0.071134021,0.465979381
Alaska,DENALI BOROUGH,2060,1745,13,54,315,0.847087379,0.026213592,0.152912621
Alaska,DILLINGHAM CENSUS AREA,4979,881,17,144,4098,0.176943161,0.02892147,0.823056839
Alaska,FAIRBANKS NORTH STAR BOROUGH,99705,71649,4131,7356,28056,0.718609899,0.073777644,0.281390101
Alaska,HAINES BOROUGH,2560,2037,1,39,523,0.795703125,0.015234375,0.204296875
Alaska,HOONAH-ANGOON CENSUS AREA,2128,1049,47,47,1079,0.492951128,0.022086466,0.507048872
Alaska,JUNEAU CITY AND BOROUGH,32531,21476,402,1985,11055,0.660170299,0.061018721,0.339829701
Alaska,KENAI PENINSULA BOROUGH,57221,46738,353,2124,10483,0.816798029,0.037119239,0.183201971
Alaska,KETCHIKAN GATEWAY BOROUGH,13699,8903,58,663,4796,0.649901453,0.048397693,0.350098547
Alaska,KODIAK ISLAND BOROUGH,13973,7186,62,1186,6787,0.514277535,0.084877979,0.485722465
Alaska,KUSILVAK CENSUS AREA,7914,353,28,81,7561,0.044604498,0.010235027,0.955395502
Alaska,LAKE AND PENINSULA BOROUGH,1474,310,8,32,1164,0.210312076,0.021709634,0.789687924
Alaska,MATANUSKA-SUSITNA BOROUGH,96178,77677,925,4292,18501,0.807637921,0.04462559,0.192362079
Alaska,NOME CENSUS AREA,9854,1630,72,193,8224,0.16541506,0.019585955,0.83458494
Alaska,NORTH SLOPE BOROUGH,9667,3112,53,350,6555,0.321919934,0.036205648,0.678080066
Alaska,NORTHWEST ARCTIC BOROUGH,7732,916,25,142,6816,0.118468702,0.018365235,0.881531298
Alaska,PETERSBURG BOROUGH,3221,2209,97,304,1012,0.68581186,0.094380627,0.31418814
Alaska,PRINCE OF WALES-HYDER CENSUS AREA,6376,2930,12,205,3446,0.459535759,0.032151819,0.540464241
Alaska,SITKA CITY AND BOROUGH,8943,5606,97,540,3337,0.626858996,0.060382422,0.373141004
Alaska,SKAGWAY MUNICIPALITY,999,752,0,45,247,0.752752753,0.045045045,0.247247247
Alaska,SOUTHEAST FAIRBANKS CENSUS AREA,7029,5389,76,336,1640,0.766680893,0.047801963,0.233319107
Alaska,VALDEZ-CORDOVA CENSUS AREA,9617,6742,0,425,2875,0.701050224,0.044192576,0.298949776
Alaska,WRANGELL CITY AND BOROUGH,2387,1635,5,34,752,0.684960201,0.014243821,0.315039799
Alaska,YAKUTAT CITY AND BOROUGH,643,253,9,17,390,0.393468118,0.026438569,0.606531882
Alaska,YUKON-KOYUKUK CENSUS AREA,5644,1228,17,109,4416,0.217576187,0.019312544,0.782423813
Arizona,APACHE,72124,13906,434,4547,58218,0.192806833,0.063044202,0.807193167
Arizona,COCHISE,129647,73548,4697,43960,56099,0.567294268,0.339074564,0.432705732
Arizona,COCONINO,136701,74746,1874,18916,61955,0.546784588,0.138374994,0.453215412
Arizona,GILA,53165,33852,339,9869,19313,0.636734694,0.185629644,0.363265306
Arizona,GRAHAM,37407,19337,724,11882,18070,0.516935333,0.317641083,0.483064667
Arizona,GREENLEE,9023,4262,130,4242,4761,0.472348443,0.470131885,0.527651557
Arizona,LA PAZ,20335,12179,40,5180,8156,0.598918121,0.254733219,0.401081879
Arizona,MARICOPA,4018143,2303538,198489,1209034,1714605,0.573284226,0.300893721,0.426715774
Arizona,MOHAVE,203362,159067,1995,31809,44295,0.782186446,0.156415653,0.217813554
Arizona,NAVAJO,107656,45842,499,11905,61814,0.425819276,0.110583711,0.574180724
Arizona,PIMA,998537,535965,32586,356589,462572,0.536750266,0.357111454,0.463249734
Arizona,PINAL,389772,226031,17194,113394,163741,0.579905688,0.290923925,0.420094312
Arizona,SANTA CRUZ,47073,7359,112,38965,39714,0.156331655,0.827756888,0.843668345
Arizona,YAVAPAI,215996,175206,1222,30382,40790,0.81115391,0.140660012,0.18884609
Arizona,YUMA,202987,68015,3784,124037,134972,0.335070719,0.611058836,0.664929281
Arkansas,ARKANSAS,18731,13172,4730,546,5559,0.703219262,0.029149538,0.296780738
Arkansas,ASHLEY,21229,14412,5517,1078,6817,0.678882661,0.050779594,0.321117339
Arkansas,BAXTER,41040,39130,135,798,1910,0.953460039,0.019444444,0.046539961
Arkansas,BENTON,238198,178691,3481,38068,59507,0.750178423,0.159816623,0.249821577
Arkansas,BOONE,37227,35167,131,836,2060,0.944663819,0.022456819,0.055336181
Arkansas,BRADLEY,11206,6383,3206,1564,4823,0.569605568,0.139568089,0.430394432
Arkansas,CALHOUN,5245,3828,1163,182,1417,0.729837941,0.034699714,0.270162059
Arkansas,CARROLL,27635,22558,115,3950,5077,0.816283698,0.142934684,0.183716302
Arkansas,CHICOT,11353,4487,6121,604,6866,0.395225931,0.053201797,0.604774069
Arkansas,CLARK,22751,15839,5437,984,6912,0.696189178,0.043250846,0.303810822
Arkansas,CLAY,15400,14787,56,268,613,0.960194805,0.017402597,0.039805195
Arkansas,CLEBURNE,25711,24446,133,613,1265,0.950799269,0.023841935,0.049200731
Arkansas,CLEVELAND,8510,7231,935,169,1279,0.849706228,0.019858989,0.150293772
Arkansas,COLUMBIA,24327,14391,8626,654,9936,0.591564928,0.026883709,0.408435072
Arkansas,CONWAY,21110,17270,2533,818,3840,0.818095689,0.038749408,0.181904311
Arkansas,CRAIGHEAD,101409,79398,13860,4753,22011,0.782948259,0.046869607,0.217051741
Arkansas,CRAWFORD,61748,53037,695,4073,8711,0.858926605,0.065961651,0.141073395
Arkansas,CRITTENDEN,49765,22077,25243,1120,27688,0.443625038,0.022505777,0.556374962
Arkansas,CROSS,17467,12850,3989,302,4617,0.735672983,0.017289746,0.264327017
Arkansas,DALLAS,7868,4228,3219,219,3640,0.537366548,0.027834265,0.462633452
Arkansas,DESHA,12379,5740,5922,575,6639,0.463688505,0.046449632,0.536311495
Arkansas,DREW,18740,12539,5395,540,6201,0.669103522,0.028815368,0.330896478
Arkansas,FAULKNER,119343,97161,13435,4792,22182,0.814132375,0.040153172,0.185867625
Arkansas,FRANKLIN,17866,16583,132,486,1283,0.928187619,0.027202508,0.071812381
Arkansas,FULTON,12224,11722,15,141,502,0.958933246,0.011534686,0.041066754
Arkansas,GARLAND,96954,80514,8041,5022,16440,0.830435052,0.05179776,0.169564948
Arkansas,GRANT,18054,16802,686,221,1252,0.930652487,0.012241055,0.069347513
Arkansas,GREENE,43382,41008,398,1122,2374,0.945276843,0.025863261,0.054723157
Arkansas,HEMPSTEAD,22336,12451,6631,2788,9885,0.557440903,0.124820917,0.442559097
Arkansas,HOT SPRING,33316,27644,3883,1047,5672,0.829751471,0.031426342,0.170248529
Arkansas,HOWARD,13555,8958,2955,1433,4597,0.66086315,0.105717447,0.33913685
Arkansas,INDEPENDENCE,36952,32989,740,2213,3963,0.89275276,0.059888504,0.10724724
Arkansas,IZARD,13480,12912,162,242,568,0.957863501,0.017952522,0.042136499
Arkansas,JACKSON,17597,13652,3025,494,3945,0.775814059,0.028072967,0.224185941
Arkansas,JEFFERSON,73548,29808,40807,1375,43740,0.405286344,0.018695274,0.594713656
Arkansas,JOHNSON,25930,21131,388,3470,4799,0.814924798,0.133821828,0.185075202
Arkansas,LAFAYETTE,7270,4339,2777,90,2931,0.596836314,0.012379642,0.403163686
Arkansas,LAWRENCE,17029,16370,153,203,659,0.96130131,0.011920841,0.03869869
Arkansas,LEE,9966,4091,5622,225,5875,0.410495685,0.022576761,0.589504315
Arkansas,LINCOLN,14062,9141,4311,494,4921,0.65004978,0.035130138,0.34995022
Arkansas,LITTLE RIVER,12720,9333,2632,397,3387,0.733726415,0.031210692,0.266273585
Arkansas,LOGAN,22001,20156,407,561,1845,0.916140175,0.025498841,0.083859825
Arkansas,LONOKE,70691,61524,4300,2722,9167,0.870322955,0.038505609,0.129677045
Arkansas,MADISON,15702,14273,3,824,1429,0.908992485,0.052477391,0.091007515
Arkansas,MARION,16458,15597,42,369,861,0.947685016,0.022420707,0.052314984
Arkansas,MILLER,43652,30467,10794,1297,13185,0.697951984,0.02971227,0.302048016
Arkansas,MISSISSIPPI,44864,26759,15487,1720,18105,0.59644704,0.038338088,0.40355296
Arkansas,MONROE,7713,4252,3138,163,3461,0.551277065,0.021133152,0.448722935
Arkansas,MONTGOMERY,9197,8451,57,339,746,0.918886593,0.036859846,0.081113407
Arkansas,NEVADA,8793,5639,2692,282,3154,0.641305584,0.032070966,0.358694416
Arkansas,NEWTON,8052,7600,0,85,452,0.943864878,0.010556384,0.056135122
Arkansas,OUACHITA,25044,13950,10043,491,11094,0.557019645,0.019605494,0.442980355
Arkansas,PERRY,10300,9547,214,282,753,0.926893204,0.027378641,0.073106796
Arkansas,PHILLIPS,20391,7178,12538,321,13213,0.352018047,0.015742239,0.647981953
Arkansas,PIKE,11087,9727,348,726,1360,0.877333814,0.065482096,0.122666186
Arkansas,POINSETT,24210,21279,1992,630,2931,0.878934325,0.026022305,0.121065675
Arkansas,POLK,20364,18070,42,1277,2294,0.887350226,0.062708702,0.112649774
Arkansas,POPE,62830,53712,1839,4919,9118,0.854878243,0.078290625,0.145121757
Arkansas,PRAIRIE,8402,7175,1035,93,1227,0.853963342,0.011068793,0.146036658
Arkansas,PULASKI,390463,211679,138384,23080,178784,0.542123069,0.059109314,0.457876931
Arkansas,RANDOLPH,17695,16894,122,317,801,0.954732975,0.017914665,0.045267025
Arkansas,ST. FRANCIS,27345,11273,14136,1200,16072,0.412250869,0.043883708,0.587749131
Arkansas,SALINE,113833,99189,6638,4631,14644,0.871355407,0.040682403,0.128644593
Arkansas,SCOTT,10870,9174,18,814,1696,0.843974241,0.074885005,0.156025759
Arkansas,SEARCY,7965,7492,22,155,473,0.940615191,0.019460138,0.059384809
Arkansas,SEBASTIAN,127273,90829,7849,16772,36444,0.713654899,0.131779718,0.286345101
Arkansas,SEVIER,17268,10239,812,5558,7029,0.592946491,0.321867037,0.407053509
Arkansas,SHARP,17055,16040,60,334,1015,0.940486661,0.0195837,0.059513339
Arkansas,STONE,12512,11922,5,213,590,0.952845269,0.017023657,0.047154731
Arkansas,UNION,40633,24984,13323,1466,15649,0.614869687,0.036079049,0.385130313
Arkansas,VAN BUREN,17002,15922,90,497,1080,0.936478061,0.029231855,0.063521939
Arkansas,WASHINGTON,216432,156896,7020,34732,59536,0.724920529,0.160475346,0.275079471
Arkansas,WHITE,78660,69701,3521,3209,8959,0.886104755,0.04079583,0.113895245
Arkansas,WOODRUFF,6983,4854,1869,32,2129,0.695116712,0.004582558,0.304883288
Arkansas,YELL,21835,16594,441,4146,5241,0.759972521,0.189878635,0.240027479
California,ALAMEDA,1584983,522707,179400,358168,1062276,0.329787133,0.225975925,0.670212867
California,ALPINE,1131,725,11,108,406,0.641025641,0.095490716,0.358974359
California,AMADOR,36995,29496,822,4784,7499,0.797296932,0.129314772,0.202703068
California,BUTTE,222564,164214,3017,33800,58350,0.73782822,0.151866429,0.26217178
California,CALAVERAS,44767,36951,259,4967,7816,0.825407108,0.110952264,0.174592892
California,COLUSA,21396,8017,131,12277,13379,0.374696205,0.573798841,0.625303795
California,CONTRA COSTA,1096068,503815,94046,273350,592253,0.4596567,0.249391461,0.5403433
California,DEL NORTE,27788,17582,787,5300,10206,0.632719159,0.190729811,0.367280841
California,EL DORADO,182093,143804,1564,22719,38289,0.789728326,0.124765916,0.210271674
California,FRESNO,956749,298219,45409,494077,658530,0.311700352,0.516412351,0.688299648
California,GLENN,28029,15065,241,11094,12964,0.53747904,0.395804345,0.46252096
California,HUMBOLDT,135034,102235,1537,14289,32799,0.757105618,0.105817794,0.242894382
California,IMPERIAL,178206,22437,4530,145855,155769,0.125904852,0.818462902,0.874095148
California,INYO,18373,11906,192,3778,6467,0.648016111,0.205627823,0.351983889
California,KERN,865736,317048,46058,441496,548688,0.366217877,0.509966087,0.633782123
California,KINGS,150998,51467,8883,79452,99531,0.340845574,0.526179155,0.659154426
California,LAKE,64158,46554,1357,11899,17604,0.725614888,0.185464011,0.274385112
California,LASSEN,32645,21526,2758,5986,11119,0.659396539,0.183366519,0.340603461
California,LOS ANGELES,10038388,2703547,801739,4842319,7334841,0.269320831,0.482380139,0.730679169
California,MADERA,153187,55593,4941,85245,97594,0.362909385,0.556476725,0.637090615
California,MARIN,258349,185975,6181,40875,72374,0.71985957,0.158216211,0.28014043
California,MARIPOSA,17789,14539,192,1803,3250,0.817302828,0.10135477,0.182697172
California,MENDOCINO,87544,58376,538,20693,29168,0.666818971,0.236372567,0.333181029
California,MERCED,263885,78992,8353,150222,184893,0.299342517,0.569270705,0.700657483
California,MODOC,9184,7149,47,1345,2035,0.77841899,0.146450348,0.22158101
California,MONO,14146,9405,59,3862,4741,0.664852255,0.273010038,0.335147745
California,MONTEREY,428441,135021,10981,243894,293420,0.315144909,0.569259245,0.684855091
California,NAPA,140295,76016,2844,46689,64279,0.541829716,0.332791618,0.458170284
California,NEVADA,98570,84497,462,8902,14073,0.857228366,0.090311454,0.142771634
California,ORANGE,3116069,1320050,48196,1064499,1796019,0.423626691,0.341615991,0.576373309
California,PLACER,366280,272814,4978,49158,93466,0.744823632,0.134208802,0.255176368
California,PLUMAS,18966,15993,124,1574,2973,0.843245808,0.082990615,0.156754192
California,RIVERSIDE,2298032,867646,136414,1079778,1430386,0.377560452,0.469870742,0.622439548
California,SACRAMENTO,1465832,686399,140253,326742,779433,0.468265804,0.22290549,0.531734196
California,SAN BENITO,57557,21092,406,33307,36465,0.366454124,0.578678527,0.633545876
California,SAN BERNARDINO,2094769,652920,169547,1070262,1441849,0.311690692,0.510921252,0.688309308
California,SAN DIEGO,3223096,1515316,153024,1060995,1707780,0.470142993,0.329185044,0.529857007
California,SAN FRANCISCO,840763,346732,44879,128619,494031,0.412401592,0.152978901,0.587598408
California,SAN JOAQUIN,708554,243086,47598,284168,465468,0.343073358,0.401053413,0.656926642
California,SAN LUIS OBISPO,276517,192918,5324,60181,83599,0.697671391,0.217639422,0.302328609
California,SAN MATEO,748731,305166,18471,189389,443565,0.407577621,0.252946652,0.592422379
California,SANTA BARBARA,435850,201998,7421,192304,233852,0.463457612,0.441216015,0.536542388
California,SANTA CLARA,1868149,627328,44980,497074,1240821,0.335801909,0.266078348,0.664198091
California,SANTA CRUZ,269278,157042,2335,88602,112236,0.583196548,0.329035421,0.416803452
California,SHASTA,178942,145248,1752,16384,33694,0.811704351,0.091560394,0.188295649
California,SIERRA,3021,2658,3,268,363,0.879841112,0.088712347,0.120158888
California,SISKIYOU,43895,34244,614,5044,9651,0.780134412,0.114910582,0.219865588
California,SOLANO,425753,169259,57650,107592,256494,0.397552102,0.252709905,0.602447898
California,SONOMA,495078,320545,6762,127774,174533,0.647463632,0.258088624,0.352536368
California,STANISLAUS,527367,235880,12904,230087,291487,0.44727865,0.43629389,0.55272135
California,SUTTER,95247,46108,1841,28261,49139,0.484088738,0.296712757,0.515911262
California,TEHAMA,63152,44291,291,14813,18861,0.701339625,0.234561059,0.298660375
California,TRINITY,13373,11096,151,955,2277,0.829731549,0.071412548,0.170268451
California,TULARE,454033,139581,6021,283533,314452,0.307424791,0.624476635,0.692575209
California,TUOLUMNE,54079,43995,970,6139,10084,0.813532055,0.113519111,0.186467945
California,VENTURA,840833,395199,13462,349799,445634,0.470008908,0.416014833,0.529991092
California,YOLO,207320,100100,4708,64526,107220,0.482828478,0.311238665,0.517171522
California,YUBA,73437,41676,2377,19611,31761,0.567506843,0.267045222,0.432493157
Colorado,ADAMS,471206,245330,14234,182114,225876,0.520642776,0.386484892,0.479357224
Colorado,ALAMOSA,16269,8020,262,7427,8249,0.492962075,0.456512386,0.507037925
Colorado,ARAPAHOE,608310,378452,60356,113506,229858,0.622136739,0.186592362,0.377863261
Colorado,ARCHULETA,12174,9402,77,2251,2772,0.772301626,0.184902251,0.227698374
Colorado,BACA,3701,3203,41,362,498,0.865441772,0.097811402,0.134558228
Colorado,BENT,5895,3292,545,1844,2603,0.558439355,0.312807464,0.441560645
Colorado,BOULDER,310032,243252,2558,42487,66780,0.78460288,0.137040693,0.21539712
Colorado,BROOMFIELD,60699,47441,563,7225,13258,0.78157795,0.119029968,0.21842205
Colorado,CHAFFEE,18309,15637,367,1858,2672,0.854060844,0.101480146,0.145939156
Colorado,CHEYENNE,2002,1691,6,258,311,0.844655345,0.128871129,0.155344655
Colorado,CLEAR CREEK,9136,8284,120,507,852,0.906742557,0.055494746,0.093257443
Colorado,CONEJOS,8249,3570,5,4484,4679,0.432779731,0.54358104,0.567220269
Colorado,COSTILLA,3581,1148,0,2306,2433,0.320580843,0.643954203,0.679419157
Colorado,CROWLEY,5551,3394,292,1674,2157,0.611421366,0.301567285,0.388578634
Colorado,CUSTER,4303,3940,131,116,363,0.915640251,0.026957936,0.084359749
Colorado,DELTA,30214,24796,290,4448,5418,0.820679155,0.147216522,0.179320845
Colorado,DENVER,649654,344954,60955,201019,304700,0.530981107,0.309424709,0.469018893
Colorado,DOLORES,1862,1688,0,110,174,0.906552095,0.059076262,0.093447905
Colorado,DOUGLAS,306974,257929,3098,25007,49045,0.840230769,0.081462925,0.159769231
Colorado,EAGLE,52576,35237,313,15767,17339,0.670210743,0.299889684,0.329789257
Colorado,ELBERT,23855,21455,126,1468,2400,0.899392161,0.061538462,0.100607839
Colorado,EL PASO,655024,462443,37426,104686,192581,0.705993979,0.159820098,0.294006021
Colorado,FREMONT,46809,36525,2388,6080,10284,0.780298661,0.129889551,0.219701339
Colorado,GARFIELD,57076,39222,244,16044,17854,0.687189011,0.281098886,0.312810989
Colorado,GILPIN,5605,4945,29,493,660,0.882247993,0.087957181,0.117752007
Colorado,GRAND,14411,12679,203,889,1732,0.879814031,0.061688988,0.120185969
Colorado,GUNNISON,15651,13756,69,1404,1895,0.878921475,0.089706728,0.121078525
Colorado,HINSDALE,874,849,0,11,25,0.971395881,0.012585812,0.028604119
Colorado,HUERFANO,6502,4172,20,2252,2330,0.641648723,0.346354968,0.358351277
Colorado,JACKSON,1335,1118,1,206,217,0.837453184,0.154307116,0.162546816
Colorado,JEFFERSON,552344,435423,5535,83142,116921,0.788318512,0.150525759,0.211681488
Colorado,KIOWA,1463,1273,12,105,190,0.87012987,0.071770335,0.12987013
Colorado,KIT CARSON,7980,6055,334,1510,1925,0.75877193,0.189223058,0.24122807
Colorado,LAKE,7362,4388,5,2774,2974,0.596033686,0.376799783,0.403966314
Colorado,LA PLATA,53182,42314,187,6625,10868,0.795645143,0.124572224,0.204354857
Colorado,LARIMER,318227,265802,2616,34843,52425,0.835259107,0.109491024,0.164740893
Colorado,LAS ANIMAS,14503,7657,249,6146,6846,0.527959732,0.423774392,0.472040268
Colorado,LINCOLN,5478,3783,611,931,1695,0.690580504,0.169952537,0.309419496
Colorado,LOGAN,21928,17215,317,3375,4713,0.785069318,0.153912806,0.214930682
Colorado,MESA,147834,121445,1005,20521,26389,0.821495732,0.138811099,0.178504268
Colorado,MINERAL,733,644,6,79,89,0.878581173,0.107776262,0.121418827
Colorado,MOFFAT,13117,10777,64,1873,2340,0.82160555,0.142791797,0.17839445
Colorado,MONTEZUMA,25700,18901,23,3122,6799,0.735447471,0.121478599,0.264552529
Colorado,MONTROSE,40815,31190,214,8243,9625,0.764179836,0.201960064,0.235820164
Colorado,MORGAN,28359,17170,710,9913,11189,0.605451532,0.349553933,0.394548468
Colorado,OTERO,18572,10237,59,7647,8335,0.551206117,0.411748869,0.448793883
Colorado,OURAY,4580,4256,0,220,324,0.929257642,0.048034934,0.070742358
Colorado,PARK,16189,14635,0,916,1554,0.904008895,0.05658163,0.095991105
Colorado,PHILLIPS,4371,3430,5,792,941,0.784717456,0.181194235,0.215282544
Colorado,PITKIN,17420,15034,217,1684,2386,0.863030999,0.096670494,0.136969001
Colorado,PROWERS,12235,7531,54,4398,4704,0.615529219,0.359460564,0.384470781
Colorado,PUEBLO,161519,85629,2826,68312,75890,0.530148156,0.422934763,0.469851844
Colorado,RIO BLANCO,6712,5676,31,713,1036,0.845649583,0.106227652,0.154350417
Colorado,RIO GRANDE,11745,6233,53,5187,5512,0.530693912,0.441634738,0.469306088
Colorado,ROUTT,23606,21283,97,1612,2323,0.901592815,0.068287723,0.098407185
Colorado,SAGUACHE,6238,3551,23,2427,2687,0.569252966,0.389067009,0.430747034
Colorado,SAN JUAN,606,465,0,117,141,0.767326733,0.193069307,0.232673267
Colorado,SAN MIGUEL,7676,6705,18,729,971,0.873501824,0.094971339,0.126498176
Colorado,SEDGWICK,2365,1895,29,321,470,0.801268499,0.135729387,0.198731501
Colorado,SUMMIT,28940,23454,334,4266,5486,0.810435384,0.147408431,0.189564616
Colorado,TELLER,23340,20905,251,1414,2435,0.895672665,0.060582691,0.104327335
Colorado,WASHINGTON,4795,4233,28,445,562,0.882794578,0.092805005,0.117205422
Colorado,WELD,270948,181384,2603,77680,89564,0.669442107,0.286697078,0.330557893
Colorado,YUMA,10185,7827,41,2201,2358,0.768483063,0.216102111,0.231516937
Connecticut,FAIRFIELD,939983,602311,97643,171720,337672,0.640767971,0.182684155,0.359232029
Connecticut,HARTFORD,896943,573000,112624,148744,323943,0.638836582,0.165834395,0.361163418
Connecticut,LITCHFIELD,186304,167998,2517,9649,18306,0.90174124,0.051791695,0.09825876
Connecticut,MIDDLESEX,165165,140206,7804,9183,24959,0.848884449,0.055598947,0.151115551
Connecticut,NEW HAVEN,862224,563977,105051,141282,298247,0.654095687,0.163857652,0.345904313
Connecticut,NEW LONDON,273185,209685,14098,26167,63500,0.767556784,0.095784908,0.232443216
Connecticut,TOLLAND,151948,131114,4237,7387,20834,0.862887304,0.048615316,0.137112696
Connecticut,WINDHAM,117470,98828,2232,12376,18642,0.841304163,0.105354559,0.158695837
Delaware,KENT,169509,107946,39709,11096,61563,0.636815744,0.065459651,0.363184256
Delaware,NEW CASTLE,549643,328838,129600,50568,220805,0.598275608,0.092001536,0.401724392
Delaware,SUSSEX,207302,155138,25749,19042,52164,0.748367117,0.091856326,0.251632883
District of Columbia,DISTRICT OF COLUMBIA,647484,230489,310678,65803,416995,0.355976364,0.101628766,0.644023636
Florida,ALACHUA,254218,159436,49724,22548,94782,0.627162514,0.088695529,0.372837486
Florida,BAKER,27135,22259,3928,638,4876,0.820305878,0.023512069,0.179694122
Florida,BAY,175353,136667,18486,9629,38686,0.779382161,0.054912092,0.220617839
Florida,BRADFORD,27223,20263,5407,1030,6960,0.744333835,0.037835654,0.255666165
Florida,BREVARD,553591,421151,54704,50179,132440,0.760762007,0.090642731,0.239237993
Florida,BROWARD,1843152,744254,495666,496991,1098898,0.403794153,0.269641896,0.596205847
Florida,CALHOUN,14615,11259,1944,815,3356,0.770372905,0.055764625,0.229627095
Florida,CHARLOTTE,165783,140576,9123,10807,25207,0.847951841,0.065187625,0.152048159
Florida,CITRUS,139654,124112,3884,7068,15542,0.888710671,0.050610795,0.111289329
Florida,CLAY,197417,148325,18913,17464,49092,0.751328406,0.088462493,0.248671594
Florida,COLLIER,341091,220021,22587,90374,121070,0.645050734,0.264955686,0.354949266
Florida,COLUMBIA,67806,49743,12031,3649,18063,0.733607645,0.053815297,0.266392355
Florida,DESOTO,34957,19292,4506,10672,15665,0.551878022,0.305289355,0.448121978
Florida,DIXIE,16091,13735,1383,591,2356,0.853582748,0.036728606,0.146417252
Florida,DUVAL,890673,491717,257936,74775,398956,0.552073544,0.08395337,0.447926456
Florida,ESCAMBIA,306327,200923,65509,16170,105404,0.655910187,0.052786728,0.344089813
Florida,FLAGLER,100783,75681,10827,9671,25102,0.750930216,0.095958644,0.249069784
Florida,FRANKLIN,11628,9142,1593,577,2486,0.78620571,0.049621603,0.21379429
Florida,GADSDEN,46424,15596,25299,4663,30828,0.335946924,0.100443736,0.664053076
Florida,GILCHRIST,16992,14848,983,864,2144,0.873822976,0.050847458,0.126177024
Florida,GLADES,13272,8084,1653,2817,5188,0.609101869,0.212251356,0.390898131
Florida,GULF,15785,11642,2808,761,4143,0.737535635,0.048210326,0.262464365
Florida,HAMILTON,14395,7908,4777,1322,6487,0.549357416,0.091837444,0.450642584
Florida,HARDEE,27468,13014,2107,11801,14454,0.47378768,0.429627203,0.52621232
Florida,HENDRY,38363,13066,4475,19382,25297,0.340588588,0.50522639,0.659411412
Florida,HERNANDO,174809,140686,8835,19813,34123,0.80479838,0.113340846,0.19520162
Florida,HIGHLANDS,98328,68044,9216,17963,30284,0.692010414,0.182684485,0.307989586
Florida,HILLSBOROUGH,1302884,674967,203726,339540,627917,0.518056097,0.26060647,0.481943903
Florida,HOLMES,19635,17145,1353,530,2490,0.873185638,0.026992615,0.126814362
Florida,INDIAN RIVER,142866,109224,12751,16821,33642,0.7645206,0.1177397,0.2354794
Florida,JACKSON,48900,32095,13012,2301,16805,0.656339468,0.047055215,0.343660532
Florida,JEFFERSON,14198,8223,5089,581,5975,0.57916608,0.040921257,0.42083392
Florida,LAFAYETTE,8801,6111,1558,1058,2690,0.694352914,0.120213612,0.305647086
Florida,LAKE,310561,224450,29462,41936,86111,0.72272436,0.135033053,0.27727564
Florida,LEE,663675,461425,54687,127815,202250,0.695257468,0.192586733,0.304742532
Florida,LEON,282940,163155,86917,17151,119785,0.576641691,0.060617092,0.423358309
Florida,LEVY,39821,31902,3626,3180,7919,0.801135079,0.079857362,0.198864921
Florida,LIBERTY,8295,6098,1348,598,2197,0.735141652,0.072091621,0.264858348
Florida,MADISON,18729,10202,7208,921,8527,0.544716749,0.049175076,0.455283251
Florida,MANATEE,343729,248268,30938,53393,95461,0.722278306,0.15533458,0.277721694
Florida,MARION,336811,243982,41910,39313,92829,0.724388455,0.116721247,0.275611545
Florida,MARTIN,151586,120303,8181,19491,31283,0.793628699,0.128580476,0.206371301
Florida,MIAMI-DADE,2639042,398700,444590,1731733,2240342,0.15107755,0.65619759,0.84892245
Florida,MONROE,75901,52390,4625,16725,23511,0.690241235,0.220352828,0.309758765
Florida,NASSAU,75880,66176,4854,2819,9704,0.872113864,0.037150764,0.127886136
Florida,OKALOOSA,192237,144488,16978,15655,47749,0.751613893,0.081435936,0.248386107
Florida,OKEECHOBEE,39255,25090,3382,9799,14165,0.639154248,0.249624252,0.360845752
Florida,ORANGE,1229039,534859,244321,352927,694180,0.435184726,0.287156876,0.564815274
Florida,OSCEOLA,300870,110172,29087,147382,190698,0.366178084,0.48985276,0.633821916
Florida,PALM BEACH,1378806,794678,241488,280872,584128,0.576352293,0.203706685,0.423647707
Florida,PASCO,479288,372551,22632,62794,106737,0.777300913,0.131015173,0.222699087
Florida,PINELLAS,931477,702808,94385,81072,228669,0.754509236,0.087035965,0.245490764
Florida,POLK,626676,391735,91538,120481,234941,0.625099733,0.192254052,0.374900267
Florida,PUTNAM,72696,52241,11756,6861,20455,0.718622758,0.094379333,0.281377242
Florida,ST. JOHNS,210495,177340,11001,12435,33155,0.84249032,0.059075037,0.15750968
Florida,ST. LUCIE,288006,172109,54946,49921,115897,0.597588245,0.173333194,0.402411755
Florida,SANTA ROSA,161021,133735,9046,8092,27286,0.830543842,0.050254315,0.169456158
Florida,SARASOTA,392038,328567,17708,33485,63471,0.838099878,0.085412639,0.161900122
Florida,SEMINOLE,437346,279840,47429,82037,157506,0.639859516,0.187579171,0.360140484
Florida,SUMTER,108501,91246,8782,6237,17255,0.840969208,0.057483341,0.159030792
Florida,SUWANNEE,43595,32890,5749,3859,10705,0.754444317,0.088519326,0.245555683
Florida,TAYLOR,22685,16398,4822,845,6287,0.722856513,0.037249284,0.277143487
Florida,UNION,15191,10663,3255,807,4528,0.701928774,0.05312356,0.298071226
Florida,VOLUSIA,503719,372365,51650,60757,131354,0.739231595,0.120616852,0.260768405
Florida,WAKULLA,31128,24522,4770,1146,6606,0.787779491,0.036815729,0.212220509
Florida,WALTON,59487,50140,3062,3486,9347,0.842873233,0.058601039,0.157126767
Florida,WASHINGTON,24629,19052,3720,843,5577,0.773559625,0.034227943,0.226440375
Georgia,APPLING,18417,12825,3479,1723,5592,0.696367487,0.093554868,0.303632513
Georgia,ATKINSON,8294,4700,1424,2010,3594,0.566674705,0.242343863,0.433325295
Georgia,BACON,11222,8361,1678,879,2861,0.745054358,0.078328284,0.254945642
Georgia,BAKER,3292,1630,1565,64,1662,0.495139733,0.019441069,0.504860267
Georgia,BALDWIN,45795,24524,18988,972,21271,0.535516978,0.021225025,0.464483022
Georgia,BANKS,18336,16204,485,1158,2132,0.883726003,0.06315445,0.116273997
Georgia,BARROW,72012,53113,8120,6817,18899,0.737557629,0.094664778,0.262442371
Georgia,BARTOW,101336,79956,10933,8046,21380,0.78901871,0.079399226,0.21098129
Georgia,BEN HILL,17477,9871,6237,1081,7606,0.564799451,0.061852721,0.435200549
Georgia,BERRIEN,19019,15608,2080,930,3411,0.820653031,0.04889847,0.179346969
Georgia,BIBB,154816,62975,81847,4853,91841,0.406773202,0.031346889,0.593226798
Georgia,BLECKLEY,12746,8856,3334,339,3890,0.694806214,0.026596579,0.305193786
Georgia,BRANTLEY,18452,17088,570,390,1364,0.926078474,0.02113592,0.073921526
Georgia,BROOKS,15637,9033,5423,863,6604,0.577668351,0.055189614,0.422331649
Georgia,BRYAN,33151,24757,4917,2038,8394,0.746794968,0.061476275,0.253205032
Georgia,BULLOCH,72386,46311,20468,2630,26075,0.63977841,0.036332993,0.36022159
Georgia,BURKE,23007,10788,11405,680,12219,0.468900769,0.029556222,0.531099231
Georgia,BUTTS,23445,15736,6555,701,7709,0.671187887,0.029899765,0.328812113
Georgia,CALHOUN,6489,2138,3954,299,4351,0.32948066,0.046077978,0.67051934
Georgia,CAMDEN,51445,36278,9637,3018,15167,0.70518029,0.058664593,0.29481971
Georgia,CANDLER,11031,6897,2687,1239,4134,0.625237966,0.112319826,0.374762034
Georgia,CARROLL,112595,81048,20486,7262,31547,0.71981882,0.064496647,0.28018118
Georgia,CATOOSA,65375,59875,1744,1772,5500,0.915869981,0.027105163,0.084130019
Georgia,CHARLTON,13130,8164,3289,1489,4966,0.621782178,0.113404417,0.378217822
Georgia,CHATHAM,279290,139088,109399,16615,140202,0.498005657,0.059490136,0.501994343
Georgia,CHATTAHOOCHEE,11914,7172,1764,1781,4742,0.601980863,0.149487997,0.398019137
Georgia,CHATTOOGA,25241,20857,2708,1170,4384,0.82631433,0.046353156,0.17368567
Georgia,CHEROKEE,225944,181206,13720,22432,44738,0.801995185,0.099281238,0.198004815
Georgia,CLARKE,120905,68211,31996,12770,52694,0.564170216,0.105620115,0.435829784
Georgia,CLAY,3104,982,1895,152,2122,0.316365979,0.048969072,0.683634021
Georgia,CLAYTON,267234,36488,175801,35111,230746,0.136539512,0.131386725,0.863460488
Georgia,CLINCH,6791,4494,1794,285,2297,0.661758209,0.04196731,0.338241791
Georgia,COBB,719133,391063,184546,90536,328070,0.543797879,0.125896044,0.456202121
Georgia,COFFEE,43003,25517,12107,4672,17486,0.593377206,0.108643583,0.406622794
Georgia,COLQUITT,46024,26389,10579,8316,19635,0.573374761,0.180688337,0.426625239
Georgia,COLUMBIA,136204,96778,22057,8131,39426,0.710537135,0.059697219,0.289462865
Georgia,COOK,17033,11051,4711,1000,5982,0.648799389,0.058709564,0.351200611
Georgia,COWETA,133416,95942,23454,8955,37474,0.719119146,0.067120885,0.280880854
Georgia,CRAWFORD,12539,9214,2876,65,3325,0.734827339,0.005183826,0.265172661
Georgia,CRISP,23314,11898,10063,760,11416,0.510337136,0.032598439,0.489662864
Georgia,DADE,16445,15463,197,350,982,0.940285801,0.021283065,0.059714199
Georgia,DAWSON,22673,21084,126,891,1589,0.929916641,0.039297843,0.070083359
Georgia,DECATUR,27378,14089,11373,1508,13289,0.514610271,0.055080722,0.485389729
Georgia,DEKALB,716331,212598,379694,64968,503733,0.296787379,0.090695502,0.703212621
Georgia,DODGE,21180,13796,6027,745,7384,0.651369216,0.035174693,0.348630784
Georgia,DOOLY,14293,6128,7027,1027,8165,0.428741342,0.071853355,0.571258658
Georgia,DOUGHERTY,93310,25627,62966,2374,67683,0.274643661,0.025442075,0.725356339
Georgia,DOUGLAS,136520,62670,56227,12017,73850,0.459053619,0.088023733,0.540946381
Georgia,EARLY,10579,4975,5318,214,5604,0.470271292,0.020228755,0.529728708
Georgia,ECHOLS,4048,2787,82,1036,1261,0.688488142,0.255928854,0.311511858
Georgia,EFFINGHAM,54630,43667,7361,1896,10963,0.799322716,0.034706205,0.200677284
Georgia,ELBERT,19537,12471,5924,1033,7066,0.638327276,0.052874034,0.361672724
Georgia,EMANUEL,22731,13637,7699,1016,9094,0.599929612,0.04469667,0.400070388
Georgia,EVANS,10814,6125,3262,1286,4689,0.566395413,0.118919919,0.433604587
Georgia,FANNIN,23742,22653,64,465,1089,0.954131918,0.019585545,0.045868082
Georgia,FAYETTE,108655,71294,22424,7563,37361,0.6561502,0.069605633,0.3438498
Georgia,FLOYD,96169,69449,14092,9731,26720,0.722155788,0.101186453,0.277844212
Georgia,FORSYTH,196236,151783,5523,18793,44453,0.773471738,0.095767341,0.226528262
Georgia,FRANKLIN,22110,18647,2117,934,3463,0.843374039,0.042243329,0.156625961
Georgia,FULTON,983903,397535,428481,75002,586368,0.404038813,0.076229059,0.595961187
Georgia,GILMER,28673,24735,199,3066,3938,0.86265825,0.106929864,0.13734175
Georgia,GLASCOCK,3087,2700,214,48,387,0.874635569,0.015549077,0.125364431
Georgia,GLYNN,81743,52402,20924,5395,29341,0.64105795,0.065999535,0.35894205
Georgia,GORDON,55889,43845,2332,8287,12044,0.784501422,0.148276047,0.215498578
Georgia,GRADY,25243,14919,7122,2654,10324,0.591015331,0.105138058,0.408984669
Georgia,GREENE,16331,9134,5935,1012,7197,0.55930439,0.061968036,0.44069561
Georgia,GWINNETT,859234,354281,212639,174843,504953,0.412321905,0.203487059,0.587678095
Georgia,HABERSHAM,43527,33959,1661,5884,9568,0.780182416,0.135180463,0.219817584
Georgia,HALL,187916,117093,13811,50913,70823,0.623113519,0.270934886,0.376886481
Georgia,HANCOCK,8881,2130,6503,173,6751,0.239837856,0.019479788,0.760162144
Georgia,HARALSON,28565,25981,1402,377,2584,0.909539646,0.01319797,0.090460354
Georgia,HARRIS,32776,25252,5314,1035,7524,0.770441787,0.031577984,0.229558213
Georgia,HART,25498,19265,5056,919,6233,0.755549455,0.036042043,0.244450545
Georgia,HEARD,11617,9863,1142,271,1754,0.849014375,0.023327882,0.150985625
Georgia,HENRY,211512,104644,81182,13224,106868,0.494742615,0.062521275,0.505257385
Georgia,HOUSTON,147570,86268,42975,9563,61302,0.584590364,0.064803144,0.415409636
Georgia,IRWIN,9408,6420,2673,95,2988,0.682397959,0.010097789,0.317602041
Georgia,JACKSON,61420,50768,4343,4126,10652,0.826571149,0.067176815,0.173428851
Georgia,JASPER,13593,9855,2863,541,3738,0.725005518,0.039799897,0.274994482
Georgia,JEFF DAVIS,14990,10813,2439,1657,4177,0.721347565,0.11054036,0.278652435
Georgia,JEFFERSON,16374,6852,8886,543,9522,0.418468303,0.033162331,0.581531697
Georgia,JENKINS,8922,5029,2981,694,3893,0.563662856,0.07778525,0.436337144
Georgia,JOHNSON,9794,6092,3384,39,3702,0.622013478,0.00398203,0.377986522
Georgia,JONES,28738,20756,7362,168,7982,0.722249287,0.005845918,0.277750713
Georgia,LAMAR,18114,11709,5523,404,6405,0.646406095,0.022303191,0.353593905
Georgia,LANIER,10403,7087,2575,550,3316,0.681245794,0.052869365,0.318754206
Georgia,LAURENS,47886,28442,17259,1199,19444,0.593952303,0.025038633,0.406047697
Georgia,LEE,28946,21277,5740,708,7669,0.735058385,0.024459338,0.264941615
Georgia,LIBERTY,64427,27348,25346,7514,37079,0.42448042,0.116628122,0.57551958
Georgia,LINCOLN,7720,5061,2514,55,2659,0.655569948,0.007124352,0.344430052
Georgia,LONG,16588,9823,3846,1944,6765,0.592175066,0.117193152,0.407824934
Georgia,LOWNDES,113203,61980,40430,6061,51223,0.547511992,0.053540984,0.452488008
Georgia,LUMPKIN,30921,28122,612,1428,2799,0.909478995,0.046182206,0.090521005
Georgia,MCDUFFIE,21582,11835,8983,565,9747,0.548373645,0.026179223,0.451626355
Georgia,MCINTOSH,14007,8582,4871,239,5425,0.612693653,0.017062897,0.387306347
Georgia,MACON,14045,4771,8316,561,9274,0.339693841,0.03994304,0.660306159
Georgia,MADISON,28232,23698,2525,1272,4534,0.839402097,0.045055256,0.160597903
Georgia,MARION,8739,5123,2756,633,3616,0.58622268,0.072433917,0.41377732
Georgia,MERIWETHER,21297,12077,8156,432,9220,0.567075175,0.020284547,0.432924825
Georgia,MILLER,5936,4076,1844,6,1860,0.686657682,0.001010782,0.313342318
Georgia,MITCHELL,22982,10666,10857,1001,12316,0.464102341,0.043555826,0.535897659
Georgia,MONROE,26915,19420,6435,605,7495,0.721530745,0.022478172,0.278469255
Georgia,MONTGOMERY,8968,5942,2360,538,3026,0.662578055,0.059991079,0.337421945
Georgia,MORGAN,17900,12842,4143,524,5058,0.717430168,0.029273743,0.282569832
Georgia,MURRAY,39401,32933,354,5493,6468,0.83584173,0.139412705,0.16415827
Georgia,MUSCOGEE,200285,85016,88432,14552,115269,0.424475123,0.072656465,0.575524877
Georgia,NEWTON,102645,51778,42382,5023,50867,0.504437625,0.048935652,0.495562375
Georgia,OCONEE,34400,29323,1811,1605,5077,0.852412791,0.046656977,0.147587209
Georgia,OGLETHORPE,14688,11206,2346,578,3482,0.76293573,0.039351852,0.23706427
Georgia,PAULDING,147400,109350,25511,8083,38050,0.741858887,0.054837178,0.258141113
Georgia,PEACH,27086,12315,12319,1950,14771,0.454662925,0.071992911,0.545337075
Georgia,PICKENS,29740,27803,430,914,1937,0.934868863,0.03073302,0.065131137
Georgia,PIERCE,18934,15864,1481,970,3070,0.837857822,0.05123059,0.162142178
Georgia,PIKE,17812,15354,1989,250,2458,0.862003144,0.014035482,0.137996856
Georgia,POLK,41215,29648,5473,5251,11567,0.719349751,0.127405071,0.280650249
Georgia,PULASKI,11590,6851,3891,541,4739,0.591113028,0.046678171,0.408886972
Georgia,PUTNAM,21247,13871,5650,1411,7376,0.652845108,0.066409375,0.347154892
Georgia,QUITMAN,2326,1154,1145,0,1172,0.496130696,0,0.503869304
Georgia,RABUN,16266,14140,295,1318,2126,0.869297922,0.081027911,0.130702078
Georgia,RANDOLPH,7315,2466,4527,90,4849,0.337115516,0.012303486,0.662884484
Georgia,RICHMOND,201291,73950,108806,9147,127341,0.367378571,0.045441674,0.632621429
Georgia,ROCKDALE,86901,32655,42210,8617,54246,0.375772431,0.099158813,0.624227569
Georgia,SCHLEY,5074,3601,1215,226,1473,0.709696492,0.044540796,0.290303508
Georgia,SCREVEN,14206,7809,5966,231,6397,0.549697311,0.016260735,0.450302689
Georgia,SEMINOLE,8769,5489,2937,252,3280,0.625955069,0.028737598,0.374044931
Georgia,SPALDING,63873,38353,21012,2708,25520,0.600457157,0.042396631,0.399542843
Georgia,STEPHENS,25620,21273,3120,744,4347,0.830327869,0.029039813,0.169672131
Georgia,STEWART,5868,1605,2857,1277,4263,0.273517382,0.217620995,0.726482618
Georgia,SUMTER,31429,12642,16214,1651,18787,0.402239969,0.052531102,0.597760031
Georgia,TALBOT,6490,2581,3723,126,3909,0.397688752,0.019414484,0.602311248
Georgia,TALIAFERRO,1721,660,1009,38,1061,0.383497966,0.022080186,0.616502034
Georgia,TATTNALL,25302,14850,7307,2705,10452,0.586910126,0.106908545,0.413089874
Georgia,TAYLOR,8401,4903,3289,191,3498,0.583620998,0.022735389,0.416379002
Georgia,TELFAIR,16416,8214,5834,2271,8202,0.500365497,0.138340643,0.499634503
Georgia,TERRELL,9213,3331,5573,222,5882,0.361554325,0.024096386,0.638445675
Georgia,THOMAS,44824,25917,16261,1496,18907,0.578194717,0.033374978,0.421805283
Georgia,TIFT,40787,23072,12096,4414,17715,0.565670434,0.108220757,0.434329566
Georgia,TOOMBS,27210,16639,6967,3100,10571,0.611503124,0.113928703,0.388496876
Georgia,TOWNS,10800,10271,72,260,529,0.951018519,0.024074074,0.048981481
Georgia,TREUTLEN,6762,4692,1962,79,2070,0.693877551,0.011682934,0.306122449
Georgia,TROUP,68867,40240,23591,2485,28627,0.584314694,0.036084046,0.415685306
Georgia,TURNER,8338,4558,3245,356,3780,0.546653874,0.04269609,0.453346126
Georgia,TWIGGS,8509,4748,3576,5,3761,0.557997415,0.000587613,0.442002585
Georgia,UNION,21725,20495,101,621,1230,0.943383199,0.02858458,0.056616801
Georgia,UPSON,26528,18020,7535,631,8508,0.679282268,0.023786188,0.320717732
Georgia,WALKER,68285,62513,3120,1250,5772,0.915471919,0.018305631,0.084528081
Georgia,WALTON,86201,66141,13638,3269,20060,0.767288083,0.037922994,0.232711917
Georgia,WARE,35723,23003,10547,1300,12720,0.643926882,0.036391121,0.356073118
Georgia,WARREN,5561,2089,3268,43,3472,0.375651861,0.007732422,0.624348139
Georgia,WASHINGTON,20785,9118,10895,450,11667,0.438681742,0.021650229,0.561318258
Georgia,WAYNE,30046,21352,6125,1847,8694,0.71064368,0.061472409,0.28935632
Georgia,WEBSTER,2720,1175,1519,26,1545,0.431985294,0.009558824,0.568014706
Georgia,WHEELER,7956,4499,3265,173,3457,0.565485168,0.021744595,0.434514832
Georgia,WHITE,27791,25742,758,794,2049,0.926271095,0.0285704,0.073728905
Georgia,WHITFIELD,103456,62546,4078,34198,40910,0.604566192,0.330555985,0.395433808
Georgia,WILCOX,8972,5267,3371,190,3705,0.587048596,0.021176995,0.412951404
Georgia,WILKES,9991,5167,4232,393,4824,0.517165449,0.039335402,0.482834551
Georgia,WILKINSON,9386,5375,3548,243,4011,0.572661411,0.025889623,0.427338589
Georgia,WORTH,21156,14273,6280,443,6883,0.674654944,0.020939686,0.325345056
Hawaii,HAWAII,191482,58898,1203,23444,132584,0.30759027,0.122434485,0.69240973
Hawaii,HONOLULU,984178,191473,24130,91036,792705,0.194551189,0.092499528,0.805448811
Hawaii,KALAWAO,85,32,0,4,53,0.376470588,0.047058824,0.623529412
Hawaii,KAUAI,69691,20947,452,7350,48744,0.300569657,0.105465555,0.699430343
Hawaii,MAUI,160863,50482,896,17417,110381,0.313819834,0.108272257,0.686180166
Idaho,ADA,417501,357162,4579,31830,60339,0.855475795,0.076239338,0.144524205
Idaho,ADAMS,3880,3629,0,120,251,0.935309278,0.030927835,0.064690722
Idaho,BANNOCK,83604,71284,564,6442,12320,0.85263863,0.077053729,0.14736137
Idaho,BEAR LAKE,5939,5572,28,245,367,0.938205085,0.041252736,0.061794915
Idaho,BENEWAH,9088,7692,29,291,1396,0.846390845,0.032020246,0.153609155
Idaho,BINGHAM,45407,33834,133,8034,11573,0.745127403,0.176933072,0.254872597
Idaho,BLAINE,21309,16468,19,4362,4841,0.772818997,0.204702238,0.227181003
Idaho,BOISE,6885,6365,36,245,520,0.924473493,0.035584604,0.075526507
Idaho,BONNER,41066,38512,35,1102,2554,0.937807432,0.026834851,0.062192568
Idaho,BONNEVILLE,107788,90653,480,13316,17135,0.841030541,0.123538798,0.158969459
Idaho,BOUNDARY,10961,10014,26,457,947,0.913602773,0.041693276,0.086397227
Idaho,BUTTE,2653,2323,53,162,330,0.875612514,0.061062948,0.124387486
Idaho,CAMAS,1052,920,0,119,132,0.874524715,0.113117871,0.125475285
Idaho,CANYON,198921,142337,787,48640,56584,0.715545367,0.244519181,0.284454633
Idaho,CARIBOU,6808,6414,7,363,394,0.94212691,0.053319624,0.05787309
Idaho,CASSIA,23369,16689,37,6129,6680,0.714151226,0.262270529,0.285848774
Idaho,CLARK,901,524,0,373,377,0.581576027,0.413984462,0.418423973
Idaho,CLEARWATER,8560,7829,14,310,731,0.914602804,0.036214953,0.085397196
Idaho,CUSTER,4234,4031,0,113,203,0.952054795,0.02668871,0.047945205
Idaho,ELMORE,26175,19391,624,4209,6784,0.740821394,0.160802292,0.259178606
Idaho,FRANKLIN,12914,11789,10,883,1125,0.912885241,0.068375407,0.087114759
Idaho,FREMONT,12945,11039,46,1598,1906,0.852761684,0.123445346,0.147238316
Idaho,GEM,16731,14789,0,1341,1942,0.883928038,0.080150619,0.116071962
Idaho,GOODING,15233,10419,11,4381,4814,0.683975579,0.287599291,0.316024421
Idaho,IDAHO,16312,14965,14,506,1347,0.917422756,0.031020108,0.082577244
Idaho,JEFFERSON,26792,23372,39,2771,3420,0.872349955,0.103426396,0.127650045
Idaho,JEROME,22653,14530,17,7558,8123,0.641416148,0.333642343,0.358583852
Idaho,KOOTENAI,145046,132435,471,6061,12611,0.913055169,0.041786744,0.086944831
Idaho,LATAH,38339,34477,246,1520,3862,0.899267065,0.039646313,0.100732935
Idaho,LEMHI,7790,7297,27,226,493,0.936713736,0.029011553,0.063286264
Idaho,LEWIS,3812,3325,3,155,487,0.87224554,0.04066107,0.12775446
Idaho,LINCOLN,5260,3551,0,1557,1709,0.675095057,0.296007605,0.324904943
Idaho,MADISON,37916,34054,250,2515,3862,0.898143264,0.066330837,0.101856736
Idaho,MINIDOKA,20279,12970,18,6775,7309,0.639577888,0.334089452,0.360422112
Idaho,NEZ PERCE,39779,34897,146,1371,4882,0.877271927,0.034465421,0.122728073
Idaho,ONEIDA,4245,4007,0,149,238,0.94393404,0.035100118,0.05606596
Idaho,OWYHEE,11364,7790,9,2955,3574,0.685498064,0.260031679,0.314501936
Idaho,PAYETTE,22700,18062,98,3695,4638,0.795682819,0.16277533,0.204317181
Idaho,POWER,7731,4941,25,2435,2790,0.63911525,0.314965722,0.36088475
Idaho,SHOSHONE,12571,11618,40,419,953,0.924190597,0.033330682,0.075809403
Idaho,TETON,10285,8312,24,1792,1973,0.808167234,0.174234322,0.191832766
Idaho,TWIN FALLS,80004,64953,400,11914,15051,0.811871906,0.148917554,0.188128094
Idaho,VALLEY,9720,9429,1,133,291,0.970061728,0.013683128,0.029938272
Idaho,WASHINGTON,10025,7898,0,1742,2127,0.787830424,0.173765586,0.212169576
Illinois,ADAMS,67081,62015,2532,943,5066,0.924479361,0.014057632,0.075520639
Illinois,ALEXANDER,7364,4481,2535,118,2883,0.608500815,0.0160239,0.391499185
Illinois,BOND,17313,15241,962,587,2072,0.880321146,0.033905158,0.119678854
Illinois,BOONE,53851,40227,1119,10974,13624,0.747005627,0.203784517,0.252994373
Illinois,BROWN,6859,5093,1131,286,1766,0.742528065,0.04169704,0.257471935
Illinois,BUREAU,34115,30358,200,2881,3757,0.88987249,0.084449656,0.11012751
Illinois,CALHOUN,4999,4891,5,15,108,0.978395679,0.0030006,0.021604321
Illinois,CARROLL,14926,14013,168,494,913,0.938831569,0.03309661,0.061168431
Illinois,CASS,13254,10204,429,2433,3050,0.769880791,0.183567225,0.230119209
Illinois,CHAMPAIGN,205766,142486,25591,11403,63280,0.692466199,0.055417319,0.307533801
Illinois,CHRISTIAN,34200,32551,570,525,1649,0.951783626,0.015350877,0.048216374
Illinois,CLARK,16159,15656,47,221,503,0.968871836,0.013676589,0.031128164
Illinois,CLAY,13582,13089,74,187,493,0.963701958,0.013768223,0.036298042
Illinois,CLINTON,37929,34777,1279,1134,3152,0.916897361,0.029897967,0.083102639
Illinois,COLES,53037,48426,1807,1209,4611,0.913060693,0.022795407,0.086939307
Illinois,COOK,5236393,2256002,1239171,1295026,2980391,0.430831299,0.247312606,0.569168701
Illinois,CRAWFORD,19541,17828,692,412,1713,0.912338161,0.021083875,0.087661839
Illinois,CUMBERLAND,10943,10623,23,114,320,0.970757562,0.010417619,0.029242438
Illinois,DEKALB,104345,81773,6918,11111,22572,0.783679141,0.106483301,0.216320859
Illinois,DE WITT,16388,15613,74,370,775,0.952709299,0.022577496,0.047290701
Illinois,DOUGLAS,19826,18047,96,1371,1779,0.910269343,0.069151619,0.089730657
Illinois,DUPAGE,930412,638010,42526,129549,292402,0.685728473,0.139238316,0.314271527
Illinois,EDGAR,17992,17509,94,200,483,0.973154735,0.011116052,0.026845265
Illinois,EDWARDS,6649,6453,32,66,196,0.970521883,0.009926305,0.029478117
Illinois,EFFINGHAM,34332,33120,117,638,1212,0.964697658,0.018583246,0.035302342
Illinois,FAYETTE,22136,20367,923,377,1769,0.92008493,0.017031081,0.07991507
Illinois,FORD,13835,13144,80,367,691,0.95005421,0.026526924,0.04994579
Illinois,FRANKLIN,39694,38214,189,581,1480,0.962714768,0.014636973,0.037285232
Illinois,FULTON,36323,33483,1284,979,2840,0.921812626,0.02695262,0.078187374
Illinois,GALLATIN,5385,5166,21,50,219,0.959331476,0.009285051,0.040668524
Illinois,GREENE,13502,13117,129,142,385,0.971485706,0.01051696,0.028514294
Illinois,GRUNDY,50277,44058,717,4505,6219,0.876305269,0.089603596,0.123694731
Illinois,HAMILTON,8322,8249,42,16,73,0.99122807,0.001922615,0.00877193
Illinois,HANCOCK,18738,18140,106,245,598,0.968086242,0.013075035,0.031913758
Illinois,HARDIN,4228,4058,33,74,170,0.959791864,0.017502365,0.040208136
Illinois,HENDERSON,7042,6804,6,99,238,0.966202783,0.014058506,0.033797217
Illinois,HENRY,49883,45466,855,2628,4417,0.9114528,0.052683279,0.0885472
Illinois,IROQUOIS,29053,26420,376,1816,2633,0.909372526,0.062506454,0.090627474
Illinois,JACKSON,59534,44539,8420,2471,14995,0.748127121,0.041505694,0.251872879
Illinois,JASPER,9635,9381,33,123,254,0.973637779,0.012765957,0.026362221
Illinois,JEFFERSON,38578,33273,3039,880,5305,0.862486391,0.022810929,0.137513609
Illinois,JERSEY,22625,21806,96,275,819,0.963801105,0.012154696,0.036198895
Illinois,JO DAVIESS,22397,21259,60,688,1138,0.949189624,0.0307184,0.050810376
Illinois,JOHNSON,12829,11067,1129,381,1762,0.862654922,0.02969834,0.137345078
Illinois,KANE,524886,305352,27673,163756,219534,0.58174918,0.311983936,0.41825082
Illinois,KANKAKEE,112221,81441,16746,10803,30780,0.725719785,0.096265405,0.274280215
Illinois,KENDALL,120036,86912,7664,19965,33124,0.724049452,0.166325102,0.275950548
Illinois,KNOX,52112,43744,4327,2763,8368,0.839422782,0.053020418,0.160577218
Illinois,LAKE,702898,448118,47253,145475,254780,0.637529201,0.206964595,0.362470799
Illinois,LASALLE,112579,97790,2670,9856,14789,0.86863447,0.087547411,0.13136553
Illinois,LAWRENCE,16665,12020,3408,960,4645,0.721272127,0.057605761,0.278727873
Illinois,LEE,35027,30523,1735,1975,4504,0.871413481,0.056385074,0.128586519
Illinois,LIVINGSTON,37689,33631,2030,1624,4058,0.892329327,0.043089496,0.107670673
Illinois,LOGAN,29956,23137,3472,1234,6819,0.772366137,0.041193751,0.227633863
Illinois,MCDONOUGH,32009,28282,1520,856,3727,0.883563998,0.026742479,0.116436002
Illinois,MCHENRY,307357,253736,3844,37205,53621,0.825541634,0.121048162,0.174458366
Illinois,MCLEAN,173114,139183,13441,8101,33931,0.803996211,0.046795753,0.196003789
Illinois,MACON,109193,84423,15968,2247,24770,0.773153957,0.020578242,0.226846043
Illinois,MACOUPIN,46844,45201,321,469,1643,0.964926138,0.010011955,0.035073862
Illinois,MADISON,267356,229849,21506,7998,37507,0.859711396,0.029915169,0.140288604
Illinois,MARION,38665,35530,1421,662,3135,0.918918919,0.017121428,0.081081081
Illinois,MARSHALL,12173,11583,73,375,590,0.951532079,0.030805882,0.048467921
Illinois,MASON,14126,13674,127,83,452,0.968002265,0.00587569,0.031997735
Illinois,MASSAC,15016,13385,902,379,1631,0.891382525,0.025239744,0.108617475
Illinois,MENARD,12611,12114,113,164,497,0.960589961,0.01300452,0.039410039
Illinois,MERCER,16107,15493,76,344,614,0.961879928,0.021357174,0.038120072
Illinois,MONROE,33539,32406,114,515,1133,0.966218432,0.015355258,0.033781568
Illinois,MONTGOMERY,29348,25855,2569,483,3493,0.880979965,0.01645768,0.119020035
Illinois,MORGAN,35129,31331,2088,798,3798,0.891884198,0.022716274,0.108115802
Illinois,MOULTRIE,14927,14506,50,180,421,0.971796074,0.012058686,0.028203926
Illinois,OGLE,52397,46089,529,4919,6308,0.879611428,0.093879421,0.120388572
Illinois,PEORIA,187112,133294,32449,8185,53818,0.712375476,0.043743854,0.287624524
Illinois,PERRY,21810,18821,1903,492,2989,0.862952774,0.022558459,0.137047226
Illinois,PIATT,16495,15968,68,178,527,0.968050925,0.010791149,0.031949075
Illinois,PIKE,16144,15442,190,197,702,0.956516353,0.012202676,0.043483647
Illinois,POPE,4331,4035,155,78,296,0.931655507,0.018009698,0.068344493
Illinois,PULASKI,5871,3730,1878,107,2141,0.63532618,0.018225175,0.36467382
Illinois,PUTNAM,5822,5423,11,279,399,0.93146685,0.047921676,0.06853315
Illinois,RANDOLPH,33069,28318,3394,937,4751,0.856330702,0.028334694,0.143669298
Illinois,RICHLAND,16127,15485,70,236,642,0.960190984,0.014633844,0.039809016
Illinois,ROCK ISLAND,147161,108746,13496,18061,38415,0.738959371,0.122729528,0.261040629
Illinois,ST. CLAIR,267029,166996,79406,9849,100033,0.625385258,0.036883634,0.374614742
Illinois,SALINE,24783,22759,910,391,2024,0.918331114,0.015776944,0.081668886
Illinois,SANGAMON,199016,161766,24374,4205,37250,0.812829119,0.021128954,0.187170881
Illinois,SCHUYLER,7311,6869,332,32,442,0.939543154,0.004376966,0.060456846
Illinois,SCOTT,5198,5055,0,73,143,0.972489419,0.014043863,0.027510581
Illinois,SHELBY,22115,21591,118,202,524,0.976305675,0.009134072,0.023694325
Illinois,STARK,5859,5666,44,65,193,0.967059225,0.011094043,0.032940775
Illinois,STEPHENSON,46625,39229,4260,1544,7396,0.841372654,0.033115282,0.158627346
Illinois,TAZEWELL,135697,128024,1623,2941,7673,0.943454903,0.021673287,0.056545097
Illinois,UNION,17551,16099,212,884,1452,0.917269671,0.0503675,0.082730329
Illinois,VERMILION,80368,63786,11073,3715,16582,0.793674099,0.046224866,0.206325901
Illinois,WABASH,11652,11124,109,184,528,0.954685891,0.01579128,0.045314109
Illinois,WARREN,17701,15177,462,1601,2524,0.857409186,0.090446867,0.142590814
Illinois,WASHINGTON,14457,13907,107,232,550,0.961956146,0.016047589,0.038043854
Illinois,WAYNE,16555,16007,108,97,548,0.966898218,0.005859257,0.033101782
Illinois,WHITE,14464,14023,58,184,441,0.969510509,0.012721239,0.030489491
Illinois,WHITESIDE,57525,48915,900,6698,8610,0.850325945,0.116436332,0.149674055
Illinois,WILL,683995,448959,74943,111709,235036,0.656377605,0.163318445,0.343622395
Illinois,WILLIAMSON,67121,60884,2776,1563,6237,0.907078262,0.023286304,0.092921738
Illinois,WINNEBAGO,290439,206488,35926,34122,83951,0.710951353,0.117484222,0.289048647
Illinois,WOODFORD,39106,37487,213,647,1619,0.958599703,0.016544776,0.041400297
Indiana,ADAMS,34642,32584,242,1510,2058,0.940592345,0.043588707,0.059407655
Indiana,ALLEN,363453,273309,41223,25365,90144,0.751978935,0.069788941,0.248021065
Indiana,BARTHOLOMEW,79488,67492,1579,4956,11996,0.849084138,0.062349034,0.150915862
Indiana,BENTON,8752,8128,73,458,624,0.928702011,0.052330896,0.071297989
Indiana,BLACKFORD,12476,11988,72,177,488,0.960884899,0.014187239,0.039115101
Indiana,BOONE,60511,55938,750,1539,4573,0.924426964,0.025433392,0.075573036
Indiana,BROWN,15011,14425,49,221,586,0.960961961,0.014722537,0.039038039
Indiana,CARROLL,20014,18882,68,798,1132,0.943439592,0.03987209,0.056560408
Indiana,CASS,38476,31457,529,5220,7019,0.817574592,0.135668988,0.182425408
Indiana,CLARK,113181,95634,7891,5715,17547,0.844965144,0.050494341,0.155034856
Indiana,CLAY,26686,25810,63,342,876,0.967173799,0.012815709,0.032826201
Indiana,CLINTON,32835,27531,237,4756,5304,0.838465053,0.144845439,0.161534947
Indiana,CRAWFORD,10591,10220,11,153,371,0.964970258,0.014446228,0.035029742
Indiana,DAVIESS,32411,30145,457,1451,2266,0.930085465,0.044768751,0.069914535
Indiana,DEARBORN,49679,47886,394,569,1793,0.963908291,0.011453532,0.036091709
Indiana,DECATUR,26240,25010,148,478,1230,0.953125,0.018216463,0.046875
Indiana,DEKALB,42449,40452,52,1107,1997,0.952955311,0.026078353,0.047044689
Indiana,DELAWARE,117335,102621,6753,2386,14714,0.874598372,0.020334938,0.125401628
Indiana,DUBOIS,42291,38857,164,2750,3434,0.91880069,0.065025656,0.08119931
Indiana,ELKHART,200685,152635,11206,29763,48050,0.760570048,0.148307048,0.239429952
Indiana,FAYETTE,23773,22819,476,234,954,0.959870441,0.009843099,0.040129559
Indiana,FLOYD,75900,67339,3699,2179,8561,0.887206851,0.028708827,0.112793149
Indiana,FOUNTAIN,16888,16169,75,399,719,0.957425391,0.023626243,0.042574609
Indiana,FRANKLIN,22935,22337,55,239,598,0.973926313,0.010420754,0.026073687
Indiana,FULTON,20527,18984,204,982,1543,0.924830711,0.047839431,0.075169289
Indiana,GIBSON,33668,31718,553,504,1950,0.942081502,0.014969704,0.057918498
Indiana,GRANT,68896,59110,4523,2737,9786,0.857959824,0.039726544,0.142040176
Indiana,GREENE,32815,31824,69,399,991,0.969800396,0.012159074,0.030199604
Indiana,HAMILTON,296635,252168,10485,11001,44467,0.850095235,0.037085981,0.149904765
Indiana,HANCOCK,71328,66743,1417,1406,4585,0.935719493,0.019711754,0.064280507
Indiana,HARRISON,39230,37685,316,678,1545,0.960616875,0.017282692,0.039383125
Indiana,HENDRICKS,153435,133022,8702,5271,20413,0.86695995,0.034353309,0.13304005
Indiana,HENRY,49146,46221,851,793,2925,0.940483457,0.016135596,0.059516543
Indiana,HOWARD,82765,71375,5745,2484,11390,0.862381441,0.030012687,0.137618559
Indiana,HUNTINGTON,36863,35238,261,737,1625,0.955917858,0.019992947,0.044082142
Indiana,JACKSON,43471,39195,337,2662,4276,0.901635573,0.061236226,0.098364427
Indiana,JASPER,33448,30761,241,1936,2687,0.919666348,0.05788089,0.080333652
Indiana,JAY,21255,20274,123,627,981,0.953846154,0.029498941,0.046153846
Indiana,JEFFERSON,32453,30322,629,788,2131,0.934335809,0.024281268,0.065664191
Indiana,JENNINGS,28113,26837,401,635,1276,0.954611745,0.022587415,0.045388255
Indiana,JOHNSON,145645,132589,2740,4895,13056,0.910357376,0.033609118,0.089642624
Indiana,KNOX,38062,35471,1125,670,2591,0.931926856,0.017602858,0.068073144
Indiana,KOSCIUSKO,77983,69391,557,6060,8592,0.889822141,0.077709244,0.110177859
Indiana,LAGRANGE,38084,36030,19,1461,2054,0.94606659,0.038362567,0.05393341
Indiana,LAKE,491596,269262,119856,87085,222334,0.54773025,0.177147495,0.45226975
Indiana,LAPORTE,111280,89437,12030,6635,21843,0.803711359,0.059624371,0.196288641
Indiana,LAWRENCE,45814,44023,171,680,1791,0.960907146,0.014842625,0.039092854
Indiana,MADISON,130280,111718,10091,4674,18562,0.85752226,0.035876574,0.14247774
Indiana,MARION,926335,538138,248584,89830,388197,0.580932384,0.096973557,0.419067616
Indiana,MARSHALL,46962,41585,267,4297,5377,0.885503173,0.09149951,0.114496827
Indiana,MARTIN,10262,9993,30,24,269,0.973786786,0.002338725,0.026213214
Indiana,MIAMI,36211,32517,1824,962,3694,0.8979868,0.026566513,0.1020132
Indiana,MONROE,142404,120736,4070,4623,21668,0.847841353,0.032463976,0.152158647
Indiana,MONTGOMERY,38172,35318,326,1733,2854,0.925233155,0.045399769,0.074766845
Indiana,MORGAN,69403,66950,256,959,2453,0.964655707,0.013817846,0.035344293
Indiana,NEWTON,14057,12981,39,794,1076,0.923454507,0.056484314,0.076545493
Indiana,NOBLE,47546,41802,228,4733,5744,0.879190679,0.099545703,0.120809321
Indiana,OHIO,6033,5967,58,0,66,0.989060169,0,0.010939831
Indiana,ORANGE,19725,18904,277,251,821,0.958377693,0.012724968,0.041622307
Indiana,OWEN,21192,20475,129,146,717,0.966166478,0.006889392,0.033833522
Indiana,PARKE,17107,16260,348,226,847,0.950488104,0.013210966,0.049511896
Indiana,PERRY,19414,18336,592,241,1078,0.944473061,0.012413722,0.055526939
Indiana,PIKE,12687,12579,24,29,108,0.991487349,0.002285804,0.008512651
Indiana,PORTER,166570,140793,5272,15371,25777,0.845248244,0.092279522,0.154751756
Indiana,POSEY,25567,24655,339,264,912,0.964329018,0.010325811,0.035670982
Indiana,PULASKI,13047,12381,36,363,666,0.948953782,0.027822488,0.051046218
Indiana,PUTNAM,37650,34596,1499,665,3054,0.918884462,0.017662683,0.081115538
Indiana,RANDOLPH,25596,24184,94,814,1412,0.94483513,0.031801844,0.05516487
Indiana,RIPLEY,28612,27500,136,486,1112,0.961135188,0.01698588,0.038864812
Indiana,RUSH,16991,16391,148,215,600,0.964687187,0.012653758,0.035312813
Indiana,ST. JOSEPH,267246,198873,34079,21251,68373,0.744157069,0.079518496,0.255842931
Indiana,SCOTT,23783,22938,59,405,845,0.96447042,0.01702897,0.03552958
Indiana,SHELBY,44441,41258,562,1715,3183,0.928376949,0.038590491,0.071623051
Indiana,SPENCER,20856,19905,124,553,951,0.954401611,0.026515152,0.045598389
Indiana,STARKE,23117,21861,154,803,1256,0.94566769,0.034736341,0.05433231
Indiana,STEUBEN,34267,32318,87,1108,1949,0.943123121,0.032334316,0.056876879
Indiana,SULLIVAN,21111,19479,951,353,1632,0.92269433,0.016721141,0.07730567
Indiana,SWITZERLAND,10500,10142,104,74,358,0.965904762,0.007047619,0.034095238
Indiana,TIPPECANOE,180952,141842,7951,14360,39110,0.783865334,0.079358062,0.216134666
Indiana,TIPTON,15573,14902,24,401,671,0.956912605,0.025749695,0.043087395
Indiana,UNION,7299,7026,12,53,273,0.962597616,0.007261269,0.037402384
Indiana,VANDERBURGH,181305,153326,16391,4415,27979,0.845679932,0.024351231,0.154320068
Indiana,VERMILLION,15860,15388,50,167,472,0.970239596,0.010529634,0.029760404
Indiana,VIGO,108268,93234,6571,2699,15034,0.861140873,0.02492888,0.138859127
Indiana,WABASH,32358,30652,270,759,1706,0.947277335,0.023456332,0.052722665
Indiana,WARREN,8367,8110,47,106,257,0.969284092,0.012668818,0.030715908
Indiana,WARRICK,60995,56912,943,1049,4083,0.933060087,0.017198131,0.066939913
Indiana,WASHINGTON,27930,27079,29,382,851,0.96953097,0.01367705,0.03046903
Indiana,WAYNE,67866,60261,3191,1823,7605,0.887940942,0.026861757,0.112059058
Indiana,WELLS,27796,26532,155,684,1264,0.954525831,0.024607857,0.045474169
Indiana,WHITE,24388,22013,88,1831,2375,0.902616041,0.075077907,0.097383959
Indiana,WHITLEY,33330,31963,121,624,1367,0.958985899,0.018721872,0.041014101
Iowa,ADAIR,7426,7217,27,114,209,0.971855642,0.015351468,0.028144358
Iowa,ADAMS,3892,3775,27,31,117,0.969938335,0.007965057,0.030061665
Iowa,ALLAMAKEE,14060,12939,99,765,1121,0.92027027,0.054409673,0.07972973
Iowa,APPANOOSE,12669,12184,39,202,485,0.961717578,0.015944431,0.038282422
Iowa,AUDUBON,5869,5721,9,49,148,0.974782757,0.008348952,0.025217243
Iowa,BENTON,25803,24974,181,338,829,0.967871953,0.013099252,0.032128047
Iowa,BLACK HAWK,132496,110028,11920,5315,22468,0.830425069,0.040114419,0.169574931
Iowa,BOONE,26401,25081,235,612,1320,0.950001894,0.02318094,0.049998106
Iowa,BREMER,24539,23547,269,312,992,0.959574555,0.012714455,0.040425445
Iowa,BUCHANAN,20998,20294,79,296,704,0.966472997,0.014096581,0.033527003
Iowa,BUENA VISTA,20507,13107,544,4992,7400,0.639147608,0.243429073,0.360852392
Iowa,BUTLER,14966,14552,59,162,414,0.972337298,0.010824536,0.027662702
Iowa,CALHOUN,9914,9419,134,168,495,0.950070607,0.016945733,0.049929393
Iowa,CARROLL,20629,19750,314,434,879,0.957390082,0.021038344,0.042609918
Iowa,CASS,13590,13030,57,313,560,0.95879323,0.023031641,0.04120677
Iowa,CEDAR,18375,17668,72,317,707,0.96152381,0.017251701,0.03847619
Iowa,CERRO GORDO,43481,39979,533,1839,3502,0.919459074,0.042294335,0.080540926
Iowa,CHEROKEE,11853,11183,54,367,670,0.943474226,0.030962625,0.056525774
Iowa,CHICKASAW,12244,11778,49,278,466,0.961940542,0.022704998,0.038059458
Iowa,CLARKE,9280,8157,13,1056,1123,0.878987069,0.113793103,0.121012931
Iowa,CLAY,16537,15637,91,503,900,0.945576586,0.030416641,0.054423414
Iowa,CLAYTON,17806,17158,166,326,648,0.963607773,0.018308435,0.036392227
Iowa,CLINTON,48365,44351,1324,1399,4014,0.917006099,0.028925876,0.082993901
Iowa,CRAWFORD,17252,11924,166,4658,5328,0.691166242,0.269997681,0.308833758
Iowa,DALLAS,74892,65231,824,4634,9661,0.871000908,0.061875768,0.128999092
Iowa,DAVIS,8742,8507,18,105,235,0.97311828,0.012010981,0.02688172
Iowa,DECATUR,8249,7679,139,225,570,0.930900715,0.027276033,0.069099285
Iowa,DELAWARE,17507,17058,39,195,449,0.974353116,0.011138402,0.025646884
Iowa,DES MOINES,40208,35549,2186,1158,4659,0.884127537,0.028800239,0.115872463
Iowa,DICKINSON,16967,16404,52,270,563,0.966817941,0.015913243,0.033182059
Iowa,DUBUQUE,95906,88302,1849,2066,7604,0.920714032,0.021541926,0.079285968
Iowa,EMMET,9917,8776,142,894,1141,0.884945044,0.09014823,0.115054956
Iowa,FAYETTE,20589,19470,223,448,1119,0.94565059,0.021759192,0.05434941
Iowa,FLOYD,16050,15029,319,359,1021,0.936386293,0.022367601,0.063613707
Iowa,FRANKLIN,10489,9072,101,1207,1417,0.864906092,0.115072934,0.135093908
Iowa,FREMONT,7106,6780,10,180,326,0.954123276,0.025330706,0.045876724
Iowa,GREENE,9174,8751,5,234,423,0.953891432,0.025506867,0.046108568
Iowa,GRUNDY,12407,12073,51,150,334,0.973079713,0.012089949,0.026920287
Iowa,GUTHRIE,10740,10319,81,228,421,0.960800745,0.02122905,0.039199255
Iowa,HAMILTON,15297,13868,102,823,1429,0.90658299,0.053801399,0.09341701
Iowa,HANCOCK,11092,10445,72,408,647,0.941669672,0.036783267,0.058330328
Iowa,HARDIN,17393,16171,163,685,1222,0.92974185,0.03938366,0.07025815
Iowa,HARRISON,14467,14005,8,199,462,0.968065252,0.013755443,0.031934748
Iowa,HENRY,20080,17852,458,892,2228,0.889043825,0.044422311,0.110956175
Iowa,HOWARD,9494,9188,31,141,306,0.967769117,0.014851485,0.032230883
Iowa,HUMBOLDT,9674,9140,13,362,534,0.944800496,0.037419888,0.055199504
Iowa,IDA,7071,6802,38,137,269,0.96195729,0.019374912,0.03804271
Iowa,IOWA,16344,15689,137,367,655,0.959924131,0.022454723,0.040075869
Iowa,JACKSON,19572,18796,35,262,776,0.960351523,0.01338647,0.039648477
Iowa,JASPER,36726,34838,542,640,1888,0.948592278,0.017426346,0.051407722
Iowa,JEFFERSON,17318,14249,246,526,3069,0.822785541,0.030373022,0.177214459
Iowa,JOHNSON,139436,113069,7512,7299,26367,0.810902493,0.052346596,0.189097507
Iowa,JONES,20560,19496,379,329,1064,0.948249027,0.016001946,0.051750973
Iowa,KEOKUK,10291,9985,0,147,306,0.97026528,0.014284326,0.02973472
Iowa,KOSSUTH,15280,14688,56,280,592,0.961256545,0.018324607,0.038743455
Iowa,LEE,35369,32202,1058,1173,3167,0.910458311,0.033164636,0.089541689
Iowa,LINN,216640,191139,8916,6256,25501,0.882288589,0.0288774,0.117711411
Iowa,LOUISA,11271,8996,87,1817,2275,0.798154556,0.161210185,0.201845444
Iowa,LUCAS,8731,8505,20,30,226,0.974115222,0.003436033,0.025884778
Iowa,LYON,11723,11290,7,288,433,0.963064062,0.02456709,0.036935938
Iowa,MADISON,15644,15101,76,226,543,0.965290207,0.014446433,0.034709793
Iowa,MAHASKA,22396,21131,301,420,1265,0.943516699,0.018753349,0.056483301
Iowa,MARION,33248,31604,179,587,1644,0.950553417,0.017655197,0.049446583
Iowa,MARSHALL,40962,30552,674,7899,10410,0.745862018,0.192837264,0.254137982
Iowa,MILLS,14862,14108,107,394,754,0.949266586,0.026510564,0.050733414
Iowa,MITCHELL,10762,10516,15,136,246,0.977141795,0.012637056,0.022858205
Iowa,MONONA,9088,8682,49,149,406,0.955325704,0.016395246,0.044674296
Iowa,MONROE,8002,7572,11,69,430,0.946263434,0.008622844,0.053736566
Iowa,MONTGOMERY,10465,9904,0,348,561,0.946392738,0.033253703,0.053607262
Iowa,MUSCATINE,42913,33862,631,7260,9051,0.789084893,0.169179503,0.210915107
Iowa,O'BRIEN,14092,13185,72,592,907,0.935637241,0.042009651,0.064362759
Iowa,OSCEOLA,6211,5693,25,405,518,0.916599581,0.065206891,0.083400419
Iowa,PAGE,15660,14398,331,448,1262,0.919412516,0.028607918,0.080587484
Iowa,PALO ALTO,9208,8796,116,185,412,0.955256299,0.020091225,0.044743701
Iowa,PLYMOUTH,24853,23382,126,923,1471,0.940811974,0.037138374,0.059188026
Iowa,POCAHONTAS,7127,6731,88,232,396,0.944436649,0.032552266,0.055563351
Iowa,POLK,452369,359506,27634,35936,92863,0.794718471,0.079439573,0.205281529
Iowa,POTTAWATTAMIE,93213,82913,1169,6573,10300,0.889500392,0.070515915,0.110499608
Iowa,POWESHIEK,18705,17308,200,543,1397,0.925314087,0.029029671,0.074685913
Iowa,RINGGOLD,5061,4882,12,68,179,0.964631496,0.01343608,0.035368504
Iowa,SAC,10101,9676,58,260,425,0.957924958,0.025740026,0.042075042
Iowa,SCOTT,169994,138658,12985,10394,31336,0.815664082,0.061143334,0.184335918
Iowa,SHELBY,11992,11479,23,290,513,0.957221481,0.024182789,0.042778519
Iowa,SIOUX,34509,30457,150,3309,4052,0.882581356,0.095888029,0.117418644
Iowa,STORY,93586,80101,2134,2899,13485,0.855907935,0.030976856,0.144092065
Iowa,TAMA,17479,14546,89,1401,2933,0.832198638,0.080153327,0.167801362
Iowa,TAYLOR,6213,5658,13,464,555,0.910671173,0.074682118,0.089328827
Iowa,UNION,12575,11951,124,310,624,0.950377734,0.024652087,0.049622266
Iowa,VAN BUREN,7432,7217,23,92,215,0.971071044,0.012378902,0.028928956
Iowa,WAPELLO,35315,30219,714,3499,5096,0.855698712,0.099079711,0.144301288
Iowa,WARREN,47542,45200,228,1109,2342,0.950738295,0.023326743,0.049261705
Iowa,WASHINGTON,22017,20259,160,1210,1758,0.920152609,0.054957533,0.079847391
Iowa,WAYNE,6384,6172,30,63,212,0.96679198,0.009868421,0.03320802
Iowa,WEBSTER,37295,33145,1500,1571,4150,0.88872503,0.042123609,0.11127497
Iowa,WINNEBAGO,10614,9879,98,403,735,0.930751837,0.037968721,0.069248163
Iowa,WINNESHIEK,20884,19897,198,436,987,0.952738939,0.020877227,0.047261061
Iowa,WOODBURY,102530,77797,2847,15385,24733,0.758773042,0.150053643,0.241226958
Iowa,WORTH,7563,7219,73,193,344,0.954515404,0.025518974,0.045484596
Iowa,WRIGHT,12936,11390,49,1289,1546,0.880488559,0.099644403,0.119511441
Kansas,ALLEN,13081,11928,223,402,1153,0.911856892,0.030731595,0.088143108
Kansas,ANDERSON,7896,7498,9,35,398,0.949594732,0.004432624,0.050405268
Kansas,ATCHISON,16633,14678,681,474,1955,0.882462574,0.028497565,0.117537426
Kansas,BARBER,4770,4438,16,160,332,0.930398323,0.033542977,0.069601677
Kansas,BARTON,27399,22625,353,3837,4774,0.825760064,0.140041607,0.174239936
Kansas,BOURBON,14812,13476,513,344,1336,0.909802863,0.023224413,0.090197137
Kansas,BROWN,9880,8285,154,366,1595,0.838562753,0.037044534,0.161437247
Kansas,BUTLER,66092,59473,1308,2881,6619,0.899851722,0.043590752,0.100148278
Kansas,CHASE,2722,2517,24,107,205,0.92468773,0.039309331,0.07531227
Kansas,CHAUTAUQUA,3520,3080,20,58,440,0.875,0.016477273,0.125
Kansas,CHEROKEE,20952,18608,112,471,2344,0.888125239,0.022479954,0.111874761
Kansas,CHEYENNE,2682,2438,0,174,244,0.909023117,0.064876957,0.090976883
Kansas,CLARK,2145,1743,22,260,402,0.812587413,0.121212121,0.187412587
Kansas,CLAY,8421,7979,49,214,442,0.947512172,0.025412659,0.052487828
Kansas,CLOUD,9339,8743,40,304,596,0.936181604,0.032551665,0.063818396
Kansas,COFFEY,8458,7951,66,206,507,0.940056751,0.02435564,0.059943249
Kansas,COMANCHE,2010,1903,0,86,107,0.946766169,0.04278607,0.053233831
Kansas,COWLEY,36079,29202,1008,3612,6877,0.809390504,0.10011364,0.190609496
Kansas,CRAWFORD,39304,34537,818,1981,4767,0.878714635,0.050401995,0.121285365
Kansas,DECATUR,2905,2774,12,77,131,0.954905336,0.026506024,0.045094664
Kansas,DICKINSON,19516,17890,99,862,1626,0.916683747,0.044168887,0.083316253
Kansas,DONIPHAN,7859,7093,290,202,766,0.902532129,0.025703016,0.097467871
Kansas,DOUGLAS,114967,92110,4406,6529,22857,0.801186427,0.056790209,0.198813573
Kansas,EDWARDS,2991,2333,26,586,658,0.780006687,0.195921097,0.219993313
Kansas,ELK,2683,2456,21,102,227,0.915393217,0.038017145,0.084606783
Kansas,ELLIS,28993,26233,329,1590,2760,0.904804608,0.054840824,0.095195392
Kansas,ELLSWORTH,6410,5562,243,371,848,0.867706708,0.057878315,0.132293292
Kansas,FINNEY,37133,16437,779,17804,20696,0.442652088,0.479465704,0.557347912
Kansas,FORD,34714,14517,803,18319,20197,0.418188627,0.527712162,0.581811373
Kansas,FRANKLIN,25753,23478,303,1005,2275,0.911660777,0.03902458,0.088339223
Kansas,GEARY,36787,21672,5948,5296,15115,0.589121157,0.1439639,0.410878843
Kansas,GOVE,2735,2600,27,58,135,0.950639854,0.021206581,0.049360146
Kansas,GRAHAM,2593,2313,80,76,280,0.892016969,0.02930968,0.107983031
Kansas,GRANT,7816,4150,1,3579,3666,0.530962129,0.457906858,0.469037871
Kansas,GRAY,6065,5139,0,891,926,0.847320692,0.146908491,0.152679308
Kansas,GREELEY,1224,901,11,278,323,0.736111111,0.227124183,0.263888889
Kansas,GREENWOOD,6393,5912,10,240,481,0.924761458,0.037541061,0.075238542
Kansas,HAMILTON,2586,1672,0,871,914,0.646558391,0.336813612,0.353441609
Kansas,HARPER,5861,5304,5,377,557,0.904965023,0.064323494,0.095034977
Kansas,HARVEY,34835,29173,540,3951,5662,0.837462322,0.113420411,0.162537678
Kansas,HASKELL,4130,2847,0,1179,1283,0.689346247,0.285472155,0.310653753
Kansas,HODGEMAN,1939,1726,0,142,213,0.890149562,0.073233626,0.109850438
Kansas,JACKSON,13400,11344,90,581,2056,0.846567164,0.043358209,0.153432836
Kansas,JEFFERSON,18898,17809,90,447,1089,0.942374854,0.023653297,0.057625146
Kansas,JEWELL,3038,2904,2,71,134,0.955892034,0.023370639,0.044107966
Kansas,JOHNSON,566814,459104,25107,41482,107710,0.809972936,0.073184501,0.190027064
Kansas,KEARNY,3952,2615,34,1184,1337,0.661690283,0.299595142,0.338309717
Kansas,KINGMAN,7790,7340,11,237,450,0.942233633,0.03042362,0.057766367
Kansas,KIOWA,2536,2294,17,144,242,0.904574132,0.056782334,0.095425868
Kansas,LABETTE,21048,17945,707,901,3103,0.852575067,0.042806918,0.147424933
Kansas,LANE,1674,1547,6,102,127,0.924133811,0.0609319,0.075866189
Kansas,LEAVENWORTH,78227,62071,6513,5164,16156,0.793472842,0.066013013,0.206527158
Kansas,LINCOLN,3154,2999,26,79,155,0.950856056,0.025047559,0.049143944
Kansas,LINN,9528,8993,63,211,535,0.943849706,0.022145256,0.056150294
Kansas,LOGAN,2793,2548,0,127,245,0.912280702,0.04547082,0.087719298
Kansas,LYON,33462,24163,766,6831,9299,0.722102684,0.204142012,0.277897316
Kansas,MCPHERSON,29252,26964,294,1138,2288,0.921783126,0.038903323,0.078216874
Kansas,MARION,12290,11500,100,358,790,0.935720098,0.029129373,0.064279902
Kansas,MARSHALL,10005,9532,29,226,473,0.952723638,0.022588706,0.047276362
Kansas,MEADE,4383,3620,28,633,763,0.825918321,0.144421629,0.174081679
Kansas,MIAMI,32688,30429,435,961,2259,0.93089207,0.029399168,0.06910793
Kansas,MITCHELL,6296,6057,23,118,239,0.96203939,0.018742058,0.03796061
Kansas,MONTGOMERY,34184,27469,1734,2038,6715,0.80356307,0.059618535,0.19643693
Kansas,MORRIS,5750,5335,7,248,415,0.927826087,0.043130435,0.072173913
Kansas,MORTON,3106,2304,29,638,802,0.741790084,0.205408886,0.258209916
Kansas,NEMAHA,10159,9739,89,160,420,0.958657348,0.015749582,0.041342652
Kansas,NEOSHO,16423,14894,162,805,1529,0.906898861,0.049016623,0.093101139
Kansas,NESS,3077,2746,16,283,331,0.892427689,0.091972701,0.107572311
Kansas,NORTON,5590,5019,137,278,571,0.897853309,0.049731664,0.102146691
Kansas,OSAGE,16080,15164,24,415,916,0.943034826,0.025808458,0.056965174
Kansas,OSBORNE,3782,3638,15,61,144,0.961924907,0.016129032,0.038075093
Kansas,OTTAWA,6048,5720,16,163,328,0.945767196,0.026951058,0.054232804
Kansas,PAWNEE,6911,5866,335,524,1045,0.848791781,0.075821155,0.151208219
Kansas,PHILLIPS,5501,5207,21,151,294,0.946555172,0.027449555,0.053444828
Kansas,POTTAWATOMIE,22625,20361,279,1164,2264,0.899933702,0.051447514,0.100066298
Kansas,PRATT,9739,8719,70,646,1020,0.895266454,0.066331246,0.104733546
Kansas,RAWLINS,2545,2371,9,117,174,0.931630648,0.045972495,0.068369352
Kansas,RENO,64058,54577,1842,5607,9481,0.851993506,0.087530051,0.148006494
Kansas,REPUBLIC,4806,4649,7,68,157,0.967332501,0.01414898,0.032667499
Kansas,RICE,10014,8450,170,1088,1564,0.843818654,0.108647893,0.156181346
Kansas,RILEY,75022,58247,4744,5844,16775,0.776398923,0.07789715,0.223601077
Kansas,ROOKS,5186,4937,12,127,249,0.951986116,0.024489009,0.048013884
Kansas,RUSH,3184,3033,0,94,151,0.952575377,0.029522613,0.047424623
Kansas,RUSSELL,6988,6539,87,171,449,0.935746995,0.024470521,0.064253005
Kansas,SALINE,55735,45070,1745,5873,10665,0.808648067,0.105373643,0.191351933
Kansas,SCOTT,4928,4017,0,815,911,0.815137987,0.165381494,0.184862013
Kansas,SEDGWICK,506529,349955,45738,69308,156574,0.69088838,0.136829283,0.30911162
Kansas,SEWARD,23274,7852,819,13575,15422,0.337372175,0.583268884,0.662627825
Kansas,SHAWNEE,178792,133760,13206,20577,45032,0.748131907,0.115089042,0.251868093
Kansas,SHERIDAN,2531,2389,2,93,142,0.943895693,0.03674437,0.056104307
Kansas,SHERMAN,6054,5135,87,730,919,0.848199537,0.120581434,0.151800463
Kansas,SMITH,3740,3581,16,72,159,0.957486631,0.019251337,0.042513369
Kansas,STAFFORD,4320,3641,42,558,679,0.842824074,0.129166667,0.157175926
Kansas,STANTON,2149,1299,22,762,850,0.604467194,0.354583527,0.395532806
Kansas,STEVENS,5772,3637,32,1985,2135,0.63011088,0.343901594,0.36988912
Kansas,SUMNER,23638,21355,205,1230,2283,0.903418225,0.052034859,0.096581775
Kansas,THOMAS,7925,7252,143,427,673,0.915078864,0.053880126,0.084921136
Kansas,TREGO,2951,2808,8,64,143,0.95154185,0.021687564,0.04845815
Kansas,WABAUNSEE,6997,6553,16,225,444,0.936544233,0.032156639,0.063455767
Kansas,WALLACE,1595,1545,0,48,50,0.968652038,0.030094044,0.031347962
Kansas,WASHINGTON,5686,5372,43,186,314,0.944776644,0.032711924,0.055223356
Kansas,WICHITA,2204,1509,0,646,695,0.684664247,0.293103448,0.315335753
Kansas,WILSON,9061,8417,14,250,644,0.928926167,0.027590774,0.071073833
Kansas,WOODSON,3211,3019,17,84,192,0.940205543,0.026160075,0.059794457
Kansas,WYANDOTTE,160806,68467,38408,43668,92339,0.425773914,0.271557031,0.574226086
Kentucky,ADAIR,18852,17673,516,346,1179,0.937460216,0.01835349,0.062539784
Kentucky,ALLEN,20355,19451,276,369,904,0.955588308,0.018128224,0.044411692
Kentucky,ANDERSON,21761,20544,507,326,1217,0.944074261,0.014980929,0.055925739
Kentucky,BALLARD,8256,7714,279,101,542,0.934350775,0.012233527,0.065649225
Kentucky,BARREN,42925,39017,1758,1238,3908,0.908957484,0.028841002,0.091042516
Kentucky,BATH,11978,11466,196,166,512,0.957254967,0.013858741,0.042745033
Kentucky,BELL,27950,26442,897,130,1508,0.946046512,0.004651163,0.053953488
Kentucky,BOONE,124617,110662,3667,4858,13955,0.888016884,0.038983445,0.111983116
Kentucky,BOURBON,20013,17025,1427,1379,2988,0.850697047,0.068905212,0.149302953
Kentucky,BOYD,48917,45759,1313,747,3158,0.935441666,0.015270765,0.064558334
Kentucky,BOYLE,29388,25383,2026,899,4005,0.863719886,0.030590717,0.136280114
Kentucky,BRACKEN,8425,8291,2,121,134,0.984094955,0.014362018,0.015905045
Kentucky,BREATHITT,13591,13229,66,63,362,0.973364727,0.00463542,0.026635273
Kentucky,BRECKINRIDGE,20061,19016,466,240,1045,0.947908878,0.011963511,0.052091122
Kentucky,BULLITT,76961,73319,361,1255,3642,0.95267733,0.016306961,0.04732267
Kentucky,BUTLER,12835,12274,87,447,561,0.956291391,0.034826646,0.043708609
Kentucky,CALDWELL,12826,11718,747,182,1108,0.913612974,0.014189927,0.086387026
Kentucky,CALLOWAY,38106,34153,1489,954,3953,0.896263056,0.025035427,0.103736944
Kentucky,CAMPBELL,91475,84635,2926,1636,6840,0.925225471,0.017884668,0.074774529
Kentucky,CARLISLE,4984,4718,78,110,266,0.946629213,0.022070626,0.053370787
Kentucky,CARROLL,10830,9626,259,736,1204,0.888827331,0.067959372,0.111172669
Kentucky,CARTER,27326,26433,224,341,893,0.967320501,0.012478958,0.032679499
Kentucky,CASEY,15954,15196,127,437,758,0.952488404,0.02739125,0.047511596
Kentucky,CHRISTIAN,74159,50023,14316,5251,24136,0.674537143,0.070807319,0.325462857
Kentucky,CLARK,35657,32246,1872,990,3411,0.904338559,0.027764534,0.095661441
Kentucky,CLAY,21300,19752,817,374,1548,0.927323944,0.017558685,0.072676056
Kentucky,CLINTON,10188,9810,58,270,378,0.962897527,0.026501767,0.037102473
Kentucky,CRITTENDEN,9222,8922,113,64,300,0.967469096,0.006939926,0.032530904
Kentucky,CUMBERLAND,6807,6445,202,11,362,0.946819451,0.001615984,0.053180549
Kentucky,DAVIESS,98173,87770,4411,2683,10403,0.894034001,0.027329306,0.105965999
Kentucky,EDMONSON,12105,11603,178,194,502,0.958529533,0.016026435,0.041470467
Kentucky,ELLIOTT,7725,7467,189,45,258,0.966601942,0.005825243,0.033398058
Kentucky,ESTILL,14476,14172,20,9,304,0.978999724,0.000621719,0.021000276
Kentucky,FAYETTE,308306,223356,44155,21138,84950,0.72446206,0.068561754,0.27553794
Kentucky,FLEMING,14544,13990,201,177,554,0.961908691,0.012169967,0.038091309
Kentucky,FLOYD,38649,37648,311,266,1001,0.974100235,0.006882455,0.025899765
Kentucky,FRANKLIN,49778,40906,5160,1452,8872,0.821768653,0.029169513,0.178231347
Kentucky,FULTON,6422,4589,1598,94,1833,0.714574899,0.014637185,0.285425101
Kentucky,GALLATIN,8567,7841,96,432,726,0.915256216,0.050426053,0.084743784
Kentucky,GARRARD,16976,15997,216,394,979,0.942330349,0.023209237,0.057669651
Kentucky,GRANT,24670,23247,78,609,1423,0.942318606,0.024685853,0.057681394
Kentucky,GRAVES,37502,32700,1866,2228,4802,0.871953496,0.059410165,0.128046504
Kentucky,GRAYSON,26001,24838,300,315,1163,0.955270951,0.012114919,0.044729049
Kentucky,GREEN,11149,10547,339,22,602,0.946004126,0.001973271,0.053995874
Kentucky,GREENUP,36477,35144,281,369,1333,0.963456425,0.010115963,0.036543575
Kentucky,HANCOCK,8669,8320,83,123,349,0.959741608,0.014188488,0.040258392
Kentucky,HARDIN,107529,82235,12090,5976,25294,0.764770434,0.055575705,0.235229566
Kentucky,HARLAN,28400,27046,685,240,1354,0.952323944,0.008450704,0.047676056
Kentucky,HARRISON,18648,17499,395,394,1149,0.938384813,0.021128271,0.061615187
Kentucky,HART,18441,16961,868,296,1480,0.919744049,0.01605119,0.080255951
Kentucky,HENDERSON,46396,40372,3304,1014,6024,0.870161221,0.021855332,0.129838779
Kentucky,HENRY,15455,14194,539,496,1261,0.918408282,0.032093174,0.081591718
Kentucky,HICKMAN,4720,4135,430,45,585,0.876059322,0.009533898,0.123940678
Kentucky,HOPKINS,46518,41386,2765,837,5132,0.889677114,0.017993035,0.110322886
Kentucky,JACKSON,13357,13300,6,16,57,0.995732575,0.001197874,0.004267425
Kentucky,JEFFERSON,755809,525430,154852,35322,230379,0.695188864,0.046734029,0.304811136
Kentucky,JESSAMINE,50328,45519,1800,1445,4809,0.904446829,0.028711652,0.095553171
Kentucky,JOHNSON,23350,22805,97,114,545,0.976659529,0.004882227,0.023340471
Kentucky,KENTON,163007,145329,7341,4737,17678,0.89155067,0.029060102,0.10844933
Kentucky,KNOTT,16000,15601,131,123,399,0.9750625,0.0076875,0.0249375
Kentucky,KNOX,31809,30609,364,340,1200,0.962274828,0.010688799,0.037725172
Kentucky,LARUE,14149,13009,495,425,1140,0.919428935,0.030037458,0.080571065
Kentucky,LAUREL,59751,57331,516,841,2420,0.959498586,0.014075078,0.040501414
Kentucky,LAWRENCE,15821,15468,24,106,353,0.977687883,0.006699956,0.022312117
Kentucky,LEE,7119,6867,67,54,252,0.96460177,0.007585335,0.03539823
Kentucky,LESLIE,10997,10840,75,49,157,0.985723379,0.004455761,0.014276621
Kentucky,LETCHER,23671,23175,45,165,496,0.97904609,0.006970555,0.02095391
Kentucky,LEWIS,13790,13521,36,92,269,0.980493111,0.006671501,0.019506889
Kentucky,LINCOLN,24498,23130,657,384,1368,0.944158707,0.015674749,0.055841293
Kentucky,LIVINGSTON,9394,9043,16,140,351,0.962635725,0.01490313,0.037364275
Kentucky,LOGAN,26851,23792,1722,728,3059,0.886075007,0.027112584,0.113924993
Kentucky,LYON,8402,7663,517,61,739,0.912044751,0.007260176,0.087955249
Kentucky,MCCRACKEN,65408,54765,7039,1492,10643,0.837282901,0.022810665,0.162717099
Kentucky,MCCREARY,18001,16181,1006,402,1820,0.898894506,0.022332093,0.101105494
Kentucky,MCLEAN,9500,9166,42,126,334,0.964842105,0.013263158,0.035157895
Kentucky,MADISON,85838,77335,3816,1933,8503,0.900941308,0.022519164,0.099058692
Kentucky,MAGOFFIN,12979,12914,11,45,65,0.99499191,0.003467139,0.00500809
Kentucky,MARION,19717,17203,1685,501,2514,0.872495816,0.025409545,0.127504184
Kentucky,MARSHALL,31181,30252,130,395,929,0.970206215,0.012667971,0.029793785
Kentucky,MARTIN,12631,11766,597,191,865,0.931517695,0.015121526,0.068482305
Kentucky,MASON,17296,15490,1177,65,1806,0.895582794,0.003758094,0.104417206
Kentucky,MEADE,29098,25879,1081,1132,3219,0.88937384,0.038903017,0.11062616
Kentucky,MENIFEE,6343,6095,26,144,248,0.960901781,0.022702191,0.039098219
Kentucky,MERCER,21342,19547,804,519,1795,0.915893543,0.024318246,0.084106457
Kentucky,METCALFE,9985,9380,110,150,605,0.939409114,0.015022534,0.060590886
Kentucky,MONROE,10765,10078,276,320,687,0.936182072,0.029725964,0.063817928
Kentucky,MONTGOMERY,27167,25303,797,687,1864,0.931387345,0.025288033,0.068612655
Kentucky,MORGAN,13428,12569,434,140,859,0.936029193,0.010425976,0.063970807
Kentucky,MUHLENBERG,31309,28924,1642,154,2385,0.923823821,0.004918713,0.076176179
Kentucky,NELSON,44564,40407,2322,925,4157,0.906718427,0.020756665,0.093281573
Kentucky,NICHOLAS,7075,6820,104,50,255,0.963957597,0.007067138,0.036042403
Kentucky,OHIO,24065,22658,328,890,1407,0.941533347,0.036983171,0.058466653
Kentucky,OLDHAM,63037,55821,2613,2405,7216,0.885527547,0.038152196,0.114472453
Kentucky,OWEN,10711,10201,170,264,510,0.952385398,0.024647559,0.047614602
Kentucky,OWSLEY,4616,4411,50,24,205,0.955589255,0.005199307,0.044410745
Kentucky,PENDLETON,14514,14095,83,159,419,0.971131321,0.01095494,0.028868679
Kentucky,PERRY,28041,26879,402,170,1162,0.958560679,0.006062551,0.041439321
Kentucky,PIKE,63434,61664,558,493,1770,0.972096983,0.007771857,0.027903017
Kentucky,POWELL,12447,12051,51,159,396,0.968185105,0.012774162,0.031814895
Kentucky,PULASKI,63635,60113,589,1443,3522,0.9446531,0.0226762,0.0553469
Kentucky,ROBERTSON,2208,2188,0,0,20,0.990942029,0,0.009057971
Kentucky,ROCKCASTLE,16942,16545,33,103,397,0.976567111,0.006079566,0.023432889
Kentucky,ROWAN,23608,22265,402,273,1343,0.943112504,0.011563877,0.056887496
Kentucky,RUSSELL,17669,16652,49,625,1017,0.942441564,0.035372687,0.057558436
Kentucky,SCOTT,50178,43834,2596,2136,6344,0.87357009,0.042568456,0.12642991
Kentucky,SHELBY,44290,35714,3164,3909,8576,0.806367126,0.088259201,0.193632874
Kentucky,SIMPSON,17704,15113,1830,352,2591,0.853648893,0.019882512,0.146351107
Kentucky,SPENCER,17577,16631,235,320,946,0.946179667,0.01820561,0.053820333
Kentucky,TAYLOR,24993,22597,1002,514,2396,0.904133157,0.020565758,0.095866843
Kentucky,TODD,12524,10692,1053,504,1832,0.853720856,0.040242734,0.146279144
Kentucky,TRIGG,14250,12578,1253,235,1672,0.882666667,0.016491228,0.117333333
Kentucky,TRIMBLE,8783,8470,0,263,313,0.964362974,0.02994421,0.035637026
Kentucky,UNION,15138,12561,1959,273,2577,0.829766151,0.018034086,0.170233849
Kentucky,WARREN,118950,95831,11128,5842,23119,0.805641026,0.049113073,0.194358974
Kentucky,WASHINGTON,11910,10511,704,440,1399,0.882535684,0.036943745,0.117464316
Kentucky,WAYNE,20655,19389,434,604,1266,0.938707335,0.029242314,0.061292665
Kentucky,WEBSTER,13357,11915,593,608,1442,0.892041626,0.045519203,0.107958374
Kentucky,WHITLEY,35794,34385,324,371,1409,0.960635861,0.010364866,0.039364139
Kentucky,WOLFE,7261,7140,26,35,121,0.983335629,0.004820273,0.016664371
Kentucky,WOODFORD,25317,21839,1186,1665,3478,0.862621954,0.065766086,0.137378046
Louisiana,ACADIA PARISH,62163,48303,10829,1285,13860,0.777037788,0.020671461,0.222962212
Louisiana,ALLEN PARISH,25653,18092,5101,1011,7561,0.705258644,0.039410595,0.294741356
Louisiana,ASCENSION PARISH,114738,80048,25031,5732,34690,0.697659014,0.049957294,0.302340986
Louisiana,ASSUMPTION PARISH,23057,15273,6885,544,7784,0.662401874,0.023593703,0.337598126
Louisiana,AVOYELLES PARISH,41389,27230,12323,705,14159,0.657904274,0.017033511,0.342095726
Louisiana,BEAUREGARD PARISH,36259,28870,4732,1263,7389,0.796216112,0.034832731,0.203783888
Louisiana,BIENVILLE PARISH,13977,7636,5854,223,6341,0.546326107,0.015954783,0.453673893
Louisiana,BOSSIER PARISH,123403,84261,26120,7840,39142,0.682811601,0.063531681,0.317188399
Louisiana,CADDO PARISH,254742,118726,121521,6881,136016,0.466063704,0.027011643,0.533936296
Louisiana,CALCASIEU PARISH,195887,134615,48319,5736,61272,0.687207421,0.029282188,0.312792579
Louisiana,CALDWELL PARISH,9990,7875,1743,266,2115,0.788288288,0.026626627,0.211711712
Louisiana,CAMERON PARISH,6706,6186,206,282,520,0.922457501,0.042051894,0.077542499
Louisiana,CATAHOULA PARISH,10247,6743,3292,112,3504,0.658046257,0.010930028,0.341953743
Louisiana,CLAIBORNE PARISH,16639,7688,8324,228,8951,0.462046998,0.013702747,0.537953002
Louisiana,CONCORDIA PARISH,20449,11664,8406,239,8785,0.57039464,0.011687613,0.42960536
Louisiana,DE SOTO PARISH,26965,15430,10158,727,11535,0.572223252,0.026960875,0.427776748
Louisiana,EAST BATON ROUGE PARISH,444690,204045,201634,17142,240645,0.458847737,0.038548202,0.541152263
Louisiana,EAST CARROLL PARISH,7501,2108,5229,99,5393,0.281029196,0.01319824,0.718970804
Louisiana,EAST FELICIANA PARISH,19855,10489,8885,255,9366,0.52828003,0.012843113,0.47171997
Louisiana,EVANGELINE PARISH,33768,22801,9366,958,10967,0.675225065,0.028370054,0.324774935
Louisiana,FRANKLIN PARISH,20550,13536,6724,78,7014,0.658686131,0.00379562,0.341313869
Louisiana,GRANT PARISH,22362,17082,3146,1395,5280,0.763885162,0.062382613,0.236114838
Louisiana,IBERIA PARISH,73938,44168,23221,2761,29770,0.59736536,0.037342097,0.40263464
Louisiana,IBERVILLE PARISH,33229,15899,15952,790,17330,0.478467604,0.023774414,0.521532396
Louisiana,JACKSON PARISH,16109,10714,4860,247,5395,0.665094047,0.015333044,0.334905953
Louisiana,JEFFERSON PARISH,435092,236758,112504,58988,198334,0.544156178,0.135575924,0.455843822
Louisiana,JEFFERSON DAVIS PARISH,31434,24574,5376,658,6860,0.781764968,0.020932748,0.218235032
Louisiana,LAFAYETTE PARISH,231811,154441,59075,9996,77370,0.666236719,0.043121336,0.333763281
Louisiana,LAFOURCHE PARISH,97474,75082,12989,4153,22392,0.770277202,0.042606233,0.229722798
Louisiana,LASALLE PARISH,14899,12403,1671,581,2496,0.832471978,0.038995906,0.167528022
Louisiana,LINCOLN PARISH,47349,25227,19131,1277,22122,0.532788443,0.026969947,0.467211557
Louisiana,LIVINGSTON PARISH,133949,118839,8204,4452,15110,0.887195873,0.03323653,0.112804127
Louisiana,MADISON PARISH,11873,4171,7358,208,7702,0.351301272,0.01751874,0.648698728
Louisiana,MOREHOUSE PARISH,27012,13461,12774,322,13551,0.498334074,0.011920628,0.501665926
Louisiana,NATCHITOCHES PARISH,39330,21003,15921,815,18327,0.534019832,0.020722095,0.465980168
Louisiana,ORLEANS PARISH,376738,116141,222313,20601,260597,0.308280556,0.054682565,0.691719444
Louisiana,OUACHITA PARISH,155769,91475,57939,3209,64294,0.587247784,0.020601018,0.412752216
Louisiana,PLAQUEMINES PARISH,23599,15692,4884,1418,7907,0.66494343,0.060087292,0.33505657
Louisiana,POINTE COUPEE PARISH,22498,13550,8077,540,8948,0.602275758,0.024002134,0.397724242
Louisiana,RAPIDES PARISH,132225,81538,42202,3704,50687,0.616660995,0.028012857,0.383339005
Louisiana,RED RIVER PARISH,8838,5110,3446,130,3728,0.57818511,0.01470921,0.42181489
Louisiana,RICHLAND PARISH,20777,12676,7492,422,8101,0.610097704,0.020310921,0.389902296
Louisiana,SABINE PARISH,24248,16597,4039,905,7651,0.684468822,0.037322666,0.315531178
Louisiana,ST. BERNARD PARISH,42858,27818,9091,4133,15040,0.649073685,0.096434738,0.350926315
Louisiana,ST. CHARLES PARISH,52639,34590,13759,2971,18049,0.657117346,0.056441042,0.342882654
Louisiana,ST. HELENA PARISH,10818,4805,5699,16,6013,0.444167129,0.001479016,0.555832871
Louisiana,ST. JAMES PARISH,21650,10364,10835,333,11286,0.478706697,0.015381062,0.521293303
Louisiana,ST. JOHN THE BAPTIST PARISH,44161,16788,23942,2333,27373,0.380154435,0.05282942,0.619845565
Louisiana,ST. LANDRY PARISH,83613,46104,34148,1549,37509,0.55139751,0.018525827,0.44860249
Louisiana,ST. MARTIN PARISH,53126,34383,15718,1311,18743,0.647197229,0.024677183,0.352802771
Louisiana,ST. MARY PARISH,53441,30219,16599,3291,23222,0.565464718,0.061581931,0.434535282
Louisiana,ST. TAMMANY PARISH,242960,193148,28314,12583,49812,0.794978597,0.051790418,0.205021403
Louisiana,TANGIPAHOA PARISH,125486,80213,37144,4785,45273,0.639218718,0.038131744,0.360781282
Louisiana,TENSAS PARISH,4893,2041,2746,82,2852,0.417126507,0.016758635,0.582873493
Louisiana,TERREBONNE PARISH,112742,76512,20770,5230,36230,0.678646822,0.046389101,0.321353178
Louisiana,UNION PARISH,22533,15354,5821,974,7179,0.681400612,0.043225492,0.318599388
Louisiana,VERMILION PARISH,59110,46553,8328,1772,12557,0.787565556,0.029978007,0.212434444
Louisiana,VERNON PARISH,52476,36979,7293,4713,15497,0.704684046,0.089812486,0.295315954
Louisiana,WASHINGTON PARISH,46556,30680,14027,954,15876,0.658991322,0.020491451,0.341008678
Louisiana,WEBSTER PARISH,40617,25436,13784,725,15181,0.626240244,0.017849669,0.373759756
Louisiana,WEST BATON ROUGE PARISH,24669,14181,9296,678,10488,0.574851028,0.027483887,0.425148972
Louisiana,WEST CARROLL PARISH,11454,9120,1910,332,2334,0.796228392,0.028985507,0.203771608
Louisiana,WEST FELICIANA PARISH,15415,7972,7041,232,7443,0.517158612,0.015050276,0.482841388
Louisiana,WINN PARISH,14855,9703,4838,88,5152,0.653180747,0.005923931,0.346819253
Maine,ANDROSCOGGIN,107393,98220,1413,1827,9173,0.914584749,0.017012282,0.085415251
Maine,AROOSTOOK,70005,66253,505,767,3752,0.946403828,0.01095636,0.053596172
Maine,CUMBERLAND,286119,260732,7297,5450,25387,0.911271184,0.019048018,0.088728816
Maine,FRANKLIN,30402,29221,134,379,1181,0.961153871,0.012466285,0.038846129
Maine,HANCOCK,54658,52147,263,715,2511,0.95405979,0.013081342,0.04594021
Maine,KENNEBEC,121112,115191,934,1684,5921,0.951111368,0.013904485,0.048888632
Maine,KNOX,39723,38106,258,462,1617,0.959293105,0.011630541,0.040706895
Maine,LINCOLN,34156,32924,39,323,1232,0.963930203,0.009456611,0.036069797
Maine,OXFORD,57421,55035,227,652,2386,0.958447258,0.011354731,0.041552742
Maine,PENOBSCOT,153437,144593,1250,1841,8844,0.942360708,0.01199841,0.057639292
Maine,PISCATAQUIS,17156,16426,57,211,730,0.957449289,0.012298904,0.042550711
Maine,SAGADAHOC,35092,33277,249,525,1815,0.94827881,0.014960675,0.05172119
Maine,SOMERSET,51577,49580,168,506,1997,0.961281191,0.009810574,0.038718809
Maine,WALDO,38976,37443,171,447,1533,0.960668103,0.011468596,0.039331897
Maine,WASHINGTON,32191,29128,169,553,3063,0.904849181,0.017178715,0.095150819
Maine,YORK,199682,189532,1339,3105,10150,0.949169179,0.015549724,0.050830821
Maryland,ALLEGANY,73549,64455,5778,1184,9094,0.876354539,0.016098111,0.123645461
Maryland,ANNE ARUNDEL,555280,392444,86074,38114,162836,0.706749748,0.068639245,0.293250252
Maryland,BALTIMORE,822959,495942,219731,39642,327017,0.602632695,0.048170079,0.397367305
Maryland,CALVERT,90114,71415,11334,2982,18699,0.792496172,0.033091418,0.207503828
Maryland,CAROLINE,32661,25218,4449,1985,7443,0.77211353,0.060775849,0.22788647
Maryland,CARROLL,167444,151303,5296,4864,16141,0.903603593,0.029048518,0.096396407
Maryland,CECIL,101960,87838,6743,3984,14122,0.861494704,0.039074147,0.138505296
Maryland,CHARLES,152754,69387,63812,7651,83367,0.454240151,0.050087068,0.545759849
Maryland,DORCHESTER,32534,21082,9027,1413,11452,0.647999016,0.043431487,0.352000984
Maryland,FREDERICK,241373,183419,21085,19549,57954,0.75989858,0.080990832,0.24010142
Maryland,GARRETT,29813,28844,180,279,969,0.9674974,0.009358334,0.0325026
Maryland,HARFORD,248966,193288,32164,9959,55678,0.776363038,0.040001446,0.223636962
Maryland,HOWARD,304115,170615,54027,19032,133500,0.561021324,0.062581589,0.438978676
Maryland,KENT,19923,15620,3009,858,4303,0.784018471,0.043065803,0.215981529
Maryland,MONTGOMERY,1017859,474107,174395,186225,543752,0.465788483,0.182957561,0.534211517
Maryland,PRINCE GEORGE'S,892816,127687,558578,144996,765129,0.14301603,0.162403004,0.85698397
Maryland,QUEEN ANNE'S,48600,42200,3584,1639,6400,0.868312757,0.03372428,0.131687243
Maryland,ST. MARY'S,109614,82878,15428,4939,26736,0.756089551,0.045058113,0.243910449
Maryland,SOMERSET,25980,13429,10743,925,12551,0.516897614,0.035604311,0.483102386
Maryland,TALBOT,37799,29553,4440,2256,8246,0.781846081,0.059684119,0.218153919
Maryland,WASHINGTON,149270,121625,14450,6020,27645,0.814798687,0.040329604,0.185201313
Maryland,WICOMICO,101182,65752,24259,4993,35430,0.649838904,0.049346722,0.350161096
Maryland,WORCESTER,51519,41198,7184,1690,10321,0.799666143,0.032803432,0.200333857
Maryland,BALTIMORE CITY,622454,174785,387565,28492,447669,0.280799866,0.045773664,0.719200134
Massachusetts,BARNSTABLE,214766,195568,5355,5551,19198,0.910609687,0.025846736,0.089390313
Massachusetts,BERKSHIRE,129288,116006,3427,5080,13282,0.897268115,0.039292123,0.102731885
Massachusetts,BRISTOL,552763,465443,18386,37322,87320,0.842029948,0.067518991,0.157970052
Massachusetts,DUKES,17048,15706,537,133,1342,0.921281089,0.007801502,0.078718911
Massachusetts,ESSEX,763849,562176,22419,138848,201673,0.735977922,0.181774146,0.264022078
Massachusetts,FRANKLIN,71144,65185,772,2576,5959,0.916240301,0.036208254,0.083759699
Massachusetts,HAMPDEN,468041,305962,36357,106386,162079,0.653707688,0.2273006,0.346292312
Massachusetts,HAMPSHIRE,160759,136536,4174,8272,24223,0.849321033,0.051455906,0.150678967
Massachusetts,MIDDLESEX,1556116,1162938,71251,113745,393178,0.747333746,0.07309545,0.252666254
Massachusetts,NANTUCKET,10556,8090,984,1074,2466,0.766388784,0.101743085,0.233611216
Massachusetts,NORFOLK,687721,537263,41513,26416,150458,0.781222327,0.038410925,0.218777673
Massachusetts,PLYMOUTH,503681,417802,43277,17786,85879,0.829497241,0.035312033,0.170502759
Massachusetts,SUFFOLK,758919,352694,151997,161935,406225,0.464732073,0.213375868,0.535267927
Massachusetts,WORCESTER,810935,640956,33877,82804,169979,0.790391338,0.102109294,0.209608662
Michigan,ALCONA,10550,10162,29,143,388,0.963222749,0.013554502,0.036777251
Michigan,ALGER,9476,8039,733,123,1437,0.848353736,0.01298016,0.151646264
Michigan,ALLEGAN,112837,100510,1582,7861,12327,0.890753919,0.069666865,0.109246081
Michigan,ALPENA,29068,27934,144,363,1134,0.960988028,0.012487959,0.039011972
Michigan,ANTRIM,23267,22144,73,450,1123,0.951734216,0.019340697,0.048265784
Michigan,ARENAC,15424,14676,73,281,748,0.951504149,0.018218361,0.048495851
Michigan,BARAGA,8690,6372,1591,113,2318,0.733256617,0.013003452,0.266743383
Michigan,BARRY,59147,56123,284,1499,3024,0.948873147,0.025343635,0.051126853
Michigan,BAY,106698,96695,1342,5295,10003,0.906249414,0.049626047,0.093750586
Michigan,BENZIE,17437,16447,58,366,990,0.943224178,0.020989849,0.056775822
Michigan,BERRIEN,155565,117151,23146,7760,38414,0.753067849,0.049882686,0.246932151
Michigan,BRANCH,43706,39884,1002,1861,3822,0.912552052,0.042579966,0.087447948
Michigan,CALHOUN,134790,106614,14450,6339,28176,0.790963721,0.047028711,0.209036279
Michigan,CASS,51952,45131,2432,1724,6821,0.868705728,0.033184478,0.131294272
Michigan,CHARLEVOIX,26134,24656,82,431,1478,0.94344532,0.016491926,0.05655468
Michigan,CHEBOYGAN,25690,23727,169,324,1963,0.923588945,0.012611911,0.076411055
Michigan,CHIPPEWA,38586,27288,2497,626,11298,0.707199502,0.016223501,0.292800498
Michigan,CLARE,30710,29216,112,567,1494,0.951351351,0.018463041,0.048648649
Michigan,CLINTON,76905,69423,1199,3314,7482,0.902711137,0.043092127,0.097288863
Michigan,CRAWFORD,13895,13264,64,233,631,0.954587981,0.016768622,0.045412019
Michigan,DELTA,36712,34397,89,383,2315,0.936941599,0.010432556,0.063058401
Michigan,DICKINSON,26012,24941,127,336,1071,0.958826695,0.012917115,0.041173305
Michigan,EATON,108341,90840,6804,5551,17501,0.838463739,0.051236374,0.161536261
Michigan,EMMET,33018,30212,219,506,2806,0.915016052,0.015324974,0.084983948
Michigan,GENESEE,415874,301485,84325,13308,114389,0.724943132,0.032000077,0.275056868
Michigan,GLADWIN,25501,24620,92,331,881,0.965452335,0.012979883,0.034547665
Michigan,GOGEBIC,15824,14264,713,183,1560,0.901415571,0.011564712,0.098584429
Michigan,GRAND TRAVERSE,89907,83398,1183,2324,6509,0.927602968,0.025848933,0.072397032
Michigan,GRATIOT,41878,36382,2338,2335,5496,0.868761641,0.055757199,0.131238359
Michigan,HILLSDALE,46178,44048,272,939,2130,0.953874139,0.020334358,0.046125861
Michigan,HOUGHTON,36660,33941,261,526,2719,0.925831969,0.014348063,0.074168031
Michigan,HURON,32290,30908,128,685,1382,0.957200372,0.021213998,0.042799628
Michigan,INGHAM,283491,202018,30518,21352,81473,0.71260816,0.075318088,0.28739184
Michigan,IONIA,64064,56612,1956,2982,7452,0.883678821,0.046547203,0.116321179
Michigan,IOSCO,25401,24022,154,505,1379,0.945710799,0.019881107,0.054289201
Michigan,IRON,11507,10982,48,194,525,0.954375597,0.016859303,0.045624403
Michigan,ISABELLA,70669,61038,1807,2589,9631,0.863716764,0.036635583,0.136283236
Michigan,JACKSON,159759,136056,13412,5228,23703,0.851632772,0.032724291,0.148367228
Michigan,KALAMAZOO,256752,202052,27220,11603,54700,0.786953948,0.045191469,0.213046052
Michigan,KALKASKA,17230,16359,118,287,871,0.949448636,0.016656994,0.050551364
Michigan,KENT,622590,467375,58165,62524,155215,0.750694679,0.100425641,0.249305321
Michigan,KEWEENAW,2198,2150,13,20,48,0.978161965,0.009099181,0.021838035
Michigan,LAKE,11426,9770,902,280,1656,0.85506739,0.024505514,0.14493261
Michigan,LAPEER,88235,81480,1113,3917,6755,0.923443078,0.044392815,0.076556922
Michigan,LEELANAU,21772,19710,120,863,2062,0.9052912,0.039638067,0.0947088
Michigan,LENAWEE,98902,86348,2225,7512,12554,0.873066268,0.075953975,0.126933732
Michigan,LIVINGSTON,184591,175020,855,3990,9571,0.948150235,0.021615355,0.051849765
Michigan,LUCE,6477,5128,538,168,1349,0.791724564,0.025937934,0.208275436
Michigan,MACKINAC,11044,8258,188,160,2786,0.747736327,0.014487505,0.252263673
Michigan,MACOMB,854689,695737,87282,20793,158952,0.814023581,0.024328147,0.185976419
Michigan,MANISTEE,24536,22006,712,695,2530,0.896886208,0.028325725,0.103113792
Michigan,MARQUETTE,67582,62531,1091,941,5051,0.925261164,0.013923826,0.074738836
Michigan,MASON,28711,26398,257,1240,2313,0.919438543,0.043189022,0.080561457
Michigan,MECOSTA,43301,39691,1178,878,3610,0.916630101,0.020276668,0.083369899
Michigan,MENOMINEE,23717,22213,63,373,1504,0.936585572,0.015727116,0.063414428
Michigan,MIDLAND,83624,76855,1145,2004,6769,0.919054338,0.023964412,0.080945662
Michigan,MISSAUKEE,14988,14222,59,372,766,0.948892447,0.024819856,0.051107553
Michigan,MONROE,150436,138288,3478,4989,12148,0.919248052,0.033163604,0.080751948
Michigan,MONTCALM,63004,58045,1286,2067,4959,0.921290712,0.032807441,0.078709288
Michigan,MONTMORENCY,9401,9051,34,114,350,0.962769918,0.01212637,0.037230082
Michigan,MUSKEGON,171483,131944,23391,8888,39539,0.76942904,0.051830211,0.23057096
Michigan,NEWAYGO,48029,43526,650,2760,4503,0.906244144,0.057465281,0.093755856
Michigan,OAKLAND,1229503,904261,169203,45569,325242,0.735468722,0.037062943,0.264531278
Michigan,OCEANA,26229,21674,314,3737,4555,0.82633726,0.142475885,0.17366274
Michigan,OGEMAW,21222,20256,66,387,966,0.954481199,0.018235793,0.045518801
Michigan,ONTONAGON,6298,6032,20,67,266,0.95776437,0.010638298,0.04223563
Michigan,OSCEOLA,23234,22132,181,365,1102,0.95256951,0.015709736,0.04743049
Michigan,OSCODA,8444,8109,37,106,335,0.960326859,0.012553292,0.039673141
Michigan,OTSEGO,24141,22925,85,366,1216,0.949629261,0.01516093,0.050370739
Michigan,OTTAWA,273136,231373,3801,25204,41763,0.847098149,0.092276375,0.152901851
Michigan,PRESQUE ISLE,13037,12564,60,138,473,0.963718647,0.010585257,0.036281353
Michigan,ROSCOMMON,24068,23011,48,332,1057,0.956082765,0.01379425,0.043917235
Michigan,SAGINAW,196479,137535,35577,15862,58944,0.699998473,0.080731274,0.300001527
Michigan,ST. CLAIR,160429,147039,3512,4978,13390,0.916536287,0.031029303,0.083463713
Michigan,ST. JOSEPH,61022,53230,1683,4390,7792,0.872308348,0.071941267,0.127691652
Michigan,SANILAC,42014,39586,208,1525,2428,0.94220974,0.036297425,0.05779026
Michigan,SCHOOLCRAFT,8288,7150,41,75,1138,0.86269305,0.009049228,0.13730695
Michigan,SHIAWASSEE,69113,65296,317,1884,3817,0.944771606,0.027259705,0.055228394
Michigan,TUSCOLA,54420,51058,593,1726,3362,0.938221242,0.031716281,0.061778758
Michigan,VAN BUREN,75351,61697,2626,8195,13654,0.818794707,0.108757681,0.181205293
Michigan,WASHTENAW,354092,251417,42294,15474,102675,0.710032986,0.043700507,0.289967014
Michigan,WAYNE,1778969,886399,698192,98692,892570,0.498265568,0.055477077,0.501734432
Michigan,WEXFORD,32751,31101,183,581,1650,0.949619859,0.017739916,0.050380141
Minnesota,AITKIN,15839,14950,55,178,889,0.943872719,0.011238083,0.056127281
Minnesota,ANOKA,338764,283909,16432,13252,54855,0.838073113,0.039118678,0.161926887
Minnesota,BECKER,33138,28778,166,582,4360,0.868428994,0.017562919,0.131571006
Minnesota,BELTRAMI,45434,33342,347,869,12092,0.733855703,0.019126645,0.266144297
Minnesota,BENTON,39221,36353,912,745,2868,0.926875908,0.018994926,0.073124092
Minnesota,BIG STONE,5134,4987,10,57,147,0.971367355,0.011102454,0.028632645
Minnesota,BLUE EARTH,65125,58430,1977,1920,6695,0.897197697,0.029481766,0.102802303
Minnesota,BROWN,25391,23997,113,951,1394,0.945098657,0.037454216,0.054901343
Minnesota,CARLTON,35443,31387,423,579,4056,0.885562735,0.016336089,0.114437265
Minnesota,CARVER,95715,86114,1099,3908,9601,0.899691793,0.040829546,0.100308207
Minnesota,CASS,28519,24010,90,465,4509,0.841894877,0.01630492,0.158105123
Minnesota,CHIPPEWA,12154,10941,97,690,1213,0.900197466,0.056771433,0.099802534
Minnesota,CHISAGO,53834,50697,618,979,3137,0.941728276,0.018185533,0.058271724
Minnesota,CLAY,60879,54616,1175,2467,6263,0.897123803,0.040523005,0.102876197
Minnesota,CLEARWATER,8752,7507,22,138,1245,0.857746801,0.015767824,0.142253199
Minnesota,COOK,5194,4491,47,89,703,0.864651521,0.017135156,0.135348479
Minnesota,COTTONWOOD,11632,10196,65,818,1436,0.876547455,0.070323246,0.123452545
Minnesota,CROW WING,63048,60194,401,820,2854,0.954732902,0.013005964,0.045267098
Minnesota,DAKOTA,408456,329985,20801,26324,78471,0.807883836,0.064447578,0.192116164
Minnesota,DODGE,20290,18877,109,983,1413,0.930359783,0.048447511,0.069640217
Minnesota,DOUGLAS,36620,35366,202,489,1254,0.965756417,0.013353359,0.034243583
Minnesota,FARIBAULT,14230,13102,49,868,1128,0.92073085,0.060997892,0.07926915
Minnesota,FILLMORE,20843,20286,83,235,557,0.9732764,0.011274769,0.0267236
Minnesota,FREEBORN,30897,26950,344,2870,3947,0.87225297,0.092889277,0.12774703
Minnesota,GOODHUE,46377,42994,516,1448,3383,0.927054359,0.031222373,0.072945641
Minnesota,GRANT,5961,5736,0,105,225,0.962254655,0.017614494,0.037745345
Minnesota,HENNEPIN,1197776,843413,143509,81719,354363,0.70414919,0.068225611,0.29585081
Minnesota,HOUSTON,18812,18187,55,152,625,0.966776526,0.008079949,0.033223474
Minnesota,HUBBARD,20574,19243,110,363,1331,0.935306698,0.017643628,0.064693302
Minnesota,ISANTI,38296,36195,212,675,2101,0.945137873,0.017625862,0.054862127
Minnesota,ITASCA,45354,41852,213,555,3502,0.922785201,0.012237068,0.077214799
Minnesota,JACKSON,10211,9546,20,330,665,0.934874155,0.032318088,0.065125845
Minnesota,KANABEC,16003,15256,69,261,747,0.953321252,0.016309442,0.046678748
Minnesota,KANDIYOHI,42444,35506,1202,4909,6938,0.836537555,0.115658279,0.163462445
Minnesota,KITTSON,4480,4319,26,87,161,0.9640625,0.019419643,0.0359375
Minnesota,KOOCHICHING,13054,12227,114,10,827,0.936647771,0.000766049,0.063352229
Minnesota,LAC QUI PARLE,7023,6742,44,120,281,0.959988609,0.017086715,0.040011391
Minnesota,LAKE,10750,10348,12,134,402,0.962604651,0.012465116,0.037395349
Minnesota,LAKE OF THE WOODS,3949,3723,23,39,226,0.942770322,0.009875918,0.057229678
Minnesota,LE SUEUR,27707,25460,140,1542,2247,0.918901361,0.055653806,0.081098639
Minnesota,LINCOLN,5808,5630,22,101,178,0.969352617,0.017389807,0.030647383
Minnesota,LYON,25699,22245,729,1607,3454,0.865597883,0.062531616,0.134402117
Minnesota,MCLEOD,36046,33312,135,1900,2734,0.924152472,0.052710426,0.075847528
Minnesota,MAHNOMEN,5496,2628,30,161,2868,0.478165939,0.029294032,0.521834061
Minnesota,MARSHALL,9453,8888,25,381,565,0.940230615,0.040304665,0.059769385
Minnesota,MARTIN,20350,19138,66,798,1212,0.94044226,0.039213759,0.05955774
Minnesota,MEEKER,23129,21956,72,789,1173,0.949284448,0.034113018,0.050715552
Minnesota,MILLE LACS,25809,23207,141,469,2602,0.899182456,0.018171956,0.100817544
Minnesota,MORRISON,32962,31729,179,467,1233,0.962593289,0.01416783,0.037406711
Minnesota,MOWER,39227,32317,1186,4281,6910,0.82384582,0.109134015,0.17615418
Minnesota,MURRAY,8529,8039,30,276,490,0.942548951,0.032360183,0.057451049
Minnesota,NICOLLET,33086,29971,798,1343,3115,0.905851418,0.040591187,0.094148582
Minnesota,NOBLES,21687,13565,853,5494,8122,0.625489925,0.253331489,0.374510075
Minnesota,NORMAN,6692,6051,34,309,641,0.904213987,0.046174537,0.095786013
Minnesota,OLMSTED,148736,121949,7583,6820,26787,0.819902377,0.045853055,0.180097623
Minnesota,OTTER TAIL,57511,53897,670,1712,3614,0.937159848,0.029768218,0.062840152
Minnesota,PENNINGTON,14110,12879,221,467,1231,0.91275691,0.033097094,0.08724309
Minnesota,PINE,29218,26259,594,778,2959,0.898726812,0.026627421,0.101273188
Minnesota,PIPESTONE,9354,8526,117,438,828,0.911481719,0.046824888,0.088518281
Minnesota,POLK,31547,28069,353,1840,3478,0.889751799,0.058325673,0.110248201
Minnesota,POPE,10948,10608,60,120,340,0.968944099,0.010960906,0.031055901
Minnesota,RAMSEY,527411,340799,57303,38505,186612,0.646173478,0.073007579,0.353826522
Minnesota,RED LAKE,4061,3782,24,123,279,0.93129771,0.030288106,0.06870229
Minnesota,REDWOOD,15723,13789,107,417,1934,0.876995484,0.026521656,0.123004516
Minnesota,RENVILLE,15171,13579,115,1144,1592,0.895062949,0.075407027,0.104937051
Minnesota,RICE,64886,54743,2473,5065,10143,0.843679684,0.078059982,0.156320316
Minnesota,ROCK,9563,9062,51,233,501,0.947610582,0.024364739,0.052389418
Minnesota,ROSEAU,15615,14544,102,152,1071,0.931412104,0.00973423,0.068587896
Minnesota,ST. LOUIS,200506,183824,3060,2851,16682,0.916800495,0.014219026,0.083199505
Minnesota,SCOTT,137322,114388,3893,6428,22934,0.832991072,0.046809688,0.167008928
Minnesota,SHERBURNE,90401,83580,1740,2139,6821,0.924547295,0.023661243,0.075452705
Minnesota,SIBLEY,15021,13480,59,1228,1541,0.897410292,0.081752214,0.102589708
Minnesota,STEARNS,152595,136453,5691,4643,16142,0.894216717,0.030426947,0.105783283
Minnesota,STEELE,36523,32087,905,2600,4436,0.878542288,0.071188019,0.121457712
Minnesota,STEVENS,9771,8829,67,401,942,0.903592263,0.041039812,0.096407737
Minnesota,SWIFT,9525,8900,146,393,625,0.934383202,0.041259843,0.065616798
Minnesota,TODD,24466,22494,66,1335,1972,0.919398349,0.054565519,0.080601651
Minnesota,TRAVERSE,3429,3138,16,67,291,0.915135608,0.019539224,0.084864392
Minnesota,WABASHA,21381,20343,20,615,1038,0.951452224,0.028763856,0.048547776
Minnesota,WADENA,13759,13071,130,223,688,0.949996366,0.016207573,0.050003634
Minnesota,WASECA,19076,17079,500,1080,1997,0.895313483,0.056615643,0.104686517
Minnesota,WASHINGTON,246670,208208,9408,9235,38462,0.84407508,0.037438683,0.15592492
Minnesota,WATONWAN,11054,8335,66,2446,2719,0.754025692,0.221277366,0.245974308
Minnesota,WILKIN,6526,6181,21,152,345,0.947134539,0.02329145,0.052865461
Minnesota,WINONA,51213,47095,732,1384,4118,0.919590729,0.027024388,0.080409271
Minnesota,WRIGHT,128691,119786,1296,3435,8905,0.930803242,0.026691843,0.069196758
Minnesota,YELLOW MEDICINE,10092,9165,46,414,927,0.908145065,0.041022592,0.091854935
Mississippi,ADAMS,31979,12122,17672,1887,19857,0.379061259,0.059007474,0.620938741
Mississippi,ALCORN,37319,31064,4239,1138,6255,0.832391007,0.03049385,0.167608993
Mississippi,AMITE,12840,7349,5416,49,5491,0.572352025,0.003816199,0.427647975
Mississippi,ATTALA,19175,10555,8019,353,8620,0.550456323,0.018409387,0.449543677
Mississippi,BENTON,8470,5102,3078,185,3368,0.602361275,0.021841795,0.397638725
Mississippi,BOLIVAR,33803,11004,21648,713,22799,0.325533237,0.021092802,0.674466763
Mississippi,CALHOUN,14789,9670,3974,830,5119,0.653864359,0.056122794,0.346135641
Mississippi,CARROLL,10338,6669,3470,43,3669,0.645095763,0.004159412,0.354904237
Mississippi,CHICKASAW,17391,8986,7541,704,8405,0.516704042,0.040480708,0.483295958
Mississippi,CHOCTAW,8354,5647,2595,47,2707,0.67596361,0.005626047,0.32403639
Mississippi,CLAIBORNE,9330,1271,7854,101,8059,0.136227224,0.010825295,0.863772776
Mississippi,CLARKE,16362,10404,5731,128,5958,0.635863586,0.007823005,0.364136414
Mississippi,CLAY,20279,8023,11799,241,12256,0.395630948,0.011884215,0.604369052
Mississippi,COAHOMA,25254,5697,19138,76,19557,0.225588026,0.003009424,0.774411974
Mississippi,COPIAH,28921,13070,14683,808,15851,0.45192075,0.027938176,0.54807925
Mississippi,COVINGTON,19471,11937,6876,414,7534,0.613065585,0.02126239,0.386934415
Mississippi,DESOTO,168586,114659,40061,8401,53927,0.680121718,0.049832133,0.319878282
Mississippi,FORREST,76267,43901,27867,2528,32366,0.575622484,0.033146708,0.424377516
Mississippi,FRANKLIN,7857,4965,2816,43,2892,0.63192058,0.005472827,0.36807942
Mississippi,GEORGE,23104,20313,1832,521,2791,0.879198407,0.022550208,0.120801593
Mississippi,GREENE,14129,10082,3630,138,4047,0.713567839,0.009767146,0.286432161
Mississippi,GRENADA,21591,11981,9402,25,9610,0.554907137,0.00115789,0.445092863
Mississippi,HANCOCK,45627,38836,4115,1637,6791,0.851162689,0.035877879,0.148837311
Mississippi,HARRISON,196268,128194,45102,10643,68074,0.653157927,0.054226873,0.346842073
Mississippi,HINDS,245874,65432,172408,3854,180442,0.266120045,0.015674695,0.733879955
Mississippi,HOLMES,18772,3058,15498,62,15714,0.162902195,0.003302791,0.837097805
Mississippi,HUMPHREYS,8984,1977,6743,233,7007,0.220057881,0.025934996,0.779942119
Mississippi,ISSAQUENA,1291,443,841,7,848,0.343144849,0.005422153,0.656855151
Mississippi,ITAWAMBA,23451,21333,1531,342,2118,0.909684022,0.0145836,0.090315978
Mississippi,JACKSON,140676,96569,30229,7540,44107,0.686463931,0.053598339,0.313536069
Mississippi,JASPER,16588,7600,8785,99,8988,0.458162527,0.00596817,0.541837473
Mississippi,JEFFERSON,7586,1049,6520,8,6537,0.138281044,0.001054574,0.861718956
Mississippi,JEFFERSON DAVIS,11941,4586,7312,17,7355,0.384054937,0.001423666,0.615945063
Mississippi,JONES,68276,44516,19711,2901,23760,0.652000703,0.042489308,0.347999297
Mississippi,KEMPER,10211,3530,6011,246,6681,0.345705612,0.024091666,0.654294388
Mississippi,LAFAYETTE,51169,36042,12258,1188,15127,0.704371788,0.023217182,0.295628212
Mississippi,LAMAR,58885,44008,11826,1387,14877,0.747355014,0.023554386,0.252644986
Mississippi,LAUDERDALE,79832,42631,33866,1656,37201,0.534008919,0.020743561,0.465991081
Mississippi,LAWRENCE,12586,8278,4058,79,4308,0.657714921,0.006276816,0.342285079
Mississippi,LEAKE,23153,11125,9576,984,12028,0.480499287,0.042499892,0.519500713
Mississippi,LEE,85036,57106,23652,2126,27930,0.671550873,0.025001176,0.328449127
Mississippi,LEFLORE,31516,7580,22716,778,23936,0.240512755,0.024685874,0.759487245
Mississippi,LINCOLN,34765,23356,10706,382,11409,0.671825111,0.010988063,0.328174889
Mississippi,LOWNDES,59699,31443,26157,1108,28256,0.526692239,0.018559775,0.473307761
Mississippi,MADISON,100202,55996,38296,2830,44206,0.558831161,0.028242949,0.441168839
Mississippi,MARION,26109,16961,8415,367,9148,0.649622735,0.014056456,0.350377265
Mississippi,MARSHALL,36385,17538,17319,1212,18847,0.482011818,0.03331043,0.517988182
Mississippi,MONROE,36175,24302,11021,386,11873,0.67178991,0.010670352,0.32821009
Mississippi,MONTGOMERY,10464,5490,4713,113,4974,0.524655963,0.01079893,0.475344037
Mississippi,NESHOBA,29553,17522,6607,186,12031,0.59290089,0.006293777,0.40709911
Mississippi,NEWTON,21663,13498,6576,350,8165,0.623090061,0.01615658,0.376909939
Mississippi,NOXUBEE,11143,2956,8016,154,8187,0.26527865,0.013820336,0.73472135
Mississippi,OKTIBBEHA,49048,28141,18123,780,20907,0.573744087,0.015902789,0.426255913
Mississippi,PANOLA,34373,16445,17178,546,17928,0.478427836,0.015884561,0.521572164
Mississippi,PEARL RIVER,55196,45159,7483,1674,10037,0.818157113,0.030328285,0.181842887
Mississippi,PERRY,12187,9407,2598,37,2780,0.771888077,0.003036022,0.228111923
Mississippi,PIKE,40075,18013,20957,547,22062,0.449482221,0.013649407,0.550517779
Mississippi,PONTOTOC,30517,23609,4622,1853,6908,0.773634368,0.060720254,0.226365632
Mississippi,PRENTISS,25380,21154,3596,329,4226,0.833490938,0.012962963,0.166509062
Mississippi,QUITMAN,7761,2200,5452,73,5561,0.283468625,0.009406004,0.716531375
Mississippi,RANKIN,146761,110432,28815,3818,36329,0.752461485,0.026015086,0.247538515
Mississippi,SCOTT,28293,14299,10487,3046,13994,0.505390026,0.107659138,0.494609974
Mississippi,SHARKEY,4805,1329,3426,31,3476,0.276586889,0.006451613,0.723413111
Mississippi,SIMPSON,27401,16885,9782,481,10516,0.616218386,0.017554104,0.383781614
Mississippi,SMITH,16257,12141,4012,47,4116,0.746816756,0.002891062,0.253183244
Mississippi,STONE,17978,13852,3446,301,4126,0.770497274,0.016742686,0.229502726
Mississippi,SUNFLOWER,27911,6986,20298,418,20925,0.250295582,0.014976174,0.749704418
Mississippi,TALLAHATCHIE,14959,5408,6708,2492,9551,0.361521492,0.166588676,0.638478508
Mississippi,TATE,28415,18498,8747,701,9917,0.650994193,0.024670069,0.349005807
Mississippi,TIPPAH,22054,17115,3455,1058,4939,0.776049696,0.047973157,0.223950304
Mississippi,TISHOMINGO,19539,18256,508,522,1283,0.934336455,0.026715799,0.065663545
Mississippi,TUNICA,10477,2209,7914,139,8268,0.210842799,0.013267157,0.789157201
Mississippi,UNION,27811,21925,3940,1257,5886,0.788357125,0.045197943,0.211642875
Mississippi,WALTHALL,14978,7922,6667,264,7056,0.528909067,0.017625851,0.471090933
Mississippi,WARREN,48020,23309,22929,1005,24711,0.485401916,0.02092878,0.514598084
Mississippi,WASHINGTON,49499,13088,35171,660,36411,0.264409382,0.013333603,0.735590618
Mississippi,WAYNE,20564,12030,8015,293,8534,0.585002918,0.014248201,0.414997082
Mississippi,WEBSTER,9999,7776,1964,128,2223,0.777677768,0.01280128,0.222322232
Mississippi,WILKINSON,9345,2690,6603,8,6655,0.287854468,0.000856073,0.712145532
Mississippi,WINSTON,18697,9501,8867,208,9196,0.508156389,0.011124779,0.491843611
Mississippi,YALOBUSHA,12381,7282,4797,202,5099,0.588159276,0.016315322,0.411840724
Mississippi,YAZOO,27911,10187,16020,1341,17724,0.364981548,0.048045573,0.635018452
Missouri,ADAIR,25560,23380,528,613,2180,0.914710485,0.023982786,0.085289515
Missouri,ANDREW,17328,16498,144,371,830,0.952100646,0.021410434,0.047899354
Missouri,ATCHISON,5440,5266,16,69,174,0.968014706,0.012683824,0.031985294
Missouri,AUDRAIN,25783,22545,1692,718,3238,0.874413373,0.027847807,0.125586627
Missouri,BARRY,35726,31160,60,3031,4566,0.87219392,0.084840172,0.12780608
Missouri,BARTON,12166,11345,33,289,821,0.93251685,0.023754726,0.06748315
Missouri,BATES,16643,15788,85,349,855,0.94862705,0.020969777,0.05137295
Missouri,BENTON,18854,17999,82,333,855,0.954651533,0.017662035,0.045348467
Missouri,BOLLINGER,12356,11973,30,115,383,0.969002914,0.009307219,0.030997086
Missouri,BOONE,170770,136672,14330,5442,34098,0.800327926,0.031867424,0.199672074
Missouri,BUCHANAN,89561,75705,4546,5309,13856,0.845289802,0.059278034,0.154710198
Missouri,BUTLER,42951,38421,2388,742,4530,0.894530977,0.0172755,0.105469023
Missouri,CALDWELL,9083,8640,69,175,443,0.951227568,0.019266762,0.048772432
Missouri,CALLAWAY,44566,40287,1638,851,4279,0.903985101,0.019095274,0.096014899
Missouri,CAMDEN,43927,41601,223,1098,2326,0.947048512,0.024996016,0.052951488
Missouri,CAPE GIRARDEAU,77606,67464,5905,1723,10142,0.869314228,0.022201892,0.130685772
Missouri,CARROLL,9096,8627,111,120,469,0.948438874,0.013192612,0.051561126
Missouri,CARTER,6284,5949,4,120,335,0.946690006,0.019096117,0.053309994
Missouri,CASS,100781,89501,3663,4238,11280,0.888074141,0.042051577,0.111925859
Missouri,CEDAR,13892,13230,10,192,662,0.952346674,0.013820904,0.047653326
Missouri,CHARITON,7650,7322,166,62,328,0.957124183,0.008104575,0.042875817
Missouri,CHRISTIAN,80904,75811,474,2245,5093,0.937048848,0.027748937,0.062951152
Missouri,CLARK,6919,6739,18,21,180,0.97398468,0.003035121,0.02601532
Missouri,CLAY,230361,190625,12224,14704,39736,0.827505524,0.063830249,0.172494476
Missouri,CLINTON,20498,19245,359,389,1253,0.938872085,0.018977461,0.061127915
Missouri,COLE,76533,62592,8820,2044,13941,0.817843283,0.026707433,0.182156717
Missouri,COOPER,17593,15606,1070,266,1987,0.887057352,0.01511965,0.112942648
Missouri,CRAWFORD,24660,23660,54,425,1000,0.9594485,0.017234388,0.0405515
Missouri,DADE,7618,7186,37,136,432,0.943292203,0.017852455,0.056707797
Missouri,DALLAS,16564,15677,13,302,887,0.946450133,0.018232311,0.053549867
Missouri,DAVIESS,8277,7988,74,110,289,0.965083968,0.013289839,0.034916032
Missouri,DEKALB,12782,10541,1243,492,2241,0.824675325,0.038491629,0.175324675
Missouri,DENT,15612,14864,62,211,748,0.952088137,0.013515245,0.047911863
Missouri,DOUGLAS,13516,13214,8,144,302,0.977656111,0.01065404,0.022343889
Missouri,DUNKLIN,31562,25777,3081,1928,5785,0.816709968,0.061086116,0.183290032
Missouri,FRANKLIN,101828,97152,1053,1623,4676,0.954079428,0.015938642,0.045920572
Missouri,GASCONADE,14948,14427,66,194,521,0.965145839,0.012978325,0.034854161
Missouri,GENTRY,6785,6591,72,61,194,0.971407517,0.00899042,0.028592483
Missouri,GREENE,283206,251136,8758,9474,32070,0.886760874,0.033452681,0.113239126
Missouri,GRUNDY,10256,9762,64,94,494,0.951833073,0.009165367,0.048166927
Missouri,HARRISON,8722,8363,73,170,359,0.958839716,0.019490942,0.041160284
Missouri,HENRY,22034,20764,379,443,1270,0.942361804,0.020105292,0.057638196
Missouri,HICKORY,9335,8922,16,130,413,0.9557579,0.013926085,0.0442421
Missouri,HOLT,4615,4464,16,12,151,0.967280607,0.002600217,0.032719393
Missouri,HOWARD,10182,9243,523,139,939,0.907778433,0.013651542,0.092221567
Missouri,HOWELL,40326,38265,125,764,2061,0.948891534,0.018945593,0.051108466
Missouri,IRON,10322,9762,269,85,560,0.945746948,0.008234838,0.054253052
Missouri,JACKSON,680905,427402,160258,58974,253503,0.627696962,0.086611201,0.372303038
Missouri,JASPER,117184,99722,2475,8698,17462,0.850986483,0.07422515,0.149013517
Missouri,JEFFERSON,221577,210158,2128,3871,11419,0.948464868,0.017470225,0.051535132
Missouri,JOHNSON,54155,46860,2384,2061,7295,0.865294063,0.038057428,0.134705937
Missouri,KNOX,4035,3893,23,46,142,0.964807931,0.011400248,0.035192069
Missouri,LACLEDE,35514,33387,185,782,2127,0.940108126,0.022019485,0.059891874
Missouri,LAFAYETTE,32916,30428,661,837,2488,0.924413659,0.025428363,0.075586341
Missouri,LAWRENCE,38244,34459,47,2627,3785,0.901030227,0.068690514,0.098969773
Missouri,LEWIS,10172,9407,305,165,765,0.924793551,0.016220999,0.075206449
Missouri,LINCOLN,53850,50374,1007,1160,3476,0.935450325,0.021541318,0.064549675
Missouri,LINN,12401,11843,57,222,558,0.955003629,0.017901782,0.044996371
Missouri,LIVINGSTON,15042,14052,390,232,990,0.934184284,0.015423481,0.065815716
Missouri,MCDONALD,22763,18053,343,2583,4710,0.79308527,0.113473619,0.20691473
Missouri,MACON,15460,14554,409,187,906,0.941397154,0.012095731,0.058602846
Missouri,MADISON,12401,11816,220,61,585,0.952826385,0.004918958,0.047173615
Missouri,MARIES,9057,8713,38,50,344,0.962018328,0.005520592,0.037981672
Missouri,MARION,28840,26106,1453,445,2734,0.90520111,0.015429958,0.09479889
Missouri,MERCER,3718,3595,27,37,123,0.966917698,0.009951587,0.033082302
Missouri,MILLER,24956,23763,110,433,1193,0.952195865,0.017350537,0.047804135
Missouri,MISSISSIPPI,14208,10275,3423,273,3933,0.723184122,0.019214527,0.276815878
Missouri,MONITEAU,15801,14153,616,716,1648,0.895702804,0.045313588,0.104297196
Missouri,MONROE,8680,8149,231,98,531,0.938824885,0.011290323,0.061175115
Missouri,MONTGOMERY,11939,11326,163,187,613,0.948655666,0.015662953,0.051344334
Missouri,MORGAN,20225,19151,251,393,1074,0.946897404,0.019431397,0.053102596
Missouri,NEW MADRID,18411,14819,2957,287,3592,0.804899245,0.015588507,0.195100755
Missouri,NEWTON,58777,51105,562,2864,7672,0.869472753,0.048726543,0.130527247
Missouri,NODAWAY,23186,21570,631,342,1616,0.930302769,0.01475028,0.069697231
Missouri,OREGON,10979,10371,26,160,608,0.94462155,0.014573276,0.05537845
Missouri,OSAGE,13758,13431,114,99,327,0.97623201,0.007195813,0.02376799
Missouri,OZARK,9537,9146,16,152,391,0.959001783,0.015937926,0.040998217
Missouri,PEMISCOT,17837,12331,4778,406,5506,0.691315804,0.022761675,0.308684196
Missouri,PERRY,19100,18256,151,401,844,0.955811518,0.020994764,0.044188482
Missouri,PETTIS,42215,36235,1165,3402,5980,0.85834419,0.080587469,0.14165581
Missouri,PHELPS,45029,40136,1040,1059,4893,0.891336694,0.023518177,0.108663306
Missouri,PIKE,18517,16413,1143,391,2104,0.886374683,0.021115731,0.113625317
Missouri,PLATTE,93394,77327,5766,5195,16067,0.827965394,0.055624558,0.172034606
Missouri,POLK,31107,29247,304,653,1860,0.940206384,0.02099206,0.059793616
Missouri,PULASKI,53443,37522,5978,5514,15921,0.70209382,0.103175346,0.29790618
Missouri,PUTNAM,4895,4751,20,57,144,0.970582227,0.011644535,0.029417773
Missouri,RALLS,10243,9826,147,118,417,0.959289271,0.011520062,0.040710729
Missouri,RANDOLPH,25135,22486,1232,459,2649,0.894609111,0.018261389,0.105390889
Missouri,RAY,23031,21691,311,513,1340,0.94181755,0.022274326,0.05818245
Missouri,REYNOLDS,6578,6257,94,86,321,0.951200973,0.013073883,0.048799027
Missouri,RIPLEY,13990,13345,27,168,645,0.95389564,0.012008578,0.04610436
Missouri,ST. CHARLES,374805,330455,16619,11439,44350,0.881671803,0.03051987,0.118328197
Missouri,ST. CLAIR,9520,9025,115,196,495,0.948004202,0.020588235,0.051995798
Missouri,STE. GENEVIEVE,17990,17205,130,177,785,0.956364647,0.009838799,0.043635353
Missouri,ST. FRANCOIS,66010,60906,3143,922,5104,0.922678382,0.013967581,0.077321618
Missouri,ST. LOUIS,1001327,678612,232960,26783,322715,0.677712675,0.026747506,0.322287325
Missouri,SALINE,23334,18993,1150,2156,4341,0.813962458,0.09239736,0.186037542
Missouri,SCHUYLER,4395,4288,14,37,107,0.975654152,0.008418658,0.024345848
Missouri,SCOTLAND,4873,4763,44,55,110,0.977426637,0.011286682,0.022573363
Missouri,SCOTT,39061,32838,4406,826,6223,0.840685082,0.021146412,0.159314918
Missouri,SHANNON,8317,7846,23,148,471,0.943369003,0.017794878,0.056630997
Missouri,SHELBY,6179,5970,100,83,209,0.966175757,0.013432594,0.033824243
Missouri,STODDARD,29837,28591,446,464,1246,0.958239769,0.015551161,0.041760231
Missouri,STONE,31375,29941,32,612,1434,0.954294821,0.019505976,0.045705179
Missouri,SULLIVAN,6512,5140,57,1190,1372,0.789312039,0.182739558,0.210687961
Missouri,TANEY,53555,48159,442,2811,5396,0.899243768,0.052488096,0.100756232
Missouri,TEXAS,25735,23503,452,522,2232,0.913269866,0.02028366,0.086730134
Missouri,VERNON,20878,19710,189,402,1168,0.944055944,0.019254718,0.055944056
Missouri,WARREN,33043,30466,738,1039,2577,0.922010713,0.031443876,0.077989287
Missouri,WASHINGTON,25048,23680,491,75,1368,0.945384861,0.002994251,0.054615139
Missouri,WAYNE,13397,12839,78,178,558,0.958348884,0.013286557,0.041651116
Missouri,WEBSTER,36690,34759,475,682,1931,0.947369856,0.018588171,0.052630144
Missouri,WORTH,2082,2003,0,29,79,0.962055716,0.013928915,0.037944284
Missouri,WRIGHT,18449,17606,144,315,843,0.954306466,0.017074096,0.045693534
Missouri,ST. LOUIS CITY,317850,136935,151041,11875,180915,0.430816423,0.03736039,0.569183577
Montana,BEAVERHEAD,9291,8527,12,345,764,0.917769885,0.037132709,0.082230115
Montana,BIG HORN,13141,3874,12,686,9267,0.294802526,0.052203029,0.705197474
Montana,BLAINE,6598,3119,16,156,3479,0.472719006,0.023643528,0.527280994
Montana,BROADWATER,5692,5354,35,89,338,0.940618412,0.01563598,0.059381588
Montana,CARBON,10268,9745,1,247,523,0.949065056,0.024055317,0.050934944
Montana,CARTER,1227,1202,0,8,25,0.979625102,0.006519967,0.020374898
Montana,CASCADE,82090,70820,990,3241,11270,0.862711658,0.039481057,0.137288342
Montana,CHOUTEAU,5855,4451,4,122,1404,0.760204953,0.020836892,0.239795047
Montana,CUSTER,11945,11117,42,329,828,0.930682294,0.027542905,0.069317706
Montana,DANIELS,1758,1698,0,44,60,0.965870307,0.025028441,0.034129693
Montana,DAWSON,9365,8720,79,249,645,0.931126535,0.026588361,0.068873465
Montana,DEER LODGE,9211,8390,95,278,821,0.910867441,0.030181305,0.089132559
Montana,FALLON,3057,2923,40,30,134,0.956166176,0.009813543,0.043833824
Montana,FERGUS,11468,10833,23,94,635,0.944628532,0.008196721,0.055371468
Montana,FLATHEAD,93333,87120,287,2380,6213,0.933431905,0.025500091,0.066568095
Montana,GALLATIN,95323,88303,380,2909,7020,0.926355654,0.030517294,0.073644346
Montana,GARFIELD,1047,1017,0,6,30,0.971346705,0.005730659,0.028653295
Montana,GLACIER,13672,4371,46,348,9301,0.319704506,0.025453482,0.680295494
Montana,GOLDEN VALLEY,756,716,0,16,40,0.947089947,0.021164021,0.052910053
Montana,GRANITE,3168,3071,2,60,97,0.969381313,0.018939394,0.030618687
Montana,HILL,16523,11765,3,518,4758,0.712037766,0.031350239,0.287962234
Montana,JEFFERSON,11502,10739,17,247,763,0.933663711,0.021474526,0.066336289
Montana,JUDITH BASIN,1997,1943,0,27,54,0.972959439,0.01352028,0.027040561
Montana,LAKE,29157,19320,72,1179,9837,0.662619611,0.040436259,0.337380389
Montana,LEWIS AND CLARK,65357,59990,316,1892,5367,0.917881788,0.028948697,0.082118212
Montana,LIBERTY,2369,2278,0,19,91,0.961587168,0.008020262,0.038412832
Montana,LINCOLN,19337,18084,10,511,1253,0.935201944,0.026426023,0.064798056
Montana,MCCONE,1728,1636,0,26,92,0.946759259,0.015046296,0.053240741
Montana,MADISON,7767,7326,48,232,441,0.943221321,0.029869963,0.056778679
Montana,MEAGHER,1898,1842,0,27,56,0.970495258,0.014225501,0.029504742
Montana,MINERAL,4238,4124,3,66,114,0.973100519,0.015573384,0.026899481
Montana,MISSOULA,111966,100853,511,3368,11113,0.900746655,0.03008056,0.099253345
Montana,MUSSELSHELL,4790,4431,9,158,359,0.925052192,0.032985386,0.074947808
Montana,PARK,15708,14791,86,418,917,0.941622103,0.026610644,0.058377897
Montana,PETROLEUM,443,437,0,6,6,0.986455982,0.013544018,0.013544018
Montana,PHILLIPS,4167,3568,0,88,599,0.8562515,0.021118311,0.1437485
Montana,PONDERA,6206,5047,21,114,1159,0.813245247,0.01836932,0.186754753
Montana,POWDER RIVER,1703,1600,0,35,103,0.939518497,0.020551967,0.060481503
Montana,POWELL,6975,6313,33,174,662,0.905089606,0.024946237,0.094910394
Montana,PRAIRIE,1372,1318,0,11,54,0.960641399,0.008017493,0.039358601
Montana,RAVALLI,40823,38050,123,1320,2773,0.932072606,0.032334713,0.067927394
Montana,RICHLAND,11132,10140,41,492,992,0.910887531,0.04419691,0.089112469
Montana,ROOSEVELT,11072,4063,9,127,7009,0.366961705,0.011470376,0.633038295
Montana,ROSEBUD,9352,5489,19,391,3863,0.586933276,0.041809239,0.413066724
Montana,SANDERS,11346,10217,17,287,1129,0.900493566,0.025295258,0.099506434
Montana,SHERIDAN,3630,3352,2,64,278,0.923415978,0.017630854,0.076584022
Montana,SILVER BOW,34549,31571,163,1387,2978,0.913803583,0.04014588,0.086196417
Montana,STILLWATER,9288,8739,17,281,549,0.940891473,0.030254091,0.059108527
Montana,SWEET GRASS,3633,3425,7,66,208,0.942747041,0.018166804,0.057252959
Montana,TETON,6074,5734,5,90,340,0.944023708,0.014817254,0.055976292
Montana,TOOLE,5150,4549,8,159,601,0.883300971,0.030873786,0.116699029
Montana,TREASURE,812,724,0,56,88,0.891625616,0.068965517,0.108374384
Montana,VALLEY,7577,6483,12,153,1094,0.855615679,0.020192688,0.144384321
Montana,WHEATLAND,2115,2005,0,45,110,0.947990544,0.021276596,0.052009456
Montana,WIBAUX,986,973,0,13,13,0.986815416,0.013184584,0.013184584
Montana,YELLOWSTONE,153692,134295,899,7938,19397,0.873793041,0.051648752,0.126206959
Nebraska,ADAMS,31442,27567,256,2703,3875,0.876757204,0.085967814,0.123242796
Nebraska,ANTELOPE,6486,6214,8,186,272,0.958063521,0.028677151,0.041936479
Nebraska,ARTHUR,448,443,0,0,5,0.988839286,0,0.011160714
Nebraska,BANNER,820,767,10,31,53,0.935365854,0.037804878,0.064634146
Nebraska,BLAINE,551,544,0,0,7,0.987295826,0,0.012704174
Nebraska,BOONE,5373,5256,7,91,117,0.978224456,0.016936535,0.021775544
Nebraska,BOX BUTTE,11310,9370,13,1314,1940,0.82847038,0.116180371,0.17152962
Nebraska,BOYD,2039,1974,17,10,65,0.968121628,0.004904365,0.031878372
Nebraska,BROWN,3078,2987,1,16,91,0.970435348,0.005198181,0.029564652
Nebraska,BUFFALO,47958,42132,515,3989,5826,0.878518704,0.083176946,0.121481296
Nebraska,BURT,6647,6236,65,183,411,0.938167594,0.027531217,0.061832406
Nebraska,BUTLER,8256,7885,53,230,371,0.955062984,0.027858527,0.044937016
Nebraska,CASS,25360,23997,242,728,1363,0.946253943,0.028706625,0.053746057
Nebraska,CEDAR,8675,8434,7,142,241,0.97221902,0.016368876,0.02778098
Nebraska,CHASE,3897,3407,1,428,490,0.874262253,0.109828073,0.125737747
Nebraska,CHERRY,5770,5155,2,144,615,0.893414211,0.024956672,0.106585789
Nebraska,CHEYENNE,10077,9091,18,643,986,0.902153419,0.063808673,0.097846581
Nebraska,CLAY,6382,5707,29,551,675,0.894233783,0.086336572,0.105766217
Nebraska,COLFAX,10522,5704,167,4532,4818,0.542102262,0.430716594,0.457897738
Nebraska,CUMING,9078,8084,3,834,994,0.890504516,0.091870456,0.109495484
Nebraska,CUSTER,10802,10326,87,264,476,0.955934086,0.024439919,0.044065914
Nebraska,DAKOTA,20798,10879,847,7725,9919,0.523079142,0.371429945,0.476920858
Nebraska,DAWES,9136,7879,44,380,1257,0.862412434,0.041593695,0.137587566
Nebraska,DAWSON,24069,14878,1050,7866,9191,0.618139516,0.32681042,0.381860484
Nebraska,DEUEL,1946,1728,0,170,218,0.887975334,0.087358684,0.112024666
Nebraska,DIXON,5866,5078,23,686,788,0.865666553,0.116945107,0.134333447
Nebraska,DODGE,36725,31637,150,4019,5088,0.861456773,0.10943499,0.138543227
Nebraska,DOUGLAS,537655,381511,59847,63480,156144,0.709583283,0.118068278,0.290416717
Nebraska,DUNDY,2015,1790,2,200,225,0.888337469,0.099255583,0.111662531
Nebraska,FILLMORE,5697,5405,43,203,292,0.948744953,0.035632789,0.051255047
Nebraska,FRANKLIN,3105,3000,4,51,105,0.966183575,0.016425121,0.033816425
Nebraska,FRONTIER,2573,2518,0,10,55,0.978624174,0.003886514,0.021375826
Nebraska,FURNAS,4887,4635,6,159,252,0.948434622,0.032535298,0.051565378
Nebraska,GAGE,21818,20783,83,443,1035,0.952562105,0.020304336,0.047437895
Nebraska,GARDEN,1823,1762,3,14,61,0.966538673,0.007679649,0.033461327
Nebraska,GARFIELD,1933,1880,12,24,53,0.97258148,0.012415934,0.02741852
Nebraska,GOSPER,1976,1914,0,49,62,0.968623482,0.024797571,0.031376518
Nebraska,GRANT,769,728,0,41,41,0.946684005,0.053315995,0.053315995
Nebraska,GREELEY,2476,2386,17,50,90,0.96365105,0.020193861,0.03634895
Nebraska,HALL,60792,42430,1277,15519,18362,0.697953678,0.2552803,0.302046322
Nebraska,HAMILTON,9100,8700,49,260,400,0.956043956,0.028571429,0.043956044
Nebraska,HARLAN,3458,3271,7,105,187,0.945922499,0.030364372,0.054077501
Nebraska,HAYES,1084,1005,2,76,79,0.927121771,0.070110701,0.072878229
Nebraska,HITCHCOCK,2879,2781,4,77,98,0.965960403,0.026745398,0.034039597
Nebraska,HOLT,10398,9867,9,377,531,0.948932487,0.036256972,0.051067513
Nebraska,HOOKER,681,644,6,27,37,0.945668135,0.039647577,0.054331865
Nebraska,HOWARD,6347,6093,7,144,254,0.959981093,0.022687884,0.040018907
Nebraska,JEFFERSON,7433,7018,1,257,415,0.9441679,0.034575542,0.0558321
Nebraska,JOHNSON,5167,4199,348,513,968,0.812657248,0.099283917,0.187342752
Nebraska,KEARNEY,6549,6124,10,334,425,0.935104596,0.051000153,0.064895404
Nebraska,KEITH,8146,7433,42,514,713,0.912472379,0.063098453,0.087527621
Nebraska,KEYA PAHA,711,698,1,0,13,0.981715893,0,0.018284107
Nebraska,KIMBALL,3720,3326,11,293,394,0.894086022,0.078763441,0.105913978
Nebraska,KNOX,8556,7423,5,212,1133,0.867578308,0.024777934,0.132421692
Nebraska,LANCASTER,298080,247609,11304,19030,50471,0.830679683,0.063841922,0.169320317
Nebraska,LINCOLN,35896,31904,287,2862,3992,0.888789837,0.079730332,0.111210163
Nebraska,LOGAN,851,823,2,16,28,0.967097532,0.01880141,0.032902468
Nebraska,LOUP,548,518,0,0,30,0.945255474,0,0.054744526
Nebraska,MCPHERSON,433,422,0,4,11,0.974595843,0.009237875,0.025404157
Nebraska,MADISON,35111,28698,356,4897,6413,0.817350688,0.13947196,0.182649312
Nebraska,MERRICK,7776,7248,38,311,528,0.932098765,0.039994856,0.067901235
Nebraska,MORRILL,4874,4046,39,713,828,0.830118999,0.146286418,0.169881001
Nebraska,NANCE,3639,3542,2,91,97,0.973344325,0.02500687,0.026655675
Nebraska,NEMAHA,7168,6782,73,168,386,0.946149554,0.0234375,0.053850446
Nebraska,NUCKOLLS,4391,4212,2,102,179,0.959234798,0.023229333,0.040765202
Nebraska,OTOE,15842,14333,18,1096,1509,0.904746875,0.069183184,0.095253125
Nebraska,PAWNEE,2726,2652,0,49,74,0.972853999,0.017975055,0.027146001
Nebraska,PERKINS,2924,2796,4,107,128,0.95622435,0.036593707,0.04377565
Nebraska,PHELPS,9216,8589,14,467,627,0.931966146,0.050672743,0.068033854
Nebraska,PIERCE,7184,6980,10,108,204,0.971603563,0.015033408,0.028396437
Nebraska,PLATTE,32642,26668,90,5204,5974,0.816984253,0.159426506,0.183015747
Nebraska,POLK,5271,4973,13,200,298,0.943464238,0.037943464,0.056535762
Nebraska,RED WILLOW,10946,10120,156,530,826,0.924538644,0.048419514,0.075461356
Nebraska,RICHARDSON,8201,7601,3,145,600,0.92683819,0.017680771,0.07316181
Nebraska,ROCK,1401,1336,10,7,65,0.953604568,0.004996431,0.046395432
Nebraska,SALINE,14360,10498,114,3228,3862,0.731058496,0.224791086,0.268941504
Nebraska,SARPY,169192,139820,6661,13757,29372,0.826398411,0.081309991,0.173601589
Nebraska,SAUNDERS,20913,20025,135,449,888,0.957538373,0.021469899,0.042461627
Nebraska,SCOTTS BLUFF,36684,27120,257,8216,9564,0.739286883,0.223966852,0.260713117
Nebraska,SEWARD,16998,16240,58,374,758,0.955406518,0.022002589,0.044593482
Nebraska,SHERIDAN,5294,4391,23,221,903,0.829429543,0.041745372,0.170570457
Nebraska,SHERMAN,3107,3002,38,53,105,0.966205343,0.017058256,0.033794657
Nebraska,SIOUX,1249,1148,0,47,101,0.919135308,0.037630104,0.080864692
Nebraska,STANTON,6081,5626,34,305,455,0.92517678,0.050156224,0.07482322
Nebraska,THAYER,5182,4974,3,58,208,0.959861058,0.01119259,0.040138942
Nebraska,THOMAS,675,644,0,4,31,0.954074074,0.005925926,0.045925926
Nebraska,THURSTON,6946,2677,7,302,4269,0.38540167,0.043478261,0.61459833
Nebraska,VALLEY,4254,4119,3,64,135,0.968265162,0.015044664,0.031734838
Nebraska,WASHINGTON,20257,19306,137,496,951,0.953053266,0.024485363,0.046946734
Nebraska,WAYNE,9425,8534,315,504,891,0.905464191,0.053474801,0.094535809
Nebraska,WEBSTER,3697,3413,2,160,284,0.923180958,0.043278334,0.076819042
Nebraska,WHEELER,847,845,0,0,2,0.997638725,0,0.002361275
Nebraska,YORK,13825,12714,129,626,1111,0.919638336,0.045280289,0.080361664
Nevada,CHURCHILL,24252,18087,516,3182,6165,0.745794161,0.131205674,0.254205839
Nevada,CLARK,2035572,932420,211753,611405,1103152,0.458062893,0.300360292,0.541937107
Nevada,DOUGLAS,47259,38605,258,5607,8654,0.816881441,0.118644068,0.183118559
Nevada,ELKO,51562,34833,586,12351,16729,0.675555642,0.239536868,0.324444358
Nevada,ESMERALDA,1141,902,0,182,239,0.790534619,0.159509202,0.209465381
Nevada,EUREKA,1669,1588,1,44,81,0.951467945,0.026363092,0.048532055
Nevada,HUMBOLDT,17067,11329,77,4353,5738,0.663795629,0.255053612,0.336204371
Nevada,LANDER,5946,3875,8,1613,2071,0.651698621,0.271274807,0.348301379
Nevada,LINCOLN,5194,4372,152,371,822,0.84174047,0.071428571,0.15825953
Nevada,LYON,51657,39607,431,8079,12050,0.76673055,0.156397003,0.23326945
Nevada,MINERAL,4566,2843,59,565,1723,0.622645642,0.123740692,0.377354358
Nevada,NYE,42625,33146,1079,6045,9479,0.777618768,0.141818182,0.222381232
Nevada,PERSHING,6722,4489,319,1550,2233,0.6678072,0.230586135,0.3321928
Nevada,STOREY,3929,3564,17,147,365,0.907101044,0.0374141,0.092898956
Nevada,WASHOE,435019,280739,9623,101261,154280,0.645348824,0.232773741,0.354651176
Nevada,WHITE PINE,9974,7393,398,1456,2581,0.741227191,0.145979547,0.258772809
Nevada,CARSON CITY,54482,37485,505,12342,16997,0.688025403,0.226533534,0.311974597
New Hampshire,BELKNAP,60399,57437,328,945,2962,0.950959453,0.015645954,0.049040547
New Hampshire,CARROLL,47513,45701,169,643,1812,0.961863069,0.013533138,0.038136931
New Hampshire,CHESHIRE,76430,72378,547,1239,4052,0.946984169,0.016210912,0.053015831
New Hampshire,COOS,31870,30101,545,477,1769,0.944493254,0.014967054,0.055506746
New Hampshire,GRAFTON,89341,81750,665,1897,7591,0.915033411,0.021233252,0.084966589
New Hampshire,HILLSBOROUGH,403972,349288,8289,23646,54684,0.864634183,0.05853376,0.135365817
New Hampshire,MERRIMACK,147262,137870,1682,2722,9392,0.936222515,0.018484062,0.063777485
New Hampshire,ROCKINGHAM,299006,279490,1998,7369,19516,0.934730407,0.02464499,0.065269593
New Hampshire,STRAFFORD,125273,115079,1106,2603,10194,0.918625721,0.020778619,0.081374279
New Hampshire,SULLIVAN,43135,41275,156,600,1860,0.956879564,0.013909818,0.043120436
New Jersey,ATLANTIC,275376,157071,39439,49845,118305,0.570387398,0.181007059,0.429612602
New Jersey,BERGEN,926330,549828,49117,166161,376502,0.593555213,0.1793756,0.406444787
New Jersey,BURLINGTON,450556,310668,70387,32991,139888,0.689521391,0.073222862,0.310478609
New Jersey,CAMDEN,511998,299665,92793,78615,212333,0.585285489,0.153545522,0.414714511
New Jersey,CAPE MAY,95805,82334,4441,6733,13471,0.859391472,0.070278169,0.140608528
New Jersey,CUMBERLAND,157035,76172,29168,44982,80863,0.485063839,0.286445697,0.514936161
New Jersey,ESSEX,791609,252835,306745,171649,538774,0.319393792,0.216835584,0.680606208
New Jersey,GLOUCESTER,290298,231202,28383,15737,59096,0.796429876,0.054209812,0.203570124
New Jersey,HUDSON,662619,194795,73431,283504,467824,0.293977384,0.427853714,0.706022616
New Jersey,HUNTERDON,126250,109710,3030,7399,16540,0.868990099,0.058605941,0.131009901
New Jersey,MERCER,370212,193628,72449,60119,176584,0.523019243,0.162390738,0.476980757
New Jersey,MIDDLESEX,830300,382747,76447,162449,447553,0.460974347,0.19565097,0.539025653
New Jersey,MONMOUTH,629185,477374,42416,64639,151811,0.758718024,0.10273449,0.241281976
New Jersey,MORRIS,498192,363210,15057,61934,134982,0.729056267,0.124317532,0.270943733
New Jersey,OCEAN,583450,496778,16901,51293,86672,0.851449139,0.087913274,0.148550861
New Jersey,PASSAIC,507574,219635,55814,198350,287939,0.43271523,0.390780458,0.56728477
New Jersey,SALEM,65120,49283,8955,5012,15837,0.756802826,0.076965602,0.243197174
New Jersey,SOMERSET,330604,196255,28993,46148,134349,0.593625606,0.139586938,0.406374394
New Jersey,SUSSEX,145930,127994,2840,10330,17936,0.877091756,0.070787364,0.122908244
New Jersey,UNION,548744,232402,111478,161529,316342,0.423516248,0.294361305,0.576483752
New Jersey,WARREN,107226,89844,4327,8589,17382,0.837893794,0.080101841,0.162106206
New Mexico,BERNALILLO,673943,272139,17183,328327,401804,0.403801212,0.487173248,0.596198788
New Mexico,CATRON,3583,2862,24,629,721,0.798771979,0.175551214,0.201228021
New Mexico,CHAVES,65811,27381,1074,35657,38430,0.416055067,0.54180912,0.583944933
New Mexico,CIBOLA,27382,5732,242,10267,21650,0.209334599,0.37495435,0.790665401
New Mexico,COLFAX,12997,6230,41,6321,6767,0.479341386,0.486343002,0.520658614
New Mexico,CURRY,50497,25277,2873,20152,25220,0.50056439,0.399073212,0.49943561
New Mexico,DE BACA,2020,1014,0,911,1006,0.501980198,0.450990099,0.498019802
New Mexico,EDDY,55641,27885,737,25558,27756,0.501159217,0.459337539,0.498840783
New Mexico,GRANT,29119,13847,150,14321,15272,0.47553144,0.491809471,0.52446856
New Mexico,GUADALUPE,4526,805,71,3498,3721,0.177861246,0.772867875,0.822138754
New Mexico,HARDING,565,345,0,218,220,0.610619469,0.385840708,0.389380531
New Mexico,HIDALGO,4643,1953,12,2632,2690,0.420633211,0.566874865,0.579366789
New Mexico,LEA,68149,26881,2167,37152,41268,0.394444526,0.545158403,0.605555474
New Mexico,LINCOLN,19931,12753,112,6212,7178,0.639857508,0.31167528,0.360142492
New Mexico,LOS ALAMOS,17939,13264,87,2905,4675,0.739394615,0.161937678,0.260605385
New Mexico,LUNA,24789,8183,255,15898,16606,0.330106095,0.641332849,0.669893905
New Mexico,MCKINLEY,73998,7320,572,10303,66678,0.098921592,0.139233493,0.901078408
New Mexico,MORA,4660,815,4,3838,3845,0.174892704,0.82360515,0.825107296
New Mexico,OTERO,65318,33387,2315,23607,31931,0.511145473,0.361416455,0.488854527
New Mexico,QUAY,8698,4479,192,3831,4219,0.514945965,0.44044608,0.485054035
New Mexico,RIO ARRIBA,39949,5238,159,28544,34711,0.131117174,0.714511002,0.868882826
New Mexico,ROOSEVELT,19908,10781,434,7982,9127,0.541541089,0.400944344,0.458458911
New Mexico,SANDOVAL,136638,62189,2631,50357,74449,0.455136931,0.368543158,0.544863069
New Mexico,SAN JUAN,125133,51317,604,24504,73816,0.410099654,0.195823644,0.589900346
New Mexico,SAN MIGUEL,28668,5449,383,22060,23219,0.190072555,0.769499093,0.809927445
New Mexico,SANTA FE,147108,63487,950,75131,83621,0.431567284,0.510720015,0.568432716
New Mexico,SIERRA,11615,7772,53,3380,3843,0.66913474,0.291003013,0.33086526
New Mexico,SOCORRO,17494,6838,129,8598,10656,0.390876872,0.491482794,0.609123128
New Mexico,TAOS,32943,11842,148,18508,21101,0.359469387,0.561818899,0.640530613
New Mexico,TORRANCE,15853,8548,201,6444,7305,0.539203936,0.406484577,0.460796064
New Mexico,UNION,4339,2348,116,1771,1991,0.541138511,0.408158562,0.458861489
New Mexico,VALENCIA,76297,26487,788,45161,49810,0.347156507,0.59191056,0.652843493
New York,ALBANY,307463,228043,36363,16987,79420,0.741692496,0.055248924,0.258307504
New York,ALLEGANY,48070,45548,635,734,2522,0.947534845,0.015269399,0.052465155
New York,BRONX,1428357,146928,422677,780260,1281429,0.10286504,0.546263994,0.89713496
New York,BROOME,198093,168178,9555,7459,29915,0.848985073,0.037654031,0.151014927
New York,CATTARAUGUS,78962,71985,1193,1525,6977,0.911641043,0.019313087,0.088358957
New York,CAYUGA,79173,71808,3227,2145,7365,0.906975863,0.027092569,0.093024137
New York,CHAUTAUQUA,132646,117041,3054,9043,15605,0.882356045,0.068173937,0.117643955
New York,CHEMUNG,88267,76471,5060,2532,11796,0.866360021,0.028685692,0.133639979
New York,CHENANGO,49549,47078,418,1024,2471,0.950130174,0.020666411,0.049869826
New York,CLINTON,81685,73799,3306,2220,7886,0.903458407,0.027177572,0.096541593
New York,COLUMBIA,62195,54393,2528,2664,7802,0.874555832,0.042833025,0.125444168
New York,CORTLAND,49043,45553,723,1226,3490,0.928837959,0.024998471,0.071162041
New York,DELAWARE,46901,43421,825,1660,3480,0.925801156,0.035393702,0.074198844
New York,DUTCHESS,296928,216593,27975,33528,80335,0.729446196,0.112916263,0.270553804
New York,ERIE,921584,705888,119682,45767,215696,0.765950798,0.049661235,0.234049202
New York,ESSEX,38912,35886,1110,1156,3026,0.922234786,0.029708059,0.077765214
New York,FRANKLIN,51280,41999,2756,1675,9281,0.819013261,0.032663807,0.180986739
New York,FULTON,54606,50960,855,1483,3646,0.933230781,0.027158188,0.066769219
New York,GENESEE,59458,54029,1513,1764,5429,0.90869185,0.029668001,0.09130815
New York,GREENE,48312,41658,2786,2563,6654,0.862270243,0.053051002,0.137729757
New York,HAMILTON,4760,4512,24,63,248,0.94789916,0.013235294,0.05210084
New York,HERKIMER,64034,60852,592,1247,3182,0.950307649,0.019474029,0.049692351
New York,JEFFERSON,118947,98419,6123,8266,20528,0.827418934,0.069493136,0.172581066
New York,KINGS,2595259,926945,809358,509243,1668314,0.357168591,0.196220493,0.642831409
New York,LEWIS,27124,26014,247,451,1110,0.959076832,0.016627341,0.040923168
New York,LIVINGSTON,64801,59100,1447,2157,5701,0.912022963,0.033286523,0.087977037
New York,MADISON,72427,67735,1243,1455,4692,0.935217529,0.020089193,0.064782471
New York,MONROE,749356,536323,108883,59540,213033,0.715711891,0.079454892,0.284288109
New York,MONTGOMERY,49779,41619,725,6111,8160,0.836075454,0.122762611,0.163924546
New York,NASSAU,1354612,851645,147403,213372,502967,0.628700322,0.157515215,0.371299678
New York,NEW YORK,1629507,767701,207572,420413,861806,0.471124702,0.258000119,0.528875298
New York,NIAGARA,214150,185219,15563,5412,28931,0.864903105,0.025272006,0.135096895
New York,ONEIDA,233558,194569,13196,12024,38989,0.83306502,0.051481859,0.16693498
New York,ONONDAGA,468304,364572,49806,21088,103732,0.778494311,0.045030578,0.221505689
New York,ONTARIO,109192,99152,2518,4445,10040,0.908051872,0.04070811,0.091948128
New York,ORANGE,375384,249415,34951,71699,125969,0.664426294,0.191001748,0.335573706
New York,ORLEANS,42204,36643,2468,1892,5561,0.868235238,0.044829874,0.131764762
New York,OSWEGO,121183,114552,938,2817,6631,0.945281104,0.023245835,0.054718896
New York,OTSEGO,61399,56436,1107,2106,4963,0.919168065,0.034300233,0.080831935
New York,PUTNAM,99488,80787,2152,12618,18701,0.812027581,0.126829366,0.187972419
New York,QUEENS,2301139,601381,400155,643045,1699758,0.26134058,0.279446396,0.73865942
New York,RENSSELAER,159900,135285,9148,6913,24615,0.846060038,0.043233271,0.153939962
New York,RICHMOND,472481,296800,45323,84336,175681,0.628173408,0.178496067,0.371826592
New York,ROCKLAND,320688,204596,36726,53756,116092,0.63799082,0.167627102,0.36200918
New York,ST. LAWRENCE,112011,103238,2342,2415,8773,0.921677335,0.021560382,0.078322665
New York,SARATOGA,223774,205137,3239,6302,18637,0.916715079,0.028162342,0.083284921
New York,SCHENECTADY,154796,116261,14354,9854,38535,0.751059459,0.063657976,0.248940541
New York,SCHOHARIE,31913,29868,428,958,2045,0.935919531,0.030019114,0.064080469
New York,SCHUYLER,18410,17566,158,318,844,0.95415535,0.017273221,0.04584465
New York,SENECA,35144,31511,1486,1087,3633,0.896625313,0.030929888,0.103374687
New York,STEUBEN,98665,92654,1519,1517,6011,0.939076674,0.01537526,0.060923326
New York,SUFFOLK,1501373,1045354,107319,267396,456019,0.696265352,0.178100978,0.303734648
New York,SULLIVAN,76330,56088,5919,11160,20242,0.73480938,0.146207258,0.26519062
New York,TIOGA,50199,47970,361,797,2229,0.955596725,0.01587681,0.044403275
New York,TOMPKINS,103855,81151,3777,4818,22704,0.781387511,0.046391604,0.218612489
New York,ULSTER,181300,145799,9565,17292,35501,0.804186431,0.095377827,0.195813569
New York,WARREN,65180,61638,783,1374,3542,0.945658177,0.021080086,0.054341823
New York,WASHINGTON,62700,58182,1753,1572,4518,0.927942584,0.02507177,0.072057416
New York,WAYNE,92416,83544,3027,3724,8872,0.903999307,0.040296053,0.096000693
New York,WESTCHESTER,967315,535731,129418,225366,431584,0.553833033,0.232980983,0.446166967
New York,WYOMING,41446,37232,2219,1313,4214,0.898325532,0.031679776,0.101674468
New York,YATES,25187,24063,237,511,1124,0.955373804,0.020288244,0.044626196
North Carolina,ALAMANCE,155258,102350,28265,18432,52908,0.65922529,0.11871852,0.34077471
North Carolina,ALEXANDER,37158,32528,2070,1629,4630,0.875396954,0.043839819,0.124603046
North Carolina,ALLEGHANY,10911,9521,237,1017,1390,0.872605627,0.093208688,0.127394373
North Carolina,ANSON,26135,11863,12746,890,14272,0.453912378,0.034053951,0.546087622
North Carolina,ASHE,27114,25136,186,1373,1978,0.927048757,0.050638047,0.072951243
North Carolina,AVERY,17695,15456,734,831,2239,0.873467081,0.046962419,0.126532919
North Carolina,BEAUFORT,47561,31403,12218,3506,16158,0.660267867,0.07371586,0.339732133
North Carolina,BERTIE,20518,7140,12701,343,13378,0.347987133,0.016717029,0.652012867
North Carolina,BLADEN,34720,18868,12055,2623,15852,0.54343318,0.075547235,0.45656682
North Carolina,BRUNSWICK,115926,94135,12264,5620,21791,0.812026638,0.048479202,0.187973362
North Carolina,BUNCOMBE,247336,207380,15307,15720,39956,0.838454572,0.063557266,0.161545428
North Carolina,BURKE,89548,73673,5263,5174,15875,0.822720775,0.057779068,0.177279225
North Carolina,CABARRUS,188375,131169,30393,18419,57206,0.696318514,0.097778368,0.303681486
North Carolina,CALDWELL,81758,72024,4002,3984,9734,0.880941315,0.048729176,0.119058685
North Carolina,CAMDEN,10161,8171,1399,260,1990,0.804153135,0.025588033,0.195846865
North Carolina,CARTERET,68228,58957,4092,2771,9271,0.864117371,0.040613824,0.135882629
North Carolina,CASWELL,23174,14196,7577,796,8978,0.612583067,0.034348839,0.387416933
North Carolina,CATAWBA,154610,119091,13032,13537,35519,0.770267124,0.087555786,0.229732876
North Carolina,CHATHAM,67431,48137,8094,8514,19294,0.713870475,0.126262402,0.286129525
North Carolina,CHEROKEE,27092,24829,438,767,2263,0.916469807,0.02831094,0.083530193
North Carolina,CHOWAN,14656,8822,4993,485,5834,0.601937773,0.033092249,0.398062227
North Carolina,CLAY,10656,10232,56,316,424,0.96021021,0.029654655,0.03978979
North Carolina,CLEVELAND,97178,71546,20064,2997,25632,0.736236597,0.030840314,0.263763403
North Carolina,COLUMBUS,57230,34457,17198,2734,22773,0.602079329,0.047772147,0.397920671
North Carolina,CRAVEN,104450,69552,22042,7243,34898,0.665887985,0.069344184,0.334112015
North Carolina,CUMBERLAND,324603,147733,114578,34738,176870,0.455119022,0.107016879,0.544880978
North Carolina,CURRITUCK,24492,21461,1467,845,3031,0.876245305,0.034501062,0.123754695
North Carolina,DARE,34863,30615,779,2382,4248,0.878151622,0.068324585,0.121848378
North Carolina,DAVIDSON,163867,133272,15147,10860,30595,0.813293708,0.066273258,0.186706292
North Carolina,DAVIE,41447,35166,2725,2634,6281,0.848457066,0.063551041,0.151542934
North Carolina,DUPLIN,59453,31023,14735,12627,28430,0.521807142,0.212386255,0.478192858
North Carolina,DURHAM,288817,121493,107085,38768,167324,0.420657371,0.134230326,0.579342629
North Carolina,EDGECOMBE,55280,20468,31167,2238,34812,0.370260492,0.040484805,0.629739508
North Carolina,FORSYTH,361684,209493,92844,44745,152191,0.579215558,0.123712965,0.420784442
North Carolina,FRANKLIN,62296,39545,15861,4913,22751,0.634791961,0.078865417,0.365208039
North Carolina,GASTON,209807,156240,31666,13153,53567,0.7446844,0.062690949,0.2553156
North Carolina,GATES,11724,7334,3940,218,4390,0.625554418,0.018594336,0.374445582
North Carolina,GRAHAM,8700,7659,47,128,1041,0.880344828,0.014712644,0.119655172
North Carolina,GRANVILLE,58109,34045,17810,4318,24064,0.585881705,0.074308627,0.414118295
North Carolina,GREENE,21328,10130,7589,3142,11198,0.474962491,0.14731808,0.525037509
North Carolina,GUILFORD,506763,265781,166233,38207,240982,0.524468045,0.075394218,0.475531955
North Carolina,HALIFAX,53407,20929,27734,1379,32478,0.391877469,0.025820585,0.608122531
North Carolina,HARNETT,124320,78090,25330,14541,46230,0.628137066,0.116964286,0.371862934
North Carolina,HAYWOOD,59170,55244,521,2109,3926,0.933648809,0.035643062,0.066351191
North Carolina,HENDERSON,109719,91730,3229,10814,17989,0.836044805,0.098560869,0.163955195
North Carolina,HERTFORD,24368,8215,14106,781,16153,0.337122456,0.03205023,0.662877544
North Carolina,HOKE,51075,21011,16655,6302,30064,0.411375428,0.123387176,0.588624572
North Carolina,HYDE,5693,3334,2007,304,2359,0.585631477,0.053398911,0.414368523
North Carolina,IREDELL,165066,126743,19984,11836,38323,0.767832261,0.071704651,0.232167739
North Carolina,JACKSON,40812,33052,911,2159,7760,0.809859845,0.052901108,0.190140155
North Carolina,JOHNSTON,178396,123424,26332,23489,54972,0.691854077,0.13166775,0.308145923
North Carolina,JONES,10166,6305,3214,424,3861,0.620204604,0.041707653,0.379795396
North Carolina,LEE,59418,34689,11326,11434,24729,0.583812986,0.192433269,0.416187014
North Carolina,LENOIR,58782,29696,23197,4186,29086,0.505188663,0.071212276,0.494811337
North Carolina,LINCOLN,79578,67925,4008,5599,11653,0.853565056,0.070358642,0.146434944
North Carolina,MCDOWELL,44961,39530,1730,2531,5431,0.879206423,0.056293232,0.120793577
North Carolina,MACON,33919,30431,375,2253,3488,0.89716678,0.066422949,0.10283322
North Carolina,MADISON,21027,19780,392,496,1247,0.940695297,0.023588719,0.059304703
North Carolina,MARTIN,23729,12321,10330,840,11408,0.519238063,0.035399722,0.480761937
North Carolina,MECKLENBURG,990288,486387,301573,123971,503901,0.491157118,0.125186814,0.508842882
North Carolina,MITCHELL,15330,14294,133,699,1036,0.932420091,0.045596869,0.067579909
North Carolina,MONTGOMERY,27601,17549,5094,4121,10052,0.635810297,0.149306185,0.364189703
North Carolina,MOORE,91743,70935,11325,5710,20808,0.773192505,0.062239081,0.226807495
North Carolina,NASH,94722,49439,36019,6138,45283,0.521937881,0.064800152,0.478062119
North Carolina,NEW HANOVER,213091,163527,30410,11461,49564,0.767404536,0.053784533,0.232595464
North Carolina,NORTHAMPTON,21011,8101,11916,391,12910,0.385559945,0.0186093,0.614440055
North Carolina,ONSLOW,183753,123644,27226,21348,60109,0.672881531,0.116177695,0.327118469
North Carolina,ORANGE,138644,96748,15968,11506,41896,0.697815989,0.082989527,0.302184011
North Carolina,PAMLICO,12982,9625,2429,439,3357,0.741411185,0.033816053,0.258588815
North Carolina,PASQUOTANK,40018,21973,14745,1799,18045,0.549077915,0.04495477,0.450922085
North Carolina,PENDER,55166,40959,9440,3461,14207,0.742468187,0.062737918,0.257531813
North Carolina,PERQUIMANS,13498,9659,3276,308,3839,0.715587494,0.022818195,0.284412506
North Carolina,PERSON,39262,26061,10694,1654,13201,0.663771586,0.042127248,0.336228414
North Carolina,PITT,173798,97424,58868,10042,76374,0.56055881,0.057779721,0.43944119
North Carolina,POLK,20327,17916,1034,1151,2411,0.881389285,0.056624194,0.118610715
North Carolina,RANDOLPH,142370,114376,8151,15547,27994,0.803371497,0.109201377,0.196628503
North Carolina,RICHMOND,46046,26670,14561,2857,19376,0.579203405,0.062046649,0.420796595
North Carolina,ROBESON,134871,35850,32411,11028,99021,0.265809551,0.081767022,0.734190449
North Carolina,ROCKINGHAM,92300,67351,16770,5411,24949,0.729696641,0.058624052,0.270303359
North Carolina,ROWAN,138361,101262,22260,11100,37099,0.731868084,0.080224919,0.268131916
North Carolina,RUTHERFORD,66865,56071,6686,2592,10794,0.838570253,0.038764675,0.161429747
North Carolina,SAMPSON,63873,33478,16320,11436,30395,0.524133828,0.179042788,0.475866172
North Carolina,SCOTLAND,35932,16105,13772,960,19827,0.448207726,0.026717132,0.551792274
North Carolina,STANLY,60586,49468,6270,2336,11118,0.816492259,0.038556762,0.183507741
North Carolina,STOKES,46661,42672,1915,1311,3989,0.914511048,0.028096269,0.085488952
North Carolina,SURRY,73170,61843,2624,7349,11327,0.845196119,0.100437338,0.154803881
North Carolina,SWAIN,14163,9065,216,342,5098,0.640048012,0.024147426,0.359951988
North Carolina,TRANSYLVANIA,32928,29357,1246,1020,3571,0.891551263,0.030976676,0.108448737
North Carolina,TYRRELL,4152,2333,1262,403,1819,0.561897881,0.097061657,0.438102119
North Carolina,UNION,213422,156829,24897,23010,56593,0.734830524,0.107814565,0.265169476
North Carolina,VANCE,44829,18454,22115,3167,26375,0.411653171,0.070646233,0.588346829
North Carolina,WAKE,976019,595920,198930,97043,380099,0.610561885,0.099427368,0.389438115
North Carolina,WARREN,20468,7821,10243,772,12647,0.382108657,0.037717413,0.617891343
North Carolina,WASHINGTON,12668,5707,6195,590,6961,0.45050521,0.046574045,0.54949479
North Carolina,WATAUGA,52240,48089,570,1810,4151,0.920539816,0.034647779,0.079460184
North Carolina,WAYNE,124355,67900,38459,13362,56455,0.54601745,0.107450444,0.45398255
North Carolina,WILKES,68946,60898,3082,3977,8048,0.883270966,0.057682824,0.116729034
North Carolina,WILSON,81581,39416,31173,8103,42165,0.483151714,0.099324598,0.516848286
North Carolina,YADKIN,37971,32283,1284,3979,5688,0.85020147,0.104790498,0.14979853
North Carolina,YANCEY,17604,16371,207,830,1233,0.9299591,0.047148375,0.0700409
North Dakota,ADAMS,2341,2162,26,26,179,0.92353695,0.011106365,0.07646305
North Dakota,BARNES,11097,10403,104,174,694,0.937460575,0.015679913,0.062539425
North Dakota,BENSON,6794,2861,0,151,3933,0.421106859,0.022225493,0.578893141
North Dakota,BILLINGS,969,885,8,42,84,0.913312693,0.043343653,0.086687307
North Dakota,BOTTINEAU,6634,6158,59,119,476,0.928248417,0.017937896,0.071751583
North Dakota,BOWMAN,3221,3013,4,142,208,0.935423781,0.044085688,0.064576219
North Dakota,BURKE,2208,2054,1,117,154,0.930253623,0.05298913,0.069746377
North Dakota,BURLEIGH,88223,80347,755,1542,7876,0.910726228,0.017478435,0.089273772
North Dakota,CASS,162500,144298,4980,3805,18202,0.887987692,0.023415385,0.112012308
North Dakota,CAVALIER,3890,3742,3,0,148,0.961953728,0,0.038046272
North Dakota,DICKEY,5195,4884,77,151,311,0.940134745,0.02906641,0.059865255
North Dakota,DIVIDE,2314,2210,11,4,104,0.95505618,0.001728608,0.04494382
North Dakota,DUNN,4195,3484,4,116,711,0.830512515,0.027651967,0.169487485
North Dakota,EDDY,2370,2146,0,79,224,0.905485232,0.033333333,0.094514768
North Dakota,EMMONS,3463,3352,0,4,111,0.967946867,0.001155068,0.032053133
North Dakota,FOSTER,3366,3248,4,39,118,0.964943553,0.011586453,0.035056447
North Dakota,GOLDEN VALLEY,1822,1741,0,36,81,0.955543359,0.019758507,0.044456641
North Dakota,GRAND FORKS,68979,59526,1706,2524,9453,0.862958292,0.036590846,0.137041708
North Dakota,GRANT,2362,2292,8,20,70,0.970364098,0.008467401,0.029635902
North Dakota,GRIGGS,2329,2249,29,9,80,0.965650494,0.003864319,0.034349506
North Dakota,HETTINGER,2621,2468,19,49,153,0.941625334,0.018695155,0.058374666
North Dakota,KIDDER,2430,2302,0,122,128,0.947325103,0.050205761,0.052674897
North Dakota,LAMOURE,4113,4025,5,33,88,0.978604425,0.008023341,0.021395575
North Dakota,LOGAN,1945,1878,6,28,67,0.965552699,0.014395887,0.034447301
North Dakota,MCHENRY,5817,5542,10,140,275,0.952724772,0.024067389,0.047275228
North Dakota,MCINTOSH,2759,2644,9,25,115,0.958318231,0.009061254,0.041681769
North Dakota,MCKENZIE,9615,7372,77,268,2243,0.766718669,0.027873115,0.233281331
North Dakota,MCLEAN,9451,8466,4,206,985,0.895778225,0.021796635,0.104221775
North Dakota,MERCER,8633,8104,4,192,529,0.938723503,0.022240241,0.061276497
North Dakota,MORTON,28985,26489,187,665,2496,0.913886493,0.022942902,0.086113507
North Dakota,MOUNTRAIL,9253,5964,11,534,3289,0.644547714,0.057711013,0.355452286
North Dakota,NELSON,3048,2883,42,59,165,0.945866142,0.019356955,0.054133858
North Dakota,OLIVER,1819,1668,6,53,151,0.916987356,0.029136888,0.083012644
North Dakota,PEMBINA,7206,6686,17,230,520,0.927837913,0.031917846,0.072162087
North Dakota,PIERCE,4395,4206,23,47,189,0.956996587,0.01069397,0.043003413
North Dakota,RAMSEY,11566,9883,11,259,1683,0.85448729,0.022393222,0.14551271
North Dakota,RANSOM,5453,5221,32,87,232,0.957454612,0.01595452,0.042545388
North Dakota,RENVILLE,2562,2456,4,63,106,0.958626073,0.024590164,0.041373927
North Dakota,RICHLAND,16317,15110,76,400,1207,0.926028069,0.02451431,0.073971931
North Dakota,ROLETTE,14498,2891,76,66,11607,0.199406815,0.004552352,0.800593185
North Dakota,SARGENT,3874,3663,42,102,211,0.945534331,0.026329375,0.054465669
North Dakota,SHERIDAN,1337,1313,0,4,24,0.982049364,0.002991773,0.017950636
North Dakota,SIOUX,4380,610,2,156,3770,0.139269406,0.035616438,0.860730594
North Dakota,SLOPE,673,655,4,2,18,0.973254086,0.002971768,0.026745914
North Dakota,STARK,28628,25858,319,1246,2770,0.903241582,0.043523823,0.096758418
North Dakota,STEELE,1979,1947,0,32,32,0.983830217,0.016169783,0.016169783
North Dakota,STUTSMAN,21076,19737,110,424,1339,0.93646802,0.020117669,0.06353198
North Dakota,TOWNER,2294,2037,0,36,257,0.887968614,0.015693112,0.112031386
North Dakota,TRAILL,8077,7561,47,245,516,0.936114894,0.030333044,0.063885106
North Dakota,WALSH,11005,9433,26,1170,1572,0.857155838,0.106315311,0.142844162
North Dakota,WARD,67736,58202,2069,3151,9534,0.859247667,0.046518838,0.140752333
North Dakota,WELLS,4204,4110,0,29,94,0.977640343,0.006898192,0.022359657
North Dakota,WILLIAMS,29619,25719,532,1346,3900,0.868327763,0.045443803,0.131672237
Ohio,ADAMS,28229,27299,108,247,930,0.967055156,0.008749867,0.032944844
Ohio,ALLEN,105196,85876,12646,2813,19320,0.816342827,0.02674056,0.183657173
Ohio,ASHLAND,53189,51160,443,607,2029,0.961853015,0.011412134,0.038146985
Ohio,ASHTABULA,99777,89961,3343,3755,9816,0.901620614,0.037633924,0.098379386
Ohio,ATHENS,64974,58513,1482,1180,6461,0.900560224,0.018161111,0.099439776
Ohio,AUGLAIZE,45873,44274,207,632,1599,0.965142895,0.013777167,0.034857105
Ohio,BELMONT,69560,64816,2656,576,4744,0.931799885,0.008280621,0.068200115
Ohio,BROWN,44247,42766,436,348,1481,0.966528804,0.00786494,0.033471196
Ohio,BUTLER,372538,309123,28417,15982,63415,0.829775754,0.042900322,0.170224246
Ohio,CARROLL,28361,27415,237,317,946,0.966644336,0.011177321,0.033355664
Ohio,CHAMPAIGN,39393,36906,736,570,2487,0.936866956,0.014469576,0.063133044
Ohio,CLARK,136827,115933,11565,4113,20894,0.847296221,0.030059857,0.152703779
Ohio,CLERMONT,200285,188777,2793,3371,11508,0.942541878,0.016831016,0.057458122
Ohio,CLINTON,41892,39188,1030,672,2704,0.93545307,0.016041249,0.06454693
Ohio,COLUMBIANA,105987,100099,2307,1527,5888,0.944446017,0.014407427,0.055553983
Ohio,COSHOCTON,36724,35337,390,330,1387,0.962231783,0.008985949,0.037768217
Ohio,CRAWFORD,42725,41026,292,594,1699,0.960234055,0.013902867,0.039765945
Ohio,CUYAHOGA,1263189,762825,370327,66416,500364,0.603888254,0.052578039,0.396111746
Ohio,DARKE,52356,50549,332,728,1807,0.965486286,0.013904806,0.034513714
Ohio,DEFIANCE,38669,33645,650,3657,5024,0.870076806,0.094571879,0.129923194
Ohio,DELAWARE,185433,161561,6611,4325,23872,0.871263475,0.023323788,0.128736525
Ohio,ERIE,76141,64016,6314,2944,12125,0.840755966,0.038665108,0.159244034
Ohio,FAIRFIELD,149112,131258,9532,2936,17854,0.880264499,0.019689898,0.119735501
Ohio,FAYETTE,28769,26849,554,526,1920,0.933261497,0.018283569,0.066738503
Ohio,FRANKLIN,1215761,800021,256550,60943,415740,0.658041342,0.050127451,0.341958658
Ohio,FULTON,42485,38159,218,3474,4326,0.898175827,0.081770036,0.101824173
Ohio,GALLIA,30565,28654,759,363,1911,0.937477507,0.011876329,0.062522493
Ohio,GEAUGA,93874,89972,1232,1193,3902,0.958433645,0.012708524,0.041566355
Ohio,GREENE,164192,138632,11713,4232,25560,0.844328591,0.025774703,0.155671409
Ohio,GUERNSEY,39626,37675,614,393,1951,0.950764649,0.009917731,0.049235351
Ohio,HAMILTON,804194,537298,205489,22613,266896,0.668119882,0.028118837,0.331880118
Ohio,HANCOCK,75428,68018,998,3728,7410,0.901760619,0.049424617,0.098239381
Ohio,HARDIN,31736,30295,296,473,1441,0.954594152,0.01490421,0.045405848
Ohio,HARRISON,15633,14884,328,127,749,0.952088531,0.008123841,0.047911469
Ohio,HENRY,28015,25425,155,2000,2590,0.907549527,0.071390327,0.092450473
Ohio,HIGHLAND,43170,41360,523,352,1810,0.958072736,0.008153811,0.041927264
Ohio,HOCKING,28914,27962,237,244,952,0.967074773,0.008438819,0.032925227
Ohio,HOLMES,43436,42552,86,398,884,0.979648218,0.009162906,0.020351782
Ohio,HURON,58937,53564,650,3538,5373,0.908834858,0.060030202,0.091165142
Ohio,JACKSON,32854,31593,202,306,1261,0.961618068,0.009313934,0.038381932
Ohio,JEFFERSON,68053,61707,3806,859,6346,0.906749151,0.012622515,0.093250849
Ohio,KNOX,61004,58294,548,844,2710,0.955576683,0.013835158,0.044423317
Ohio,LAKE,229437,205905,8272,8805,23532,0.897435897,0.038376548,0.102564103
Ohio,LAWRENCE,61827,58725,1332,516,3102,0.949827745,0.008345868,0.050172255
Ohio,LICKING,168693,154496,5516,2750,14197,0.915841203,0.016301803,0.084158797
Ohio,LOGAN,45484,42793,880,612,2691,0.940836338,0.013455281,0.059163662
Ohio,LORAIN,303152,240822,23547,27411,62330,0.794393572,0.090419987,0.205606428
Ohio,LUCAS,436261,305764,80734,28558,130497,0.700874018,0.065460814,0.299125982
Ohio,MADISON,43456,38798,2532,701,4658,0.892811119,0.016131259,0.107188881
Ohio,MAHONING,234550,180423,35019,12132,54127,0.769230441,0.051724579,0.230769559
Ohio,MARION,65943,58743,3785,1575,7200,0.890814795,0.023884264,0.109185205
Ohio,MEDINA,174831,165023,2449,3198,9808,0.943900109,0.018291951,0.056099891
Ohio,MEIGS,23473,22767,261,121,706,0.96992289,0.005154859,0.03007711
Ohio,MERCER,40863,39304,178,682,1559,0.961848127,0.016689915,0.038151873
Ohio,MIAMI,103517,96412,2235,1525,7105,0.931363931,0.01473188,0.068636069
Ohio,MONROE,14547,14200,71,67,347,0.976146284,0.004605761,0.023853716
Ohio,MONTGOMERY,533763,384338,109373,13466,149425,0.720053657,0.025228425,0.279946343
Ohio,MORGAN,14913,13810,527,112,1103,0.926037685,0.007510226,0.073962315
Ohio,MORROW,34996,33692,142,466,1304,0.962738599,0.013315808,0.037261401
Ohio,MUSKINGUM,86016,79165,2823,783,6851,0.920352028,0.009102958,0.079647972
Ohio,NOBLE,14508,13391,812,130,1117,0.923007996,0.008960573,0.076992004
Ohio,OTTAWA,41162,38118,377,1956,3044,0.926048297,0.047519557,0.073951703
Ohio,PAULDING,19165,17755,164,859,1410,0.926428385,0.044821289,0.073571615
Ohio,PERRY,36025,35007,97,252,1018,0.971741846,0.006995142,0.028258154
Ohio,PICKAWAY,56515,52699,1802,724,3816,0.932478103,0.012810758,0.067521897
Ohio,PIKE,28396,27177,198,242,1219,0.957071419,0.008522327,0.042928581
Ohio,PORTAGE,161897,146480,6274,2517,15417,0.904772788,0.015546922,0.095227212
Ohio,PREBLE,41682,40383,259,285,1299,0.968835469,0.006837484,0.031164531
Ohio,PUTNAM,34184,31794,111,1966,2390,0.93008425,0.057512286,0.06991575
Ohio,RICHLAND,122312,105448,9094,2031,16864,0.862123095,0.016605076,0.137876905
Ohio,ROSS,77334,69503,4004,876,7831,0.898737942,0.011327489,0.101262058
Ohio,SANDUSKY,60187,51358,1875,5664,8829,0.853307193,0.094106701,0.146692807
Ohio,SCIOTO,78017,72985,2014,962,5032,0.935501237,0.012330646,0.064498763
Ohio,SENECA,55929,50680,1322,2660,5249,0.906148867,0.0475603,0.093851133
Ohio,SHELBY,49067,45843,1225,752,3224,0.934293925,0.015325983,0.065706075
Ohio,STARK,374979,327096,26587,6806,47883,0.872304849,0.01815035,0.127695151
Ohio,SUMMIT,541847,425784,76981,9938,116063,0.785801158,0.018340971,0.214198842
Ohio,TRUMBULL,206373,180839,16835,3268,25534,0.876272574,0.015835405,0.123727426
Ohio,TUSCARAWAS,92697,88284,783,2131,4413,0.952393281,0.022988878,0.047606719
Ohio,UNION,53470,48739,1233,778,4731,0.911520479,0.014550215,0.088479521
Ohio,VAN WERT,28576,27056,257,790,1520,0.946808511,0.027645577,0.053191489
Ohio,VINTON,13234,12836,57,22,398,0.969925948,0.001662385,0.030074052
Ohio,WARREN,219916,193119,7356,5379,26797,0.87814893,0.024459339,0.12185107
Ohio,WASHINGTON,61351,58501,677,615,2850,0.953545989,0.010024286,0.046454011
Ohio,WAYNE,115371,108671,1890,1984,6700,0.941926481,0.017196696,0.058073519
Ohio,WILLIAMS,37386,34877,405,1506,2509,0.932889317,0.040282459,0.067110683
Ohio,WOOD,128885,114708,3308,6585,14177,0.890002716,0.051092059,0.109997284
Ohio,WYANDOT,22467,21755,43,566,712,0.968309076,0.025192505,0.031690924
Oklahoma,ADAIR,22236,9292,66,1351,12944,0.417880914,0.06075733,0.582119086
Oklahoma,ALFALFA,5755,4432,110,287,1323,0.770112945,0.049869679,0.229887055
Oklahoma,ATOKA,13906,10046,541,476,3860,0.722421976,0.034229829,0.277578024
Oklahoma,BEAVER,5530,4201,31,1198,1329,0.759674503,0.216636528,0.240325497
Oklahoma,BECKHAM,23300,17864,794,3155,5436,0.766695279,0.135407725,0.233304721
Oklahoma,BLAINE,9810,7350,546,891,2460,0.749235474,0.090825688,0.250764526
Oklahoma,BRYAN,44003,31960,833,2391,12043,0.726314115,0.054337204,0.273685885
Oklahoma,CADDO,29495,17170,787,3314,12325,0.582132565,0.112358027,0.417867435
Oklahoma,CANADIAN,126193,98375,2875,9824,27818,0.779559881,0.077849009,0.220440119
Oklahoma,CARTER,48442,34580,3353,3098,13862,0.713843359,0.063952768,0.286156641
Oklahoma,CHEROKEE,48097,23788,596,3157,24309,0.494583862,0.065638189,0.505416138
Oklahoma,CHOCTAW,15120,9427,1729,539,5693,0.623478836,0.035648148,0.376521164
Oklahoma,CIMARRON,2341,1773,5,490,568,0.757368646,0.20931226,0.242631354
Oklahoma,CLEVELAND,268614,198125,12044,20850,70489,0.737582553,0.077620675,0.262417447
Oklahoma,COAL,5812,4126,20,210,1686,0.70991053,0.03613214,0.29008947
Oklahoma,COMANCHE,125531,72232,20488,15550,53299,0.575411651,0.123873784,0.424588349
Oklahoma,COTTON,6112,4721,120,428,1391,0.772414921,0.070026178,0.227585079
Oklahoma,CRAIG,14744,9539,457,460,5205,0.646975041,0.031199132,0.353024959
Oklahoma,CREEK,70761,54780,1643,2592,15981,0.774155255,0.036630347,0.225844745
Oklahoma,CUSTER,28978,20478,897,4681,8500,0.706674029,0.161536338,0.293325971
Oklahoma,DELAWARE,41409,26904,123,1394,14505,0.64971383,0.033664179,0.35028617
Oklahoma,DEWEY,4863,4094,9,301,769,0.84186716,0.061895949,0.15813284
Oklahoma,ELLIS,4121,3642,1,292,479,0.883766076,0.070856588,0.116233924
Oklahoma,GARFIELD,62192,48133,1903,6665,14059,0.773941986,0.107168125,0.226058014
Oklahoma,GARVIN,27455,21159,641,2030,6296,0.770679293,0.073939173,0.229320707
Oklahoma,GRADY,53612,44095,1111,2818,9517,0.822483772,0.052562859,0.177516228
Oklahoma,GRANT,4517,4060,17,184,457,0.898826655,0.040735001,0.101173345
Oklahoma,GREER,6117,4670,436,652,1447,0.763446134,0.106588197,0.236553866
Oklahoma,HARMON,2866,1743,188,760,1123,0.608164689,0.265177948,0.391835311
Oklahoma,HARPER,3766,2918,3,750,848,0.774827403,0.199150292,0.225172597
Oklahoma,HASKELL,12850,9264,98,502,3586,0.720933852,0.039066148,0.279066148
Oklahoma,HUGHES,13785,8987,802,629,4798,0.651940515,0.045629307,0.348059485
Oklahoma,JACKSON,26056,16724,1920,5829,9332,0.641848327,0.22371047,0.358151673
Oklahoma,JEFFERSON,6333,5000,44,589,1333,0.789515238,0.093004895,0.210484762
Oklahoma,JOHNSTON,11022,7795,202,493,3227,0.70722192,0.044728724,0.29277808
Oklahoma,KAY,45587,34665,854,3281,10922,0.760414153,0.071972273,0.239585847
Oklahoma,KINGFISHER,15302,11969,81,2226,3333,0.782185335,0.14547118,0.217814665
Oklahoma,KIOWA,9302,7025,356,966,2277,0.755213932,0.103848635,0.244786068
Oklahoma,LATIMER,10774,7303,152,349,3471,0.67783553,0.032392797,0.32216447
Oklahoma,LE FLORE,49899,36083,1197,3373,13816,0.723120704,0.067596545,0.276879296
Oklahoma,LINCOLN,34504,28798,603,1017,5706,0.834627869,0.029474843,0.165372131
Oklahoma,LOGAN,44493,34647,4027,2464,9846,0.778706763,0.055379498,0.221293237
Oklahoma,LOVE,9663,7077,178,1344,2586,0.732381248,0.13908724,0.267618752
Oklahoma,MCCLAIN,36512,29158,335,2735,7354,0.798586766,0.07490688,0.201413234
Oklahoma,MCCURTAIN,33143,21205,2720,1763,11938,0.639803277,0.053193736,0.360196723
Oklahoma,MCINTOSH,20280,13920,711,488,6360,0.686390533,0.024063116,0.313609467
Oklahoma,MAJOR,7700,6611,28,689,1089,0.858571429,0.089480519,0.141428571
Oklahoma,MARSHALL,16014,10797,236,2516,5217,0.674222555,0.157112527,0.325777445
Oklahoma,MAYES,41007,27017,164,1296,13990,0.658838735,0.03160436,0.341161265
Oklahoma,MURRAY,13733,10187,184,760,3546,0.741789849,0.055341149,0.258210151
Oklahoma,MUSKOGEE,70224,40284,7710,4005,29940,0.573650034,0.057031784,0.426349966
Oklahoma,NOBLE,11506,9486,165,355,2020,0.824439423,0.030853468,0.175560577
Oklahoma,NOWATA,10555,7111,203,299,3444,0.673709143,0.028327807,0.326290857
Oklahoma,OKFUSKEE,12248,7596,946,477,4652,0.620182887,0.038945134,0.379817113
Oklahoma,OKLAHOMA,754480,437189,110135,121246,317291,0.579457375,0.16070141,0.420542625
Oklahoma,OKMULGEE,39446,25075,3202,1453,14371,0.635679156,0.036835167,0.364320844
Oklahoma,OSAGE,48054,30896,5472,1534,17158,0.642943355,0.031922421,0.357056645
Oklahoma,OTTAWA,32085,21262,277,1639,10823,0.662677264,0.051083061,0.337322736
Oklahoma,PAWNEE,16499,12849,183,452,3650,0.778774471,0.0273956,0.221225529
Oklahoma,PAYNE,79423,61804,2841,3463,17619,0.778162497,0.043601979,0.221837503
Oklahoma,PITTSBURG,44961,31659,1498,2028,13302,0.704143591,0.045105758,0.295856409
Oklahoma,PONTOTOC,38055,25731,869,1775,12324,0.676152937,0.046643017,0.323847063
Oklahoma,POTTAWATOMIE,71136,52293,1990,3367,18843,0.735113023,0.047331871,0.264886977
Oklahoma,PUSHMATAHA,11226,8205,133,359,3021,0.730892571,0.031979334,0.269107429
Oklahoma,ROGER MILLS,3780,3210,4,246,570,0.849206349,0.065079365,0.150793651
Oklahoma,ROGERS,89190,65064,934,3680,24126,0.729498823,0.041260231,0.270501177
Oklahoma,SEMINOLE,25481,16757,1272,1127,8724,0.657627252,0.044229033,0.342372748
Oklahoma,SEQUOYAH,41464,26709,779,1552,14755,0.644149141,0.03743006,0.355850859
Oklahoma,STEPHENS,44806,36451,853,3063,8355,0.813529438,0.06836138,0.186470562
Oklahoma,TEXAS,21588,10304,471,9759,11284,0.477302205,0.452056698,0.522697795
Oklahoma,TILLMAN,7715,4796,587,1885,2919,0.621646144,0.244329229,0.378353856
Oklahoma,TULSA,623335,398866,62014,72657,224469,0.639890268,0.11656172,0.360109732
Oklahoma,WAGONER,75391,54776,2659,4067,20615,0.726558873,0.053945431,0.273441127
Oklahoma,WASHINGTON,51760,38431,1330,2864,13329,0.742484544,0.055332303,0.257515456
Oklahoma,WASHITA,11649,9823,6,1069,1826,0.843248347,0.091767534,0.156751653
Oklahoma,WOODS,9033,7675,290,529,1358,0.849662349,0.058563047,0.150337651
Oklahoma,WOODWARD,20986,17081,132,2412,3905,0.813923568,0.114933765,0.186076432
Oregon,BAKER,16052,14735,41,603,1317,0.917954149,0.037565412,0.082045851
Oregon,BENTON,86495,71146,736,5975,15349,0.822544656,0.069079138,0.177455344
Oregon,CLACKAMAS,389438,324872,3162,31871,64566,0.834207242,0.081838444,0.165792758
Oregon,CLATSOP,37382,32291,277,3014,5091,0.86381146,0.08062704,0.13618854
Oregon,COLUMBIA,49389,44188,235,2249,5201,0.89469315,0.045536455,0.10530685
Oregon,COOS,62775,53860,380,3735,8915,0.857984867,0.059498208,0.142015133
Oregon,CROOK,20956,18602,58,1545,2354,0.887669403,0.073725902,0.112330597
Oregon,CURRY,22338,19545,73,1404,2793,0.874966425,0.062852538,0.125033575
Oregon,DESCHUTES,166622,146449,734,12831,20173,0.878929553,0.077006638,0.121070447
Oregon,DOUGLAS,107194,95193,340,5553,12001,0.888044107,0.051803273,0.111955893
Oregon,GILLIAM,1883,1697,18,147,186,0.901221455,0.078066914,0.098778545
Oregon,GRANT,7276,6712,24,254,564,0.922484882,0.034909291,0.077515118
Oregon,HARNEY,7229,6346,47,334,883,0.877853092,0.046202794,0.122146908
Oregon,HOOD RIVER,22749,14749,112,6948,8000,0.648336191,0.305420018,0.351663809
Oregon,JACKSON,208363,171619,1324,24496,36744,0.823653912,0.117564059,0.176346088
Oregon,JEFFERSON,22061,13369,199,4323,8692,0.606001541,0.195956666,0.393998459
Oregon,JOSEPHINE,83409,73198,283,5731,10211,0.877579158,0.068709612,0.122420842
Oregon,KLAMATH,65972,52552,529,7641,13420,0.796580367,0.115821864,0.203419633
Oregon,LAKE,7842,6711,29,603,1131,0.855776588,0.07689365,0.144223412
Oregon,LANE,357060,297692,3395,28768,59368,0.833731026,0.080569092,0.166268974
Oregon,LINCOLN,46347,38590,155,3912,7757,0.832632101,0.084406758,0.167367899
Oregon,LINN,118971,102802,521,9856,16169,0.86409293,0.082843718,0.13590707
Oregon,MALHEUR,30551,19009,290,9987,11542,0.622205492,0.32689601,0.377794508
Oregon,MARION,323259,216600,3128,81907,106659,0.67005095,0.25337887,0.32994905
Oregon,MORROW,11204,6941,49,3811,4263,0.619510889,0.340146376,0.380489111
Oregon,MULTNOMAH,768418,547919,40815,85202,220499,0.713048107,0.110879756,0.286951893
Oregon,POLK,77264,61558,525,9910,15706,0.796722924,0.128261545,0.203277076
Oregon,SHERMAN,1795,1525,10,128,270,0.849582173,0.071309192,0.150417827
Oregon,TILLAMOOK,25430,21691,59,2539,3739,0.852968934,0.099842705,0.147031066
Oregon,UMATILLA,76738,52015,530,19377,24723,0.677825849,0.252508536,0.322174151
Oregon,UNION,25745,23104,151,1130,2641,0.897416974,0.043892018,0.102583026
Oregon,WALLOWA,6857,6415,21,183,442,0.935540324,0.026688056,0.064459676
Oregon,WASCO,25492,19387,107,4215,6105,0.760513102,0.165345991,0.239486898
Oregon,WASHINGTON,556210,379525,9778,89846,176685,0.682341202,0.161532515,0.317658798
Oregon,WHEELER,1348,1291,0,19,57,0.957715134,0.014094955,0.042284866
Oregon,YAMHILL,101119,79112,970,15599,22007,0.782365332,0.154263788,0.217634668
Pennsylvania,ADAMS,101767,91434,1510,6613,10333,0.898464139,0.064981772,0.101535861
Pennsylvania,ALLEGHENY,1231145,980112,158380,22537,251033,0.796097941,0.018305724,0.203902059
Pennsylvania,ARMSTRONG,67979,66206,636,445,1773,0.973918416,0.006546139,0.026081584
Pennsylvania,BEAVER,169785,152737,10121,2340,17048,0.899590659,0.013782136,0.100409341
Pennsylvania,BEDFORD,49086,47663,245,516,1423,0.971010064,0.010512162,0.028989936
Pennsylvania,BERKS,413965,309200,17025,75409,104765,0.746923049,0.182162743,0.253076951
Pennsylvania,BLAIR,126448,120251,1999,1404,6197,0.950991712,0.011103378,0.049008288
Pennsylvania,BRADFORD,62228,59889,328,883,2339,0.962412419,0.014189754,0.037587581
Pennsylvania,BUCKS,626583,535979,23174,29708,90604,0.855399843,0.047412713,0.144600157
Pennsylvania,BUTLER,185689,176986,1992,2354,8703,0.953131311,0.012677111,0.046868689
Pennsylvania,CAMBRIA,139381,129671,4531,2149,9710,0.930334838,0.01541817,0.069665162
Pennsylvania,CAMERON,4869,4737,30,34,132,0.97288971,0.006982953,0.02711029
Pennsylvania,CARBON,64634,59990,872,2526,4644,0.928149271,0.039081598,0.071850729
Pennsylvania,CENTRE,157823,136652,5484,4317,21171,0.865856054,0.027353428,0.134143946
Pennsylvania,CHESTER,509797,412444,29506,35579,97353,0.809035753,0.069790524,0.190964247
Pennsylvania,CLARION,39454,38058,429,282,1396,0.964617022,0.007147564,0.035382978
Pennsylvania,CLEARFIELD,81343,75983,1822,2250,5360,0.934106192,0.027660647,0.065893808
Pennsylvania,CLINTON,39614,37786,547,528,1828,0.953854698,0.013328621,0.046145302
Pennsylvania,COLUMBIA,66912,62661,1216,1644,4251,0.936468795,0.024569584,0.063531205
Pennsylvania,CRAWFORD,87343,83136,1545,1017,4207,0.951833576,0.011643749,0.048166424
Pennsylvania,CUMBERLAND,241427,212171,8027,7844,29256,0.878820513,0.032490152,0.121179487
Pennsylvania,DAUPHIN,271094,185458,46997,21597,85636,0.684109571,0.079666094,0.315890429
Pennsylvania,DELAWARE,561683,388429,113923,19073,173254,0.691544875,0.033956876,0.308455125
Pennsylvania,ELK,31370,30619,144,223,751,0.97605993,0.007108703,0.02394007
Pennsylvania,ERIE,279858,239185,18730,10572,40673,0.85466558,0.037776301,0.14533442
Pennsylvania,FAYETTE,134851,124606,5457,1350,10245,0.92402726,0.010011049,0.07597274
Pennsylvania,FOREST,7581,4862,2027,487,2719,0.641340193,0.064239546,0.358659807
Pennsylvania,FRANKLIN,152285,135822,5470,7400,16463,0.891893489,0.048593098,0.108106511
Pennsylvania,FULTON,14694,14182,188,157,512,0.965155846,0.010684633,0.034844154
Pennsylvania,GREENE,37938,34601,1808,857,3337,0.912040698,0.022589488,0.087959302
Pennsylvania,HUNTINGDON,45906,41877,2342,816,4029,0.912233695,0.017775454,0.087766305
Pennsylvania,INDIANA,87895,82505,2050,1150,5390,0.93867683,0.013083793,0.06132317
Pennsylvania,JEFFERSON,44756,43615,231,341,1141,0.974506211,0.00761909,0.025493789
Pennsylvania,JUNIATA,24829,23640,188,725,1189,0.952112449,0.029199726,0.047887551
Pennsylvania,LACKAWANNA,213459,187898,5770,12664,25561,0.880253351,0.059327552,0.119746649
Pennsylvania,LANCASTER,530216,442338,18448,50765,87878,0.83426,0.095743999,0.16574
Pennsylvania,LAWRENCE,89162,82297,3339,1047,6865,0.923005316,0.011742671,0.076994684
Pennsylvania,LEBANON,135776,115056,2324,14951,20720,0.847395711,0.11011519,0.152604289
Pennsylvania,LEHIGH,356756,244451,18254,75169,112305,0.685205014,0.210701432,0.314794986
Pennsylvania,LUZERNE,320095,274232,10395,27638,45863,0.856720661,0.086343117,0.143279339
Pennsylvania,LYCOMING,116656,106063,5517,2031,10593,0.909194555,0.017410163,0.090805445
Pennsylvania,MCKEAN,42884,40239,968,861,2645,0.938321985,0.020077418,0.061678015
Pennsylvania,MERCER,115320,104346,6497,1481,10974,0.90483871,0.012842525,0.09516129
Pennsylvania,MIFFLIN,46675,45025,330,609,1650,0.96464917,0.01304767,0.03535083
Pennsylvania,MONROE,167881,114983,21343,23909,52898,0.684907762,0.142416354,0.315092238
Pennsylvania,MONTGOMERY,812970,629397,70479,37577,183573,0.77419462,0.046221878,0.22580538
Pennsylvania,MONTOUR,18508,17125,296,444,1383,0.925275557,0.023989626,0.074724443
Pennsylvania,NORTHAMPTON,299616,236265,13450,35040,63351,0.788559356,0.116949696,0.211440644
Pennsylvania,NORTHUMBERLAND,94006,87685,2372,2732,6321,0.932759611,0.029061975,0.067240389
Pennsylvania,PERRY,45677,43849,376,733,1828,0.959979859,0.016047464,0.040020141
Pennsylvania,PHILADELPHIA,1555072,557211,645130,207721,997861,0.358318457,0.133576452,0.641681543
Pennsylvania,PIKE,56632,46303,3129,5582,10329,0.817611951,0.098566182,0.182388049
Pennsylvania,POTTER,17377,16837,92,193,540,0.96892444,0.011106635,0.03107556
Pennsylvania,SCHUYLKILL,146360,135013,3826,5002,11347,0.922471987,0.034176004,0.077528013
Pennsylvania,SNYDER,40046,38228,381,822,1818,0.954602207,0.020526395,0.045397793
Pennsylvania,SOMERSET,76617,72758,1965,993,3859,0.949632588,0.01296057,0.050367412
Pennsylvania,SULLIVAN,6381,5968,151,112,413,0.935276602,0.017552108,0.064723398
Pennsylvania,SUSQUEHANNA,42369,40911,228,702,1458,0.965588048,0.016568718,0.034411952
Pennsylvania,TIOGA,42284,40665,291,551,1619,0.961711286,0.013030934,0.038288714
Pennsylvania,UNION,44958,38055,2934,2526,6903,0.846456693,0.056185773,0.153543307
Pennsylvania,VENANGO,53906,51809,423,562,2097,0.96109895,0.010425556,0.03890105
Pennsylvania,WARREN,40962,39800,186,383,1162,0.971632245,0.009350129,0.028367755
Pennsylvania,WASHINGTON,208226,193432,5996,2935,14794,0.928952196,0.014095262,0.071047804
Pennsylvania,WAYNE,51642,47068,1655,2074,4574,0.911428682,0.040161109,0.088571318
Pennsylvania,WESTMORELAND,361251,340727,8340,3769,20524,0.943186316,0.010433189,0.056813684
Pennsylvania,WYOMING,28147,26954,199,499,1193,0.957615376,0.017728355,0.042384624
Pennsylvania,YORK,439660,373619,22942,28334,66041,0.849790747,0.064445253,0.150209253
Rhode Island,BRISTOL,49176,45959,578,1164,3217,0.93458191,0.023670083,0.06541809
Rhode Island,KENT,164958,148775,2183,6549,16183,0.90189624,0.039701015,0.09810376
Rhode Island,NEWPORT,82663,71438,2615,4261,11225,0.864207687,0.051546641,0.135792313
Rhode Island,PROVIDENCE,630459,403279,49082,128218,227180,0.639659359,0.203372464,0.360340641
Rhode Island,WASHINGTON,126405,115794,1836,3596,10611,0.916055536,0.028448242,0.083944464
South Carolina,ABBEVILLE,24997,17229,6986,301,7768,0.689242709,0.012041445,0.310757291
South Carolina,AIKEN,163908,110091,40325,8614,53817,0.671663372,0.052553872,0.328336628
South Carolina,ALLENDALE,9838,2286,7258,277,7552,0.232364302,0.028156129,0.767635698
South Carolina,ANDERSON,191215,148792,30984,6397,42423,0.77813979,0.033454488,0.22186021
South Carolina,BAMBERG,15432,5477,9615,193,9955,0.354911871,0.01250648,0.645088129
South Carolina,BARNWELL,22098,11366,9892,512,10732,0.51434519,0.023169518,0.48565481
South Carolina,BEAUFORT,171420,114710,31600,19657,56710,0.669175125,0.114671567,0.330824875
South Carolina,BERKELEY,193613,123907,47090,11724,69706,0.639972523,0.060553785,0.360027477
South Carolina,CALHOUN,14958,7978,6330,484,6980,0.533360075,0.032357267,0.466639925
South Carolina,CHARLESTON,372904,235661,106155,19052,137243,0.631961577,0.051090897,0.368038423
South Carolina,CHEROKEE,55863,40918,11240,2231,14945,0.732470508,0.039936989,0.267529492
South Carolina,CHESTER,32556,19197,12373,562,13359,0.589660892,0.017262563,0.410339108
South Carolina,CHESTERFIELD,46192,28331,15287,1829,17861,0.613331313,0.039595601,0.386668687
South Carolina,CLARENDON,34178,16098,16636,976,18080,0.47100474,0.028556381,0.52899526
South Carolina,COLLETON,38004,21362,14497,1125,16642,0.562098726,0.029602147,0.437901274
South Carolina,DARLINGTON,67922,37556,27588,1282,30366,0.552928359,0.018874591,0.447071641
South Carolina,DILLON,31435,14715,14370,798,16720,0.468108796,0.025385717,0.531891204
South Carolina,DORCHESTER,145715,94831,36673,6980,50884,0.65079779,0.047901726,0.34920221
South Carolina,EDGEFIELD,26466,14896,9672,1495,11570,0.562835336,0.056487569,0.437164664
South Carolina,FAIRFIELD,23108,8753,13256,434,14355,0.378786567,0.018781374,0.621213433
South Carolina,FLORENCE,138330,73636,57362,3286,64694,0.532321261,0.023754789,0.467678739
South Carolina,GEORGETOWN,60572,37991,19696,1875,22581,0.627203989,0.030954897,0.372796011
South Carolina,GREENVILLE,474903,330124,85657,40776,144779,0.69513985,0.085861744,0.30486015
South Carolina,GREENWOOD,69771,42193,21326,3995,27578,0.604735492,0.057258746,0.395264508
South Carolina,HAMPTON,20473,8446,11015,790,12027,0.41254335,0.038587408,0.58745665
South Carolina,HORRY,290730,223819,39099,17639,66911,0.769851752,0.060671413,0.230148248
South Carolina,JASPER,26549,10710,11626,3713,15839,0.403405025,0.139854608,0.596594975
South Carolina,KERSHAW,62722,43207,15491,2542,19515,0.688865151,0.040528044,0.311134849
South Carolina,LANCASTER,81263,56912,18512,3973,24351,0.70034333,0.048890639,0.29965667
South Carolina,LAURENS,66389,45381,16803,2866,21008,0.683562036,0.043169802,0.316437964
South Carolina,LEE,18461,6028,11634,393,12433,0.32652619,0.021288121,0.67347381
South Carolina,LEXINGTON,273843,208072,39461,15579,65771,0.759822234,0.056890262,0.240177766
South Carolina,MCCORMICK,9895,4809,4768,115,5086,0.486003032,0.011622031,0.513996968
South Carolina,MARION,32167,12676,17920,866,19491,0.394068455,0.026922001,0.605931545
South Carolina,MARLBORO,27993,11137,14186,872,16856,0.397849462,0.031150645,0.602150538
South Carolina,NEWBERRY,37690,22675,11306,2747,15015,0.601618466,0.072884054,0.398381534
South Carolina,OCONEE,74949,63932,5561,3616,11017,0.853006711,0.048246141,0.146993289
South Carolina,ORANGEBURG,90575,30444,55836,1846,60131,0.336119238,0.0203809,0.663880762
South Carolina,PICKENS,120124,103895,7974,3995,16229,0.864897939,0.033257301,0.135102061
South Carolina,RICHLAND,397899,176322,180888,19766,221577,0.443132554,0.049675923,0.556867446
South Carolina,SALUDA,20000,11646,5201,2965,8354,0.5823,0.14825,0.4177
South Carolina,SPARTANBURG,291240,201442,59733,18252,89798,0.6916701,0.062669963,0.3083299
South Carolina,SUMTER,107777,50128,49801,4010,57649,0.465108511,0.037206454,0.534891489
South Carolina,UNION,28125,18436,8802,329,9689,0.655502222,0.011697778,0.344497778
South Carolina,WILLIAMSBURG,33238,10427,21762,738,22811,0.313707203,0.022203502,0.686292797
South Carolina,YORK,240076,172474,45212,11625,67602,0.718414169,0.048422166,0.281585831
South Dakota,AURORA,2729,2457,11,166,272,0.900329791,0.060828142,0.099670209
South Dakota,BEADLE,18168,14745,45,1622,3423,0.81159181,0.089277851,0.18840819
South Dakota,BENNETT,3438,1042,33,140,2396,0.303083188,0.04072135,0.696916812
South Dakota,BON HOMME,7013,6174,70,280,839,0.880365036,0.039925852,0.119634964
South Dakota,BROOKINGS,33046,30143,414,775,2903,0.912152757,0.023452158,0.087847243
South Dakota,BROWN,38060,34218,573,857,3842,0.899054125,0.022517078,0.100945875
South Dakota,BRULE,5330,4574,0,22,756,0.858161351,0.00412758,0.141838649
South Dakota,BUFFALO,2038,377,4,21,1661,0.18498528,0.01030422,0.81501472
South Dakota,BUTTE,10292,9444,7,358,848,0.917605908,0.034784298,0.082394092
South Dakota,CAMPBELL,1548,1469,0,3,79,0.948966408,0.001937984,0.051033592
South Dakota,CHARLES MIX,9239,5845,4,232,3394,0.632644226,0.025110943,0.367355774
South Dakota,CLARK,3625,3400,28,92,225,0.937931034,0.02537931,0.062068966
South Dakota,CLAY,14011,12445,208,356,1566,0.888230676,0.025408608,0.111769324
South Dakota,CODINGTON,27750,25946,115,517,1804,0.934990991,0.018630631,0.065009009
South Dakota,CORSON,4149,1284,12,24,2865,0.309472162,0.005784526,0.690527838
South Dakota,CUSTER,8394,7646,23,244,748,0.91088873,0.029068382,0.08911127
South Dakota,DAVISON,19787,18286,95,435,1501,0.924142114,0.021984131,0.075857886
South Dakota,DAY,5618,4889,0,109,729,0.870238519,0.019401922,0.129761481
South Dakota,DEUEL,4341,4167,30,131,174,0.95991707,0.030177378,0.04008293
South Dakota,DEWEY,5579,1212,2,51,4367,0.217243234,0.009141423,0.782756766
South Dakota,DOUGLAS,2973,2828,0,26,145,0.951227716,0.008745375,0.048772284
South Dakota,EDMUNDS,4018,3885,5,51,133,0.966898955,0.012692882,0.033101045
South Dakota,FALL RIVER,6906,5924,78,229,982,0.857804807,0.033159571,0.142195193
South Dakota,FAULK,2359,2219,0,95,140,0.940652819,0.040271301,0.059347181
South Dakota,GRANT,7227,6852,26,202,375,0.948111249,0.02795074,0.051888751
South Dakota,GREGORY,4226,3735,0,34,491,0.883814482,0.008045433,0.116185518
South Dakota,HAAKON,2083,1853,8,0,230,0.889582333,0,0.110417667
South Dakota,HAMLIN,5982,5698,7,187,284,0.952524239,0.031260448,0.047475761
South Dakota,HAND,3375,3288,0,47,87,0.974222222,0.013925926,0.025777778
South Dakota,HANSON,3386,3141,118,33,245,0.927643237,0.009746013,0.072356763
South Dakota,HARDING,1328,1256,9,15,72,0.945783133,0.011295181,0.054216867
South Dakota,HUGHES,17466,14386,132,468,3080,0.823657392,0.026794916,0.176342608
South Dakota,HUTCHINSON,7226,6897,14,136,329,0.95446997,0.018820924,0.04553003
South Dakota,HYDE,1413,1238,0,10,175,0.876150035,0.007077141,0.123849965
South Dakota,JACKSON,3237,1458,5,75,1779,0.450417053,0.023169601,0.549582947
South Dakota,JERAULD,2031,1953,0,51,78,0.961595273,0.025110783,0.038404727
South Dakota,JONES,781,736,16,2,45,0.942381562,0.002560819,0.057618438
South Dakota,KINGSBURY,5107,4871,31,108,236,0.953788917,0.021147445,0.046211083
South Dakota,LAKE,12086,11375,72,263,711,0.941171604,0.021760715,0.058828396
South Dakota,LAWRENCE,24645,22507,110,764,2138,0.913248123,0.031000203,0.086751877
South Dakota,LINCOLN,49874,46879,516,846,2995,0.939948671,0.016962746,0.060051329
South Dakota,LYMAN,3837,2214,0,13,1623,0.577013292,0.003388064,0.422986708
South Dakota,MCCOOK,5613,5357,21,155,256,0.954391591,0.027614466,0.045608409
South Dakota,MCPHERSON,2263,2070,5,47,193,0.91471498,0.020768891,0.08528502
South Dakota,MARSHALL,4701,3919,29,227,782,0.833652414,0.048287598,0.166347586
South Dakota,MEADE,26381,23306,442,1046,3075,0.883438839,0.039649748,0.116561161
South Dakota,MELLETTE,2086,821,0,94,1265,0.393576222,0.04506232,0.606423778
South Dakota,MINER,2306,2183,22,45,123,0.946660885,0.01951431,0.053339115
South Dakota,MINNEHAHA,178942,151253,7422,8300,27689,0.845262711,0.046383744,0.154737289
South Dakota,MOODY,6439,5092,48,190,1347,0.790806026,0.029507688,0.209193974
South Dakota,OGLALA LAKOTA,14153,673,68,148,13480,0.047551756,0.010457147,0.952448244
South Dakota,PENNINGTON,106085,85568,1242,4934,20517,0.806598482,0.046509874,0.193401518
South Dakota,PERKINS,2981,2850,3,48,131,0.956055015,0.016101979,0.043944985
South Dakota,POTTER,2307,2139,0,20,168,0.927178153,0.008669267,0.072821847
South Dakota,ROBERTS,10318,6082,43,240,4236,0.589455321,0.023260322,0.410544679
South Dakota,SANBORN,2339,2274,0,44,65,0.972210346,0.018811458,0.027789654
South Dakota,SPINK,6570,6247,14,130,323,0.950837139,0.01978691,0.049162861
South Dakota,STANLEY,2962,2640,0,43,322,0.891289669,0.014517218,0.108710331
South Dakota,SULLY,1469,1434,0,9,35,0.976174268,0.006126617,0.023825732
South Dakota,TODD,9942,996,33,365,8946,0.10018105,0.036712935,0.89981895
South Dakota,TRIPP,5504,4516,5,33,988,0.820494186,0.00599564,0.179505814
South Dakota,TURNER,8302,7953,46,162,349,0.957961937,0.01951337,0.042038063
South Dakota,UNION,14842,13802,47,445,1040,0.929928581,0.029982482,0.070071419
South Dakota,WALWORTH,5495,4468,11,257,1027,0.813102821,0.046769791,0.186897179
South Dakota,YANKTON,22636,20428,462,738,2208,0.902456264,0.032602933,0.097543736
South Dakota,ZIEBACH,2833,672,8,104,2161,0.237204377,0.036710201,0.762795623
Tennessee,ANDERSON,75430,67885,2840,1884,7545,0.899973485,0.0249768,0.100026515
Tennessee,BEDFORD,45986,35916,3053,5318,10070,0.781020311,0.115643892,0.218979689
Tennessee,BENTON,16261,15175,563,339,1086,0.933214439,0.020847426,0.066785561
Tennessee,BLEDSOE,13686,12372,573,305,1314,0.903989478,0.022285547,0.096010522
Tennessee,BLOUNT,125188,114671,3616,3717,10517,0.915990351,0.029691344,0.084009649
Tennessee,BRADLEY,102062,88921,4649,5482,13141,0.87124493,0.053712449,0.12875507
Tennessee,CAMPBELL,40176,38847,205,506,1329,0.96692055,0.012594584,0.03307945
Tennessee,CANNON,13787,13055,221,251,732,0.946906506,0.018205556,0.053093494
Tennessee,CARROLL,28353,24144,2934,652,4209,0.851550101,0.022995803,0.148449899
Tennessee,CARTER,56941,54280,729,935,2661,0.953267417,0.016420505,0.046732583
Tennessee,CHEATHAM,39422,36956,637,1029,2466,0.937446096,0.026102176,0.062553904
Tennessee,CHESTER,17324,14888,1821,417,2436,0.859385823,0.024070653,0.140614177
Tennessee,CLAIBORNE,31748,30341,334,318,1407,0.955682248,0.010016379,0.044317752
Tennessee,CLAY,7780,7408,128,142,372,0.95218509,0.018251928,0.04781491
Tennessee,COCKE,35321,33088,547,723,2233,0.936779819,0.020469409,0.063220181
Tennessee,COFFEE,53448,47782,1004,2103,5666,0.893990421,0.039346655,0.106009579
Tennessee,CROCKETT,14600,11057,1912,1387,3543,0.757328767,0.095,0.242671233
Tennessee,CUMBERLAND,57455,54547,341,1556,2908,0.949386476,0.027082064,0.050613524
Tennessee,DAVIDSON,658506,374311,180490,65133,284195,0.568424585,0.09891026,0.431575415
Tennessee,DECATUR,11686,10742,325,348,944,0.919219579,0.029779223,0.080780421
Tennessee,DEKALB,19038,17083,233,1370,1955,0.897310642,0.07196134,0.102689358
Tennessee,DICKSON,50472,45453,1972,1592,5019,0.900558726,0.031542241,0.099441274
Tennessee,DYER,38054,30552,5078,1149,7502,0.802859095,0.030193935,0.197140905
Tennessee,FAYETTE,38814,26453,10697,961,12361,0.681532437,0.024759108,0.318467563
Tennessee,FENTRESS,17931,17401,29,225,530,0.970442251,0.012548101,0.029557749
Tennessee,FRANKLIN,41138,36709,1282,1147,4429,0.892337984,0.027881764,0.107662016
Tennessee,GIBSON,49572,38409,9156,1191,11163,0.774812394,0.02402566,0.225187606
Tennessee,GILES,28949,24557,2905,562,4392,0.848284915,0.019413451,0.151715085
Tennessee,GRAINGER,22736,21680,175,597,1056,0.953553835,0.026257917,0.046446165
Tennessee,GREENE,68576,64067,1416,1846,4509,0.934248133,0.026919039,0.065751867
Tennessee,GRUNDY,13524,11055,32,64,2469,0.81743567,0.004732328,0.18256433
Tennessee,HAMBLEN,62999,51892,2321,6948,11107,0.823695614,0.110287465,0.176304386
Tennessee,HAMILTON,348121,249305,68414,17138,98816,0.716144674,0.049230009,0.283855326
Tennessee,HANCOCK,6642,6466,30,4,176,0.973501957,0.000602228,0.026498043
Tennessee,HARDEMAN,26253,14455,10981,406,11798,0.550603741,0.015464899,0.449396259
Tennessee,HARDIN,25900,23887,816,510,2013,0.922277992,0.01969112,0.077722008
Tennessee,HAWKINS,56595,54017,791,750,2578,0.954448273,0.013252054,0.045551727
Tennessee,HAYWOOD,18248,8242,8944,759,10006,0.451665936,0.041593599,0.548334064
Tennessee,HENDERSON,28013,24583,2126,620,3430,0.877556849,0.022132581,0.122443151
Tennessee,HENRY,32269,28258,2771,691,4011,0.875701137,0.021413741,0.124298863
Tennessee,HICKMAN,24283,22041,1172,501,2242,0.907672034,0.020631718,0.092327966
Tennessee,HOUSTON,8290,7674,223,172,616,0.925693607,0.020747889,0.074306393
Tennessee,HUMPHREYS,18240,17044,589,372,1196,0.934429825,0.020394737,0.065570175
Tennessee,JACKSON,11496,11041,82,204,455,0.960421016,0.017745303,0.039578984
Tennessee,JEFFERSON,52490,48509,1322,1802,3981,0.924156982,0.034330349,0.075843018
Tennessee,JOHNSON,18017,16664,711,307,1353,0.924904257,0.017039463,0.075095743
Tennessee,KNOX,444348,369088,39819,16857,75260,0.830628246,0.037936482,0.169371754
Tennessee,LAKE,7687,5201,2029,292,2486,0.676596852,0.03798621,0.323403148
Tennessee,LAUDERDALE,27427,16680,9610,621,10747,0.608159842,0.022641922,0.391840158
Tennessee,LAWRENCE,42226,39777,803,784,2449,0.942002558,0.01856676,0.057997442
Tennessee,LEWIS,11944,11165,191,250,779,0.934778969,0.020931011,0.065221031
Tennessee,LINCOLN,33550,29364,1733,1017,4186,0.875230999,0.030312966,0.124769001
Tennessee,LOUDON,50229,44666,634,3861,5563,0.889247248,0.076867945,0.110752752
Tennessee,MCMINN,52506,47246,2126,1729,5260,0.899820973,0.03292957,0.100179027
Tennessee,MCNAIRY,26103,23552,1620,481,2551,0.90227177,0.018427001,0.09772823
Tennessee,MACON,22761,21054,66,1103,1707,0.925003295,0.048460085,0.074996705
Tennessee,MADISON,98184,55970,36327,3469,42214,0.570052147,0.035331622,0.429947853
Tennessee,MARION,28306,26129,422,437,2177,0.923090511,0.015438423,0.076909489
Tennessee,MARSHALL,31159,26795,2186,1520,4364,0.859944157,0.048782053,0.140055843
Tennessee,MAURY,84089,67178,9830,4353,16911,0.798891651,0.051766581,0.201108349
Tennessee,MEIGS,11716,11113,187,163,603,0.948531922,0.013912598,0.051468078
Tennessee,MONROE,45293,41442,968,1744,3851,0.914975824,0.038504846,0.085024176
Tennessee,MONTGOMERY,185980,121791,34737,17214,64189,0.654860738,0.09255834,0.345139262
Tennessee,MOORE,6351,5969,245,24,382,0.939851992,0.003778932,0.060148008
Tennessee,MORGAN,21794,20354,940,246,1440,0.933926769,0.01128751,0.066073231
Tennessee,OBION,31129,26141,3226,1123,4988,0.839763565,0.036075685,0.160236435
Tennessee,OVERTON,22100,21311,179,276,789,0.964298643,0.012488688,0.035701357
Tennessee,PERRY,7864,7323,220,166,541,0.931205493,0.02110885,0.068794507
Tennessee,PICKETT,5097,4961,38,18,136,0.973317638,0.003531489,0.026682362
Tennessee,POLK,16687,15941,48,283,746,0.955294541,0.01695931,0.044705459
Tennessee,PUTNAM,73810,65883,1748,4199,7927,0.892602628,0.05688931,0.107397372
Tennessee,RHEA,32394,29566,796,1422,2828,0.912699883,0.043897018,0.087300117
Tennessee,ROANE,53162,49564,1404,847,3598,0.932320078,0.015932433,0.067679922
Tennessee,ROBERTSON,67426,56759,5002,4134,10667,0.841796933,0.06131166,0.158203067
Tennessee,RUTHERFORD,282558,209062,37745,20089,73496,0.739890571,0.071096908,0.260109429
Tennessee,SCOTT,22043,21520,49,161,523,0.976273647,0.007303906,0.023726353
Tennessee,SEQUATCHIE,14592,12620,31,498,1972,0.864857456,0.034128289,0.135142544
Tennessee,SEVIER,93617,85222,618,5041,8395,0.910326116,0.053847058,0.089673884
Tennessee,SHELBY,937750,351310,492349,55338,586440,0.374630765,0.059011464,0.625369235
Tennessee,SMITH,19136,17883,432,479,1253,0.934521321,0.025031355,0.065478679
Tennessee,STEWART,13286,12230,207,317,1056,0.920517838,0.023859702,0.079482162
Tennessee,SULLIVAN,156752,147096,2978,2600,9656,0.93839951,0.01658671,0.06160049
Tennessee,SUMNER,169623,145753,11666,7137,23870,0.859276159,0.042075662,0.140723841
Tennessee,TIPTON,61674,46986,11124,1536,14688,0.761844537,0.024905146,0.238155463
Tennessee,TROUSDALE,7884,6744,943,28,1140,0.855403349,0.003551497,0.144596651
Tennessee,UNICOI,18069,16989,138,768,1080,0.940229122,0.042503736,0.059770878
Tennessee,UNION,19096,18458,107,272,638,0.966589862,0.014243821,0.033410138
Tennessee,VAN BUREN,5596,5367,31,64,229,0.959077913,0.011436741,0.040922087
Tennessee,WARREN,40015,34599,502,3361,5416,0.864650756,0.083993502,0.135349244
Tennessee,WASHINGTON,125317,112210,4878,3968,13107,0.895409242,0.031663701,0.104590758
Tennessee,WAYNE,16897,15319,1043,306,1578,0.906610641,0.018109724,0.093389359
Tennessee,WEAKLEY,34415,29970,3124,769,4445,0.870841203,0.022344908,0.129158797
Tennessee,WHITE,26252,24675,454,535,1577,0.939928386,0.0203794,0.060071614
Tennessee,WILLIAMSON,199456,171187,8696,9320,28269,0.858269493,0.046727098,0.141730507
Tennessee,WILSON,122445,105803,8201,4437,16642,0.864085916,0.036236678,0.135914084
Texas,ANDERSON,57915,34836,12239,9749,23079,0.601502202,0.168332902,0.398497798
Texas,ANDREWS,16775,7223,212,8925,9552,0.430581222,0.532041729,0.569418778
Texas,ANGELINA,87748,54335,13061,18353,33413,0.619216392,0.209155764,0.380783608
Texas,ARANSAS,24292,16581,367,6343,7711,0.682570394,0.26111477,0.317429606
Texas,ARCHER,8779,7797,56,708,982,0.888142157,0.080646999,0.111857843
Texas,ARMSTRONG,1943,1641,12,230,302,0.844570252,0.118373649,0.155429748
Texas,ATASCOSA,47050,16460,369,29541,30590,0.349840595,0.627863974,0.650159405
Texas,AUSTIN,28886,18457,2517,7327,10429,0.63896005,0.253652288,0.36103995
Texas,BAILEY,7126,2673,132,4280,4453,0.375105248,0.600617457,0.624894752
Texas,BANDERA,20796,16536,294,3644,4260,0.795152914,0.175226005,0.204847086
Texas,BASTROP,76948,42548,5944,26531,34400,0.552944846,0.344791288,0.447055154
Texas,BAYLOR,3628,3134,69,322,494,0.863836825,0.088754135,0.136163175
Texas,BEE,32659,10822,2793,18726,21837,0.331363483,0.573379467,0.668636517
Texas,BELL,326041,159050,66361,75761,166991,0.487822084,0.232366482,0.512177916
Texas,BEXAR,1825502,535001,129022,1079710,1290501,0.293070618,0.591459226,0.706929382
Texas,BLANCO,10723,8355,6,2034,2368,0.779166278,0.189685722,0.220833722
Texas,BORDEN,705,620,0,62,85,0.879432624,0.087943262,0.120567376
Texas,BOSQUE,17971,14265,245,3029,3706,0.793778866,0.168549329,0.206221134
Texas,BOWIE,93155,60723,22250,6616,32432,0.651849069,0.071021416,0.348150931
Texas,BRAZORIA,331741,167960,42342,96011,163781,0.506298588,0.289415538,0.493701412
Texas,BRAZOS,205271,118233,21434,50029,87038,0.575984917,0.243721714,0.424015083
Texas,BREWSTER,9235,4884,123,4003,4351,0.528857607,0.433459664,0.471142393
Texas,BRISCOE,1670,1008,63,544,662,0.603592814,0.325748503,0.396407186
Texas,BROOKS,7221,369,6,6705,6852,0.051100956,0.928541753,0.948899044
Texas,BROWN,37833,27799,1575,7831,10034,0.734781804,0.206988608,0.265218196
Texas,BURLESON,17293,11443,2119,3408,5850,0.661712832,0.197073961,0.338287168
Texas,BURNET,44144,32974,1037,9412,11170,0.74696448,0.213211308,0.25303552
Texas,CALDWELL,39347,16724,2734,19320,22623,0.425038758,0.491015833,0.574961242
Texas,CALHOUN,21666,9546,606,10349,12120,0.440598172,0.477660851,0.559401828
Texas,CALLAHAN,13532,11798,230,1230,1734,0.871859296,0.090895655,0.128140704
Texas,CAMERON,417947,42131,1698,370071,375816,0.100804647,0.88544959,0.899195353
Texas,CAMP,12516,7156,2145,2875,5360,0.571748162,0.229705976,0.428251838
Texas,CARSON,6068,5264,65,580,804,0.867501648,0.095583388,0.132498352
Texas,CASS,30328,23238,5219,1246,7090,0.766222633,0.041084147,0.233777367
Texas,CASTRO,7948,2768,45,4932,5180,0.348263714,0.620533468,0.651736286
Texas,CHAMBERS,37251,25470,2947,7772,11781,0.683740034,0.208638694,0.316259966
Texas,CHEROKEE,51167,31518,7358,11204,19649,0.615982958,0.218969258,0.384017042
Texas,CHILDRESS,7059,4542,678,1447,2517,0.643433914,0.204986542,0.356566086
Texas,CLAY,10479,9530,55,564,949,0.909437923,0.05382193,0.090562077
Texas,COCHRAN,2993,1148,110,1683,1845,0.383561644,0.562312061,0.616438356
Texas,COKE,3238,2504,25,676,734,0.773316862,0.208770846,0.226683138
Texas,COLEMAN,8536,6666,202,1475,1870,0.780927835,0.172797563,0.219072165
Texas,COLLIN,862215,523843,76446,129437,338372,0.60755496,0.150121489,0.39244504
Texas,COLLINGSWORTH,3058,1898,106,960,1160,0.620667103,0.313930674,0.379332897
Texas,COLORADO,20757,12068,2831,5780,8689,0.581394228,0.278460278,0.418605772
Texas,COMAL,119632,82977,2245,31432,36655,0.693602046,0.262739066,0.306397954
Texas,COMANCHE,13623,9694,57,3659,3929,0.711590692,0.268589885,0.288409308
Texas,CONCHO,4086,1749,21,2265,2337,0.42804699,0.554331865,0.57195301
Texas,COOKE,38761,29869,932,6565,8892,0.770594154,0.169371275,0.229405846
Texas,CORYELL,76128,45785,10922,13286,30343,0.60142129,0.174521858,0.39857871
Texas,COTTLE,1510,904,158,424,606,0.598675497,0.280794702,0.401324503
Texas,CRANE,4730,1687,165,2838,3043,0.356659619,0.6,0.643340381
Texas,CROCKETT,3699,1358,10,2286,2341,0.36712625,0.618004866,0.63287375
Texas,CROSBY,6007,2481,220,3235,3526,0.413018145,0.538538372,0.586981855
Texas,CULBERSON,2296,440,9,1799,1856,0.191637631,0.783536585,0.808362369
Texas,DALLAM,7014,3699,84,2970,3315,0.527373824,0.423438837,0.472626176
Texas,DALLAS,2485003,782992,541844,969793,1702011,0.315086944,0.390258281,0.684913056
Texas,DAWSON,13542,5116,761,7408,8426,0.377787624,0.547038842,0.622212376
Texas,DEAF SMITH,19245,5353,159,13440,13892,0.278150169,0.698363211,0.721849831
Texas,DELTA,5223,4243,426,357,980,0.812368371,0.068351522,0.187631629
Texas,DENTON,731851,454545,63524,137951,277306,0.621089539,0.188496019,0.378910461
Texas,DEWITT,20540,11571,1961,6911,8969,0.563339825,0.336465433,0.436660175
Texas,DICKENS,2281,1525,139,602,756,0.668566418,0.263919334,0.331433582
Texas,DIMMIT,10682,1465,34,9160,9217,0.137146602,0.857517319,0.862853398
Texas,DONLEY,3588,2959,203,362,629,0.824693423,0.100891862,0.175306577
Texas,DUVAL,11577,1159,99,10250,10418,0.100112292,0.885376177,0.899887708
Texas,EASTLAND,18328,14707,517,2712,3621,0.802433435,0.147970319,0.197566565
Texas,ECTOR,149557,55290,5986,84533,94267,0.369691823,0.565222624,0.630308177
Texas,EDWARDS,1906,930,3,972,976,0.487932844,0.50996852,0.512067156
Texas,ELLIS,157058,100289,13841,38824,56769,0.638547543,0.247195304,0.361452457
Texas,EL PASO,831095,110881,25422,675674,720214,0.133415554,0.812992498,0.866584446
Texas,ERATH,40039,30523,571,7975,9516,0.762331727,0.199180799,0.237668273
Texas,FALLS,17410,9021,4267,3850,8389,0.518150488,0.221137277,0.481849512
Texas,FANNIN,33748,26898,2293,3474,6850,0.797025009,0.102939433,0.202974991
Texas,FAYETTE,24849,18043,1782,4877,6806,0.726105678,0.196265443,0.273894322
Texas,FISHER,3858,2487,125,1197,1371,0.644634526,0.310264386,0.355365474
Texas,FLOYD,6178,2469,163,3446,3709,0.399643898,0.557785691,0.600356102
Texas,FOARD,1197,1012,35,139,185,0.845446951,0.116123642,0.154553049
Texas,FORT BEND,658331,231705,134742,158162,426626,0.351958209,0.240246927,0.648041791
Texas,FRANKLIN,10599,8462,527,1415,2137,0.798377205,0.133503161,0.201622795
Texas,FREESTONE,19586,13272,3065,2829,6314,0.677626876,0.144439906,0.322373124
Texas,FRIO,18168,3084,706,14184,15084,0.169749009,0.780713342,0.830250991
Texas,GAINES,18916,10893,338,7412,8023,0.575861704,0.391837598,0.424138296
Texas,GALVESTON,308163,179352,40043,72332,128811,0.58200368,0.234719937,0.41799632
Texas,GARZA,6410,2501,290,3590,3909,0.390171607,0.560062402,0.609828393
Texas,GILLESPIE,25398,19487,68,5426,5911,0.767265139,0.213638869,0.232734861
Texas,GLASSCOCK,1180,778,0,402,402,0.659322034,0.340677966,0.340677966
Texas,GOLIAD,7410,4338,395,2632,3072,0.585425101,0.355195682,0.414574899
Texas,GONZALES,20172,8723,1325,9901,11449,0.432431093,0.490828872,0.567568907
Texas,GRAY,22983,15144,1005,6068,7839,0.658921812,0.264021233,0.341078188
Texas,GRAYSON,122780,94631,7239,15071,28149,0.770736276,0.122748005,0.229263724
Texas,GREGG,123178,72986,24464,21824,50192,0.592524639,0.177174495,0.407475361
Texas,GRIMES,26961,16060,4298,6105,10901,0.595675235,0.226438188,0.404324765
Texas,GUADALUPE,143460,75400,9574,52644,68060,0.525582044,0.366959431,0.474417956
Texas,HALE,35504,12564,1632,20563,22940,0.35387562,0.579174178,0.64612438
Texas,HALL,3203,1847,228,1092,1356,0.576646894,0.340930378,0.423353106
Texas,HAMILTON,8266,7138,84,924,1128,0.863537382,0.111783208,0.136462618
Texas,HANSFORD,5559,2986,7,2515,2573,0.537146969,0.4524195,0.462853031
Texas,HARDEMAN,3992,2788,350,813,1204,0.698396794,0.203657315,0.301603206
Texas,HARDIN,55375,48272,3216,2872,7103,0.87172912,0.05186456,0.12827088
Texas,HARRIS,4356362,1379900,804534,1810720,2976462,0.316755127,0.415649572,0.683244873
Texas,HARRISON,66417,42640,14373,8050,23777,0.642004306,0.121203909,0.357995694
Texas,HARTLEY,6121,3895,516,1564,2226,0.636333932,0.255513805,0.363666068
Texas,HASKELL,5853,4016,191,1474,1837,0.686143858,0.251836665,0.313856142
Texas,HAYS,177562,100577,5959,65150,76985,0.566433133,0.366914092,0.433566867
Texas,HEMPHILL,4115,2635,43,1358,1480,0.640340219,0.330012151,0.359659781
Texas,HENDERSON,79016,62804,5160,9218,16212,0.794826364,0.116659917,0.205173636
Texas,HIDALGO,819217,59657,3521,745749,759560,0.072821975,0.910319244,0.927178025
Texas,HILL,34923,25155,2437,6794,9768,0.720298943,0.194542279,0.279701057
Texas,HOCKLEY,23322,11293,779,10709,12029,0.484220907,0.459180173,0.515779093
Texas,HOOD,53171,45494,428,6040,7677,0.855616784,0.113595757,0.144383216
Texas,HOPKINS,35645,26531,2409,5695,9114,0.744311965,0.159769954,0.255688035
Texas,HOUSTON,22949,14212,5854,2431,8737,0.619286243,0.105930542,0.380713757
Texas,HOWARD,36105,18604,1883,14394,17501,0.515274893,0.398670544,0.484725107
Texas,HUDSPETH,3330,643,36,2612,2687,0.193093093,0.784384384,0.806906907
Texas,HUNT,88052,64732,7385,12886,23320,0.735156498,0.146345341,0.264843502
Texas,HUTCHINSON,21858,15704,565,4801,6154,0.718455485,0.219644981,0.281544515
Texas,IRION,1644,1179,0,412,465,0.717153285,0.250608273,0.282846715
Texas,JACK,8946,7036,437,1410,1910,0.786496758,0.157612341,0.213503242
Texas,JACKSON,14486,8791,1017,4468,5695,0.606861798,0.308435731,0.393138202
Texas,JASPER,35768,26640,5822,2312,9128,0.744799821,0.064638783,0.255200179
Texas,JEFF DAVIS,2232,1318,7,859,914,0.590501792,0.384856631,0.409498208
Texas,JEFFERSON,252872,108386,84269,46984,144486,0.428620013,0.185801512,0.571379987
Texas,JIM HOGG,5239,345,65,4817,4894,0.065852262,0.919450277,0.934147738
Texas,JIM WELLS,41461,7867,218,32949,33594,0.189744579,0.794698632,0.810255421
Texas,JOHNSON,155450,115978,3926,30351,39472,0.746079125,0.19524606,0.253920875
Texas,JONES,19978,11101,3022,5313,8877,0.555661227,0.265942537,0.444338773
Texas,KARNES,14879,5829,1317,7659,9050,0.391760199,0.514752336,0.608239801
Texas,KAUFMAN,109289,74442,10215,20552,34847,0.681148148,0.188051862,0.318851852
Texas,KENDALL,37361,28070,261,8161,9291,0.75131822,0.218436337,0.24868178
Texas,KENEDY,565,190,0,374,375,0.336283186,0.661946903,0.663716814
Texas,KENT,821,669,2,147,152,0.814859927,0.179049939,0.185140073
Texas,KERR,50149,35410,795,12699,14739,0.706095834,0.253225388,0.293904166
Texas,KIMBLE,4486,3357,1,1090,1129,0.748328132,0.242978154,0.251671868
Texas,KING,267,201,0,66,66,0.752808989,0.247191011,0.247191011
Texas,KINNEY,3577,1335,21,2221,2242,0.37321778,0.620911378,0.62678222
Texas,KLEBERG,32029,7029,1264,22846,25000,0.219457367,0.71329108,0.780542633
Texas,KNOX,3796,2275,256,1255,1521,0.599315068,0.33061117,0.400684932
Texas,LAMAR,49566,37247,6151,3561,12319,0.751462696,0.071843602,0.248537304
Texas,LAMB,13742,5640,609,7356,8102,0.410420608,0.535293262,0.589579392
Texas,LAMPASAS,20219,14841,766,3791,5378,0.734012562,0.187496909,0.265987438
Texas,LA SALLE,7191,1102,66,5986,6089,0.153247114,0.832429426,0.846752886
Texas,LAVACA,19549,14590,1331,3428,4959,0.746329736,0.175354238,0.253670264
Texas,LEE,16664,10679,1911,3847,5985,0.640842535,0.230856937,0.359157465
Texas,LEON,16819,12918,1263,2347,3901,0.768059932,0.139544563,0.231940068
Texas,LIBERTY,77486,52077,8219,15521,25409,0.672082699,0.200307152,0.327917301
Texas,LIMESTONE,23454,14137,4122,4795,9317,0.602754328,0.204442739,0.397245672
Texas,LIPSCOMB,3483,2318,10,1036,1165,0.665518231,0.297444732,0.334481769
Texas,LIVE OAK,11873,6762,381,4386,5111,0.569527499,0.369409585,0.430472501
Texas,LLANO,19323,16939,432,1792,2384,0.876623713,0.092739223,0.123376287
Texas,LOVING,117,48,0,41,69,0.41025641,0.35042735,0.58974359
Texas,LUBBOCK,290782,161779,19559,97317,129003,0.556358372,0.334673398,0.443641628
Texas,LYNN,5764,2843,71,2726,2921,0.493233865,0.472935461,0.506766135
Texas,MCCULLOCH,8273,5432,136,2550,2841,0.656593739,0.308231597,0.343406261
Texas,MCLENNAN,241505,139244,34242,59946,102261,0.576567773,0.248218463,0.423432227
Texas,MCMULLEN,778,392,0,374,386,0.503856041,0.480719794,0.496143959
Texas,MADISON,13838,7823,2573,3001,6015,0.565327359,0.216866599,0.434672641
Texas,MARION,10248,7272,2349,397,2976,0.709601874,0.038739266,0.290398126
Texas,MARTIN,5252,2689,122,2393,2563,0.51199543,0.455635948,0.48800457
Texas,MASON,4066,2918,1,999,1148,0.717658633,0.245696016,0.282341367
Texas,MATAGORDA,36598,16895,3614,14587,19703,0.461637248,0.398573693,0.538362752
Texas,MAVERICK,56548,1779,49,53820,54769,0.031459999,0.951757799,0.968540001
Texas,MEDINA,47392,21361,1024,24066,26031,0.450730081,0.507807225,0.549269919
Texas,MENARD,2182,1284,26,802,898,0.588450962,0.367552704,0.411549038
Texas,MIDLAND,151290,75140,8761,62419,76150,0.49666204,0.412578492,0.50333796
Texas,MILAM,24344,15515,2029,6086,8829,0.637323365,0.25,0.362676635
Texas,MILLS,4875,4061,12,788,814,0.833025641,0.161641026,0.166974359
Texas,MITCHELL,9169,4465,972,3548,4704,0.486966954,0.386956048,0.513033046
Texas,MONTAGUE,19478,16926,28,2006,2552,0.868980388,0.102987986,0.131019612
Texas,MONTGOMERY,502586,347262,17205,111408,155324,0.690950405,0.221669525,0.309049595
Texas,MOORE,22281,7805,565,11729,14476,0.350298461,0.526412639,0.649701539
Texas,MORRIS,12700,8353,2916,1114,4347,0.657716535,0.087716535,0.342283465
Texas,MOTLEY,1071,888,13,161,183,0.829131653,0.150326797,0.170868347
Texas,NACOGDOCHES,65531,39602,11776,12092,25929,0.604324671,0.184523355,0.395675329
Texas,NAVARRO,48118,28099,6418,12133,20019,0.583960264,0.252150962,0.416039736
Texas,NEWTON,14231,10503,2971,481,3728,0.73803668,0.033799452,0.26196332
Texas,NOLAN,15061,8766,627,5347,6295,0.582033066,0.355022907,0.417966934
Texas,NUECES,352060,110139,12942,218399,241921,0.312841561,0.620345964,0.687158439
Texas,OCHILTREE,10642,4958,17,5421,5684,0.46588987,0.50939673,0.53411013
Texas,OLDHAM,2071,1496,126,299,575,0.72235635,0.144374698,0.27764365
Texas,ORANGE,83217,68053,6845,5564,15164,0.817777618,0.066861338,0.182222382
Texas,PALO PINTO,27921,21245,684,5405,6676,0.760896816,0.193581892,0.239103184
Texas,PANOLA,23900,17494,4054,2129,6406,0.731966527,0.089079498,0.268033473
Texas,PARKER,121418,102634,2071,13634,18784,0.845294767,0.112289776,0.154705233
Texas,PARMER,10004,3668,167,6141,6336,0.366653339,0.613854458,0.633346661
Texas,PECOS,15807,4226,662,10703,11581,0.267349908,0.67710508,0.732650092
Texas,POLK,46113,32805,5031,6543,13308,0.711404593,0.141890573,0.288595407
Texas,POTTER,122352,57191,10966,45061,65161,0.467430038,0.368289852,0.532569962
Texas,PRESIDIO,7304,1108,1,5914,6196,0.1516977,0.809693319,0.8483023
Texas,RAINS,11037,9500,258,908,1537,0.860741143,0.082268732,0.139258857
Texas,RANDALL,126782,95080,3293,23883,31702,0.749948731,0.188378476,0.250051269
Texas,REAGAN,3598,1111,61,2411,2487,0.308782657,0.670094497,0.691217343
Texas,REAL,3356,2669,6,673,687,0.795292014,0.200536353,0.204707986
Texas,RED RIVER,12567,9191,2208,899,3376,0.731359911,0.071536564,0.268640089
Texas,REEVES,14179,2852,502,10578,11327,0.201142535,0.746032866,0.798857465
Texas,REFUGIO,7277,3126,427,3581,4151,0.429572626,0.492098392,0.570427374
Texas,ROBERTS,931,889,0,26,42,0.954887218,0.02792696,0.045112782
Texas,ROBERTSON,16532,9655,3419,3196,6877,0.584018872,0.193322042,0.415981128
Texas,ROCKWALL,85536,62282,4509,14309,23254,0.72813786,0.167286289,0.27186214
Texas,RUNNELS,10445,6559,216,3506,3886,0.62795596,0.335662997,0.37204404
Texas,RUSK,53457,34720,9318,8395,18737,0.649493986,0.157042109,0.350506014
Texas,SABINE,10440,9038,915,405,1402,0.865708812,0.038793103,0.134291188
Texas,SAN AUGUSTINE,8695,5971,1933,602,2724,0.686716504,0.069235193,0.313283496
Texas,SAN JACINTO,27023,20359,2996,3244,6664,0.753395256,0.120045887,0.246604744
Texas,SAN PATRICIO,66070,26826,1184,36751,39244,0.406023914,0.556243378,0.593976086
Texas,SAN SABA,5893,3913,190,1703,1980,0.664008145,0.288986934,0.335991855
Texas,SCHLEICHER,3224,1584,3,1627,1640,0.491315136,0.504652605,0.508684864
Texas,SCURRY,17238,9494,784,6672,7744,0.550759949,0.387051862,0.449240051
Texas,SHACKELFORD,3352,2961,4,361,391,0.883353222,0.107696897,0.116646778
Texas,SHELBY,25725,16301,4500,4534,9424,0.633663751,0.176248785,0.366336249
Texas,SHERMAN,3066,1712,6,1277,1354,0.558382257,0.416503588,0.441617743
Texas,SMITH,217552,132668,38481,40014,84884,0.60982202,0.18392844,0.39017798
Texas,SOMERVELL,8608,6816,52,1653,1792,0.791821561,0.192030669,0.208178439
Texas,STARR,62648,593,26,61842,62055,0.009465585,0.987134466,0.990534415
Texas,STEPHENS,9452,6960,248,2121,2492,0.736352095,0.224396953,0.263647905
Texas,STERLING,1346,706,3,616,640,0.524517088,0.457652303,0.475482912
Texas,STONEWALL,1414,1067,53,285,347,0.754596888,0.20155587,0.245403112
Texas,SUTTON,3966,1584,3,2331,2382,0.399394856,0.58774584,0.600605144
Texas,SWISHER,7713,3799,469,3219,3914,0.492545054,0.417347336,0.507454946
Texas,TARRANT,1914526,954181,288833,528560,960345,0.498390202,0.276078779,0.501609798
Texas,TAYLOR,134435,88135,9740,31179,46300,0.655595641,0.23192621,0.344404359
Texas,TERRELL,921,256,15,626,665,0.27795874,0.679695983,0.72204126
Texas,TERRY,12687,5350,591,6630,7337,0.421691495,0.522582171,0.578308505
Texas,THROCKMORTON,1545,1304,3,196,241,0.844012945,0.126860841,0.155987055
Texas,TITUS,32553,15400,3109,13387,17153,0.473074678,0.41123706,0.526925322
Texas,TOM GREEN,115056,64062,4698,43091,50994,0.556789737,0.374521972,0.443210263
Texas,TRAVIS,1121645,558905,88822,378387,562740,0.498290457,0.337350053,0.501709543
Texas,TRINITY,14405,11428,1474,1300,2977,0.793335647,0.090246442,0.206664353
Texas,TYLER,21462,17047,2308,1598,4415,0.794287578,0.07445718,0.205712422
Texas,UPSHUR,40096,32476,3475,3010,7620,0.809956105,0.075069832,0.190043895
Texas,UPTON,3405,1522,155,1697,1883,0.446989721,0.498384728,0.553010279
Texas,UVALDE,26952,7507,47,18927,19445,0.278532205,0.702248442,0.721467795
Texas,VAL VERDE,48980,8287,418,39377,40693,0.169191507,0.803940384,0.830808493
Texas,VAN ZANDT,52736,44590,1228,5251,8146,0.845532464,0.09957145,0.154467536
Texas,VICTORIA,90099,41908,5169,40496,48191,0.465132798,0.449461148,0.534867202
Texas,WALKER,69330,39808,15716,12242,29522,0.574181451,0.176575797,0.425818549
Texas,WALLER,45847,19713,11436,13352,26134,0.429973608,0.291229524,0.570026392
Texas,WARD,11225,4825,517,5690,6400,0.429844098,0.506904232,0.570155902
Texas,WASHINGTON,34236,22281,5846,5069,11955,0.650806169,0.148060521,0.349193831
Texas,WEBB,263251,9641,728,250899,253610,0.036622843,0.953079001,0.963377157
Texas,WHARTON,41264,19043,5839,16171,22221,0.461491857,0.391891237,0.538508143
Texas,WHEELER,5618,3865,121,1482,1753,0.687967248,0.263794945,0.312032752
Texas,WICHITA,131957,88483,13238,23635,43474,0.670544192,0.179111377,0.329455808
Texas,WILBARGER,13158,7964,1166,3681,5194,0.605259158,0.279753762,0.394740842
Texas,WILLACY,22002,2297,343,19254,19705,0.1043996,0.875102263,0.8956004
Texas,WILLIAMSON,473592,293907,29192,112691,179685,0.620591142,0.237949543,0.379408858
Texas,WILSON,45509,26439,677,17637,19070,0.580962008,0.387549715,0.419037992
Texas,WINKLER,7576,2996,195,4307,4580,0.395459345,0.568505808,0.604540655
Texas,WISE,61243,47865,711,11152,13378,0.781558709,0.18209428,0.218441291
Texas,WOOD,42712,35746,2039,3998,6966,0.836907661,0.093603671,0.163092339
Texas,YOAKUM,8213,2919,54,5091,5294,0.355412151,0.619870936,0.644587849
Texas,YOUNG,18329,14521,201,3214,3808,0.792241803,0.175350537,0.207758197
Texas,ZAPATA,14308,911,2,13395,13397,0.063670674,0.936189544,0.936329326
Texas,ZAVALA,12060,767,52,11216,11293,0.063598673,0.930016584,0.936401327
Utah,BEAVER,6461,5742,10,694,719,0.888716917,0.107413713,0.111283083
Utah,BOX ELDER,50991,44646,146,4548,6345,0.875566276,0.08919221,0.124433724
Utah,CACHE,117449,98763,798,12125,18686,0.840901157,0.103236298,0.159098843
Utah,CARBON,20927,17443,137,2714,3484,0.83351651,0.129688919,0.16648349
Utah,DAGGETT,776,743,0,18,33,0.957474227,0.023195876,0.042525773
Utah,DAVIS,323374,274418,3577,29054,48956,0.848608732,0.089846432,0.151391268
Utah,DUCHESNE,19817,17000,34,1514,2817,0.857849321,0.076399051,0.142150679
Utah,EMERY,10728,10002,18,667,726,0.932326622,0.062173751,0.067673378
Utah,GARFIELD,5069,4574,29,283,495,0.902347603,0.055829552,0.097652397
Utah,GRAND,9388,7801,27,945,1587,0.83095441,0.100660418,0.16904559
Utah,IRON,47139,40825,286,3812,6314,0.866055708,0.080867222,0.133944292
Utah,JUAB,10400,9636,11,456,764,0.926538462,0.043846154,0.073461538
Utah,KANE,7202,6624,13,307,578,0.919744515,0.042627048,0.080255485
Utah,MILLARD,12582,10614,47,1591,1968,0.843586075,0.126450485,0.156413925
Utah,MORGAN,10276,9781,37,275,495,0.951829506,0.026761386,0.048170494
Utah,PIUTE,1865,1738,4,101,127,0.931903485,0.054155496,0.068096515
Utah,RICH,2292,2092,2,150,200,0.912739965,0.065445026,0.087260035
Utah,SALT LAKE,1078958,785919,16671,190241,293039,0.728405554,0.176319189,0.271594446
Utah,SAN JUAN,15152,6935,25,771,8217,0.457695354,0.050884372,0.542304646
Utah,SANPETE,28261,24414,230,2686,3847,0.863876013,0.095042638,0.136123987
Utah,SEVIER,20871,19267,79,1012,1604,0.92314695,0.048488333,0.07685305
Utah,SUMMIT,38521,32714,205,4482,5807,0.849251058,0.11635212,0.150748942
Utah,TOOELE,60893,50949,369,7207,9944,0.836697157,0.118355148,0.163302843
Utah,UINTAH,35721,29347,185,2840,6374,0.821561546,0.079505053,0.178438454
Utah,UTAH,551957,460433,3041,61287,91524,0.834182735,0.111035823,0.165817265
Utah,WASATCH,26661,22438,14,3530,4223,0.841603841,0.132403136,0.158396159
Utah,WASHINGTON,148244,126337,916,14712,21907,0.852223361,0.099241791,0.147776639
Utah,WAYNE,2722,2518,18,130,204,0.925055107,0.047759001,0.074944893
Utah,WEBER,238682,184377,2521,41704,54305,0.772479701,0.174726205,0.227520299
Vermont,ADDISON,36943,34483,309,759,2460,0.93341093,0.020545164,0.06658907
Vermont,BENNINGTON,36589,34768,177,625,1821,0.950230944,0.017081637,0.049769056
Vermont,CALEDONIA,31012,29532,180,428,1480,0.952276538,0.013801109,0.047723462
Vermont,CHITTENDEN,159711,143706,3727,3341,16005,0.899787742,0.020919035,0.100212258
Vermont,ESSEX,6207,5952,35,77,255,0.958917351,0.012405349,0.041082649
Vermont,FRANKLIN,48418,45764,207,651,2654,0.945185675,0.013445413,0.054814325
Vermont,GRAND ISLE,6952,6504,0,115,448,0.935558113,0.016542002,0.064441887
Vermont,LAMOILLE,25027,23768,186,386,1259,0.94969433,0.015423343,0.05030567
Vermont,ORANGE,28929,27720,144,348,1209,0.958208027,0.012029451,0.041791973
Vermont,ORLEANS,27146,25972,138,354,1174,0.956752376,0.013040595,0.043247624
Vermont,RUTLAND,60530,58076,366,788,2454,0.95945812,0.013018338,0.04054188
Vermont,WASHINGTON,59132,55829,504,1109,3303,0.94414192,0.018754651,0.05585808
Vermont,WINDHAM,43858,41102,375,921,2756,0.937160837,0.02099959,0.062839163
Vermont,WINDSOR,56150,53371,374,789,2779,0.950507569,0.014051647,0.049492431
Virginia,ACCOMACK,33115,20169,9468,2909,12946,0.609059339,0.087845387,0.390940661
Virginia,ALBEMARLE,103108,79817,9539,5851,23291,0.774110641,0.056746324,0.225889359
Virginia,ALLEGHANY,16066,14781,850,232,1285,0.920017428,0.014440433,0.079982572
Virginia,AMELIA,12777,9241,3108,130,3536,0.72325272,0.010174532,0.27674728
Virginia,AMHERST,32148,24300,5913,687,7848,0.755879059,0.021369914,0.244120941
Virginia,APPOMATTOX,15208,11669,3085,185,3539,0.76729353,0.01216465,0.23270647
Virginia,ARLINGTON,223945,141107,18584,34629,82838,0.630096676,0.154631718,0.369903324
Virginia,AUGUSTA,74053,67951,2939,1749,6102,0.917599557,0.023618219,0.082400443
Virginia,BATH,4583,4179,157,159,404,0.911848134,0.034693432,0.088151866
Virginia,BEDFORD,76463,67590,5434,1461,8873,0.883956946,0.019107281,0.116043054
Virginia,BLAND,6662,6204,335,88,458,0.931251876,0.013209246,0.068748124
Virginia,BOTETOURT,33155,30917,1128,467,2238,0.932498869,0.014085357,0.067501131
Virginia,BRUNSWICK,16930,6896,9424,326,10034,0.407324276,0.019255759,0.592675724
Virginia,BUCHANAN,23486,22408,623,74,1078,0.954100315,0.003150813,0.045899685
Virginia,BUCKINGHAM,17068,10410,5873,367,6658,0.609913288,0.021502226,0.390086712
Virginia,CAMPBELL,55012,44348,7674,1054,10664,0.806151385,0.019159456,0.193848615
Virginia,CAROLINE,29349,18723,8400,1163,10626,0.637943371,0.039626563,0.362056629
Virginia,CARROLL,29856,28448,228,876,1408,0.9528403,0.029340836,0.0471597
Virginia,CHARLES CITY,7118,2914,3419,119,4204,0.409384659,0.016718179,0.590615341
Virginia,CHARLOTTE,12313,8228,3840,91,4085,0.668236823,0.007390563,0.331763177
Virginia,CHESTERFIELD,328176,209074,73188,25423,119102,0.637078885,0.077467578,0.362921115
Virginia,CLARKE,14299,12496,784,581,1803,0.873907266,0.040632212,0.126092734
Virginia,CRAIG,5212,5002,8,1,210,0.959708365,0.000191865,0.040291635
Virginia,CULPEPER,48424,34628,6719,4367,13796,0.71509995,0.090182554,0.28490005
Virginia,CUMBERLAND,9859,6213,3268,12,3646,0.630185617,0.001217162,0.369814383
Virginia,DICKENSON,15463,15157,139,118,306,0.980210826,0.007631119,0.019789174
Virginia,DINWIDDIE,28110,17585,9230,792,10525,0.625578086,0.028175027,0.374421914
Virginia,ESSEX,11151,6164,4576,59,4987,0.552775536,0.005291005,0.447224464
Virginia,FAIRFAX,1128722,593856,102194,181901,534866,0.526131324,0.1611566,0.473868676
Virginia,FAUQUIER,67463,54741,4989,4711,12722,0.811422558,0.06983087,0.188577442
Virginia,FLOYD,15523,14596,379,400,927,0.940282162,0.025768215,0.059717838
Virginia,FLUVANNA,26014,20472,3740,833,5542,0.786960867,0.032021219,0.213039133
Virginia,FRANKLIN,56315,48995,4729,1497,7320,0.870016869,0.026582616,0.129983131
Virginia,FREDERICK,81340,69273,3587,5877,12067,0.851647406,0.072252274,0.148352594
Virginia,GILES,16907,16123,263,204,784,0.953628675,0.012066008,0.046371325
Virginia,GLOUCESTER,37001,31545,3002,1112,5456,0.852544526,0.030053242,0.147455474
Virginia,GOOCHLAND,21721,16795,3852,499,4926,0.773214861,0.02297316,0.226785139
Virginia,GRAYSON,15573,14387,427,457,1186,0.923842548,0.029345662,0.076157452
Virginia,GREENE,18938,16056,1222,920,2882,0.847819199,0.048579575,0.152180801
Virginia,GREENSVILLE,11760,4412,6739,452,7348,0.375170068,0.038435374,0.624829932
Virginia,HALIFAX,35506,21285,13041,671,14221,0.599476145,0.018898214,0.400523855
Virginia,HANOVER,101340,85830,9357,2532,15510,0.846950858,0.024985198,0.153049142
Virginia,HENRICO,318864,176493,93184,16867,142371,0.55350557,0.05289716,0.44649443
Virginia,HENRY,52580,37147,11636,2725,15433,0.706485356,0.051825789,0.293514644
Virginia,HIGHLAND,2244,2233,0,0,11,0.995098039,0,0.004901961
Virginia,ISLE OF WIGHT,35740,25254,8133,899,10486,0.706603246,0.025153889,0.293396754
Virginia,JAMES CITY,70673,54032,9438,3701,16641,0.764535254,0.052367948,0.235464746
Virginia,KING AND QUEEN,7106,4679,1886,235,2427,0.658457641,0.033070645,0.341542359
Virginia,KING GEORGE,24933,18454,4352,1050,6479,0.740143585,0.042112862,0.259856415
Virginia,KING WILLIAM,16097,12245,3109,126,3852,0.760700752,0.007827546,0.239299248
Virginia,LANCASTER,11129,7678,3113,174,3451,0.689909246,0.015634828,0.310090754
Virginia,LEE,25206,23434,922,444,1772,0.929699278,0.017614854,0.070300722
Virginia,LOUDOUN,351129,208162,25125,46273,142967,0.592836251,0.131783476,0.407163749
Virginia,LOUISA,33986,26174,5664,849,7812,0.770140646,0.024980874,0.229859354
Virginia,LUNENBURG,12558,7536,4242,507,5022,0.600095557,0.040372671,0.399904443
Virginia,MADISON,13147,11215,1085,275,1932,0.853046322,0.02091732,0.146953678
Virginia,MATHEWS,8880,7658,911,124,1222,0.862387387,0.013963964,0.137612613
Virginia,MECKLENBURG,31555,18845,11069,812,12710,0.597211219,0.025732847,0.402788781
Virginia,MIDDLESEX,10717,8367,2068,215,2350,0.780722217,0.020061584,0.219277783
Virginia,MONTGOMERY,96467,81471,3984,2855,14996,0.844547876,0.029595613,0.155452124
Virginia,NELSON,14858,12144,1997,515,2714,0.817337461,0.034661462,0.182662539
Virginia,NEW KENT,19560,15607,2394,476,3953,0.797903885,0.024335378,0.202096115
Virginia,NORTHAMPTON,12184,6598,4440,976,5586,0.541529875,0.080105056,0.458470125
Virginia,NORTHUMBERLAND,12304,8630,3515,56,3674,0.701397919,0.004551365,0.298602081
Virginia,NOTTOWAY,15711,8651,6043,618,7060,0.550633314,0.039335497,0.449366686
Virginia,ORANGE,34596,27474,4399,1403,7122,0.794138051,0.040553821,0.205861949
Virginia,PAGE,23843,22569,381,426,1274,0.946567127,0.017866879,0.053432873
Virginia,PATRICK,18264,16434,1168,491,1830,0.899802891,0.026883487,0.100197109
Virginia,PITTSYLVANIA,62794,46615,13418,1505,16179,0.742347995,0.023967258,0.257652005
Virginia,POWHATAN,28207,23526,3428,557,4681,0.834048286,0.019746871,0.165951714
Virginia,PRINCE EDWARD,23022,14340,7553,554,8682,0.62288246,0.024063939,0.37711754
Virginia,PRINCE GEORGE,37380,21065,11622,2668,16315,0.563536651,0.071375067,0.436463349
Virginia,PRINCE WILLIAM,437271,202330,86180,93909,234941,0.462710767,0.214761555,0.537289233
Virginia,PULASKI,34528,31435,2014,501,3093,0.910420528,0.014509963,0.089579472
Virginia,RAPPAHANNOCK,7431,6648,311,251,783,0.894630602,0.033777419,0.105369398
Virginia,RICHMOND,8989,5506,2579,560,3483,0.612526421,0.062298365,0.387473579
Virginia,ROANOKE,93633,81436,5197,2462,12197,0.869736097,0.026294148,0.130263903
Virginia,ROCKBRIDGE,22444,20927,637,337,1517,0.932409553,0.015015149,0.067590447
Virginia,ROCKINGHAM,77785,70230,1395,4586,7555,0.902873305,0.058957383,0.097126695
Virginia,RUSSELL,28245,27321,293,320,924,0.967286245,0.011329439,0.032713755
Virginia,SCOTT,22570,21897,171,267,673,0.970181657,0.011829863,0.029818343
Virginia,SHENANDOAH,42724,38050,904,2886,4674,0.890600131,0.067549855,0.109399869
Virginia,SMYTH,31734,29974,657,585,1760,0.94453898,0.018434487,0.05546102
Virginia,SOUTHAMPTON,18410,11051,6582,240,7359,0.600271592,0.013036393,0.399728408
Virginia,SPOTSYLVANIA,127691,90125,19966,10614,37566,0.705805421,0.083122538,0.294194579
Virginia,STAFFORD,137145,89952,22861,14625,47193,0.655889752,0.106638959,0.344110248
Virginia,SURRY,6823,3548,3035,111,3275,0.520005863,0.016268504,0.479994137
Virginia,SUSSEX,11864,4572,6621,387,7292,0.385367498,0.03261969,0.614632502
Virginia,TAZEWELL,43870,41260,1279,367,2610,0.940506041,0.008365626,0.059493959
Virginia,WARREN,38481,33831,1530,1509,4650,0.879161144,0.039214158,0.120838856
Virginia,WASHINGTON,54759,52341,790,787,2418,0.955842875,0.014372067,0.044157125
Virginia,WESTMORELAND,17557,11153,4907,1070,6404,0.635245201,0.060944353,0.364754799
Virginia,WISE,40530,37286,2128,490,3244,0.919960523,0.01208981,0.080039477
Virginia,WYTHE,29190,27475,1051,316,1715,0.941247002,0.010825625,0.058752998
Virginia,YORK,66471,48416,8673,3625,18055,0.728377789,0.05453506,0.271622211
Virginia,ALEXANDRIA CITY,149315,78235,31216,24728,71080,0.523959415,0.165609617,0.476040585
Virginia,BRISTOL CITY,17524,15550,991,292,1974,0.887354485,0.016662862,0.112645515
Virginia,BUENA VISTA CITY,6666,5927,70,91,739,0.889138914,0.013651365,0.110861086
Virginia,CHARLOTTESVILLE CITY,45084,29944,8664,2237,15140,0.664182415,0.04961849,0.335817585
Virginia,CHESAPEAKE CITY,230601,136438,67561,11661,94163,0.591662655,0.050567864,0.408337345
Virginia,COLONIAL HEIGHTS CITY,17515,13445,2231,875,4070,0.767627748,0.04995718,0.232372252
Virginia,COVINGTON CITY,5736,4677,799,72,1059,0.815376569,0.012552301,0.184623431
Virginia,DANVILLE CITY,42450,19128,20561,1401,23322,0.450600707,0.033003534,0.549399293
Virginia,EMPORIA CITY,5672,2222,3128,171,3450,0.391748942,0.030148096,0.608251058
Virginia,FAIRFAX CITY,23402,13990,1090,3840,9412,0.597812153,0.164088539,0.402187847
Virginia,FALLS CHURCH CITY,13308,9665,283,1294,3643,0.726254884,0.097234746,0.273745116
Virginia,FRANKLIN CITY,8457,3232,4956,88,5225,0.382168618,0.010405581,0.617831382
Virginia,FREDERICKSBURG CITY,27395,16383,6080,3037,11012,0.598028837,0.110859646,0.401971163
Virginia,GALAX CITY,6876,5228,382,1158,1648,0.760325771,0.168411867,0.239674229
Virginia,HAMPTON CITY,137081,55141,67183,7133,81940,0.402251224,0.052034928,0.597748776
Virginia,HARRISONBURG CITY,51388,35479,3358,9110,15909,0.690414104,0.177278742,0.309585896
Virginia,HOPEWELL CITY,22279,11390,8485,1516,10889,0.511243772,0.068046142,0.488756228
Virginia,LEXINGTON CITY,7071,5331,761,273,1740,0.75392448,0.038608401,0.24607552
Virginia,LYNCHBURG CITY,78158,49174,22124,2555,28984,0.629161442,0.032690192,0.370838558
Virginia,MANASSAS CITY,40743,18181,5497,13403,22562,0.446236163,0.328964485,0.553763837
Virginia,MANASSAS PARK CITY,15625,6021,1883,5498,9604,0.385344,0.351872,0.614656
Virginia,MARTINSVILLE CITY,13624,6454,6256,618,7170,0.473722842,0.045361127,0.526277158
Virginia,NEWPORT NEWS CITY,181323,82039,71416,14901,99284,0.452446739,0.082179315,0.547553261
Virginia,NORFOLK CITY,245452,108188,100975,17782,137264,0.440770497,0.072445936,0.559229503
Virginia,NORTON CITY,4007,3469,137,97,538,0.865734964,0.024207637,0.134265036
Virginia,PETERSBURG CITY,32123,5025,24652,1361,27098,0.156429972,0.042368396,0.843570028
Virginia,POQUOSON CITY,12077,11182,119,272,895,0.925892192,0.02252215,0.074107808
Virginia,PORTSMOUTH CITY,96135,37955,50125,3509,58180,0.394809383,0.036500754,0.605190617
Virginia,RADFORD CITY,17057,14237,1563,510,2820,0.834671982,0.029899748,0.165328018
Virginia,RICHMOND CITY,213735,85328,103367,13580,128407,0.399223337,0.063536622,0.600776663
Virginia,ROANOKE CITY,98736,59962,27148,5808,38774,0.607296224,0.058823529,0.392703776
Virginia,SALEM CITY,25165,21582,1903,794,3583,0.85761971,0.031551758,0.14238029
Virginia,STAUNTON CITY,24193,19749,2890,635,4444,0.816310503,0.026247262,0.183689497
Virginia,SUFFOLK CITY,86184,43223,35654,3102,42961,0.501520004,0.03599276,0.498479996
Virginia,VIRGINIA BEACH CITY,448290,283051,83784,33648,165239,0.631401548,0.075058556,0.368598452
Virginia,WAYNESBORO CITY,21150,16526,2496,1421,4624,0.781371158,0.067186761,0.218628842
Virginia,WILLIAMSBURG CITY,14754,10174,2210,1038,4580,0.689575708,0.070353802,0.310424292
Virginia,WINCHESTER CITY,27168,18444,2824,4430,8724,0.678886926,0.163059482,0.321113074
Washington,ADAMS,19081,6913,39,11728,12168,0.362297574,0.614642838,0.637702426
Washington,ASOTIN,22040,20187,90,784,1853,0.91592559,0.035571688,0.08407441
Washington,BENTON,184930,134307,2678,36903,50623,0.726258584,0.199551182,0.273741416
Washington,CHELAN,74267,51217,340,20199,23050,0.68963335,0.271978133,0.31036665
Washington,CLALLAM,72397,60661,612,4119,11736,0.837893835,0.056894623,0.162106165
Washington,CLARK,444506,356730,8013,37438,87776,0.802531349,0.084223835,0.197468651
Washington,COLUMBIA,3989,3531,14,255,458,0.885184257,0.063925796,0.114815743
Washington,COWLITZ,102338,86840,586,8496,15498,0.848560652,0.083019015,0.151439348
Washington,DOUGLAS,39599,26183,81,11888,13416,0.661203566,0.300209601,0.338796434
Washington,FERRY,7652,5670,20,309,1982,0.74098275,0.0403816,0.25901725
Washington,FRANKLIN,86443,36603,1579,44516,49840,0.423435096,0.514975186,0.576564904
Washington,GARFIELD,2230,2098,0,75,132,0.940807175,0.033632287,0.059192825
Washington,GRANT,92070,51535,561,36545,40535,0.559737157,0.396926252,0.440262843
Washington,GRAYS HARBOR,71419,57228,813,6855,14191,0.801299374,0.095982862,0.198700626
Washington,ISLAND,79329,64147,2216,5275,15182,0.808619799,0.066495229,0.191380201
Washington,JEFFERSON,30083,26669,237,1025,3414,0.886513978,0.0340724,0.113486022
Washington,KING,2045756,1284684,123350,189808,761072,0.627975184,0.092781348,0.372024816
Washington,KITSAP,255441,198599,6516,18108,56842,0.777475033,0.070889168,0.222524967
Washington,KITTITAS,42204,35720,398,3575,6484,0.846365273,0.084707611,0.153634727
Washington,KLICKITAT,20820,17134,154,2493,3686,0.822958694,0.119740634,0.177041306
Washington,LEWIS,75515,63944,553,7152,11571,0.846772164,0.09470966,0.153227836
Washington,LINCOLN,10363,9551,25,297,812,0.921644311,0.028659655,0.078355689
Washington,MASON,60791,49816,587,5299,10975,0.819463407,0.087167508,0.180536593
Washington,OKANOGAN,41332,27587,248,7804,13745,0.66744895,0.188812542,0.33255105
Washington,PACIFIC,20645,17177,58,1807,3468,0.832017438,0.087527246,0.167982562
Washington,PEND OREILLE,12968,11561,24,455,1407,0.891502159,0.035086366,0.108497841
Washington,PIERCE,821952,565734,53391,81898,256218,0.688281068,0.099638422,0.311718932
Washington,SAN JUAN,15956,14245,86,933,1711,0.892767611,0.058473302,0.107232389
Washington,SKAGIT,119343,90350,853,20905,28993,0.757061579,0.175167375,0.242938421
Washington,SKAMANIA,11243,9931,95,642,1312,0.883305168,0.057102197,0.116694832
Washington,SNOHOMISH,746653,541202,18374,71133,205451,0.724837374,0.095269154,0.275162626
Washington,SPOKANE,480832,412252,8294,24353,68580,0.857372221,0.050647627,0.142627779
Washington,STEVENS,43548,37985,213,1415,5563,0.872255902,0.032492881,0.127744098
Washington,THURSTON,262723,201709,7234,21174,61014,0.767763005,0.08059439,0.232236995
Washington,WAHKIAKUM,4035,3605,5,175,430,0.893432466,0.043370508,0.106567534
Washington,WALLA WALLA,59726,43393,908,12528,16333,0.726534508,0.209757894,0.273465492
Washington,WHATCOM,207100,166283,1705,18030,40817,0.802911637,0.087059392,0.197088363
Washington,WHITMAN,46737,37533,993,2517,9204,0.803068233,0.053854548,0.196931767
Washington,YAKIMA,247408,112714,1843,116577,134694,0.455579448,0.471193332,0.544420552
West Virginia,BARBOUR,16731,16085,140,123,646,0.961389038,0.007351623,0.038610962
West Virginia,BERKELEY,108724,92630,7511,4235,16094,0.851973805,0.038951841,0.148026195
West Virginia,BOONE,24000,23528,162,117,472,0.980333333,0.004875,0.019666667
West Virginia,BRAXTON,14466,14090,64,83,376,0.974008019,0.005737592,0.025991981
West Virginia,BROOKE,23665,22736,413,191,929,0.960743714,0.008070991,0.039256286
West Virginia,CABELL,96824,87459,4583,1271,9365,0.903278113,0.013126911,0.096721887
West Virginia,CALHOUN,7557,7350,6,79,207,0.972608178,0.010453884,0.027391822
West Virginia,CLAY,9141,8949,0,13,192,0.978995734,0.001422164,0.021004266
West Virginia,DODDRIDGE,8201,7893,89,35,308,0.962443604,0.004267772,0.037556396
West Virginia,FAYETTE,45534,42112,2350,468,3422,0.924847367,0.010278034,0.075152633
West Virginia,GILMER,8644,6883,925,335,1761,0.796274873,0.038755206,0.203725127
West Virginia,GRANT,11815,11431,163,74,384,0.967498942,0.006263225,0.032501058
West Virginia,GREENBRIER,35666,33326,820,481,2340,0.934391297,0.013486233,0.065608703
West Virginia,HAMPSHIRE,23542,22621,313,288,921,0.96087843,0.012233455,0.03912157
West Virginia,HANCOCK,30201,28568,676,360,1633,0.945928943,0.011920135,0.054071057
West Virginia,HARDY,13936,12774,607,516,1162,0.916618829,0.037026406,0.083381171
West Virginia,HARRISON,68998,65254,1225,1011,3744,0.945737558,0.014652599,0.054262442
West Virginia,JACKSON,29256,28483,194,13,773,0.973578069,0.000444353,0.026421931
West Virginia,JEFFERSON,55214,46368,3776,2884,8846,0.839787011,0.052233129,0.160212989
West Virginia,KANAWHA,190781,167969,8453,2004,22812,0.880428345,0.010504191,0.119571655
West Virginia,LEWIS,16434,15897,88,177,537,0.967323841,0.010770354,0.032676159
West Virginia,LINCOLN,21560,21175,103,24,385,0.982142857,0.001113173,0.017857143
West Virginia,LOGAN,35760,34268,767,316,1492,0.958277405,0.008836689,0.041722595
West Virginia,MCDOWELL,20802,18503,1892,241,2299,0.889481781,0.011585424,0.110518219
West Virginia,MARION,56790,52887,2039,667,3903,0.931273111,0.011745026,0.068726889
West Virginia,MARSHALL,32480,31475,279,317,1005,0.969057882,0.009759852,0.030942118
West Virginia,MASON,27177,26330,197,267,847,0.96883394,0.009824484,0.03116606
West Virginia,MERCER,61891,55983,3625,586,5908,0.904541856,0.009468259,0.095458144
West Virginia,MINERAL,27755,26135,843,239,1620,0.941632138,0.008611061,0.058367862
West Virginia,MINGO,25931,24899,367,103,1032,0.960202075,0.00397208,0.039797925
West Virginia,MONONGALIA,101668,90471,3615,2072,11197,0.889867018,0.020380061,0.110132982
West Virginia,MONROE,13525,13068,94,140,457,0.966210721,0.010351201,0.033789279
West Virginia,MORGAN,17475,16785,135,230,690,0.960515021,0.01316166,0.039484979
West Virginia,NICHOLAS,25930,25749,9,7,181,0.993019668,0.000269958,0.006980332
West Virginia,OHIO,43637,40308,1812,449,3329,0.923711529,0.010289433,0.076288471
West Virginia,PENDLETON,7402,7029,202,82,373,0.949608214,0.011078087,0.050391786
West Virginia,PLEASANTS,7636,7357,21,82,279,0.963462546,0.010738607,0.036537454
West Virginia,POCAHONTAS,8697,8356,129,59,341,0.960791077,0.006783948,0.039208923
West Virginia,PRESTON,33809,31440,1330,556,2369,0.9299299,0.016445325,0.0700701
West Virginia,PUTNAM,56596,54115,849,584,2481,0.95616298,0.01031875,0.04383702
West Virginia,RALEIGH,78493,68500,6480,1122,9993,0.872689284,0.014294268,0.127310716
West Virginia,RANDOLPH,29365,28254,557,233,1111,0.962165844,0.007934616,0.037834156
West Virginia,RITCHIE,10140,9925,48,51,215,0.978796844,0.005029586,0.021203156
West Virginia,ROANE,14636,14220,3,133,416,0.971576934,0.009087182,0.028423066
West Virginia,SUMMERS,13544,12404,667,243,1140,0.915829888,0.017941524,0.084170112
West Virginia,TAYLOR,16977,16359,161,159,618,0.963597809,0.009365612,0.036402191
West Virginia,TUCKER,6972,6810,16,34,162,0.9767642,0.004876649,0.0232358
West Virginia,TYLER,9033,8863,15,58,170,0.981180117,0.006420901,0.018819883
West Virginia,UPSHUR,24560,23676,260,274,884,0.964006515,0.011156352,0.035993485
West Virginia,WAYNE,41499,40497,150,259,1002,0.97585484,0.006241114,0.02414516
West Virginia,WEBSTER,8927,8724,11,23,203,0.977259998,0.002576453,0.022740002
West Virginia,WETZEL,16157,15800,19,105,357,0.977904314,0.006498731,0.022095686
West Virginia,WIRT,5841,5681,49,9,160,0.97260743,0.001540832,0.02739257
West Virginia,WOOD,86559,82684,917,849,3875,0.955232847,0.009808339,0.044767153
West Virginia,WYOMING,22866,22298,179,77,568,0.975159626,0.003367445,0.024840374
Wisconsin,ADAMS,20451,18529,613,784,1922,0.906019266,0.038335534,0.093980734
Wisconsin,ASHLAND,15993,13293,84,368,2700,0.83117614,0.023010067,0.16882386
Wisconsin,BARRON,45686,42985,579,1049,2701,0.940879044,0.022961082,0.059120956
Wisconsin,BAYFIELD,15050,12852,92,221,2198,0.853953488,0.014684385,0.146046512
Wisconsin,BROWN,254717,209674,5474,20132,45043,0.823164532,0.079036735,0.176835468
Wisconsin,BUFFALO,13319,12834,63,264,485,0.963585855,0.019821308,0.036414145
Wisconsin,BURNETT,15334,13896,74,239,1438,0.906221469,0.015586279,0.093778531
Wisconsin,CALUMET,49678,45568,347,1931,4110,0.917267201,0.038870325,0.082732799
Wisconsin,CHIPPEWA,63209,59514,842,914,3695,0.941543135,0.014459966,0.058456865
Wisconsin,CLARK,34518,32382,132,1417,2136,0.938119242,0.041051046,0.061880758
Wisconsin,COLUMBIA,56607,53011,836,1598,3596,0.936474288,0.028229724,0.063525712
Wisconsin,CRAWFORD,16483,15742,292,180,741,0.955044591,0.010920342,0.044955409
Wisconsin,DANE,510198,412357,25585,31486,97841,0.808229354,0.061713296,0.191770646
Wisconsin,DODGE,88547,80418,1809,3890,8129,0.908195648,0.043931471,0.091804352
Wisconsin,DOOR,27731,26297,146,731,1434,0.948288919,0.026360391,0.051711081
Wisconsin,DOUGLAS,43799,40331,483,588,3468,0.92082011,0.013424964,0.07917989
Wisconsin,DUNN,44159,41212,252,746,2947,0.933263887,0.016893498,0.066736113
Wisconsin,EAU CLAIRE,101281,92275,717,2212,9006,0.911079077,0.021840227,0.088920923
Wisconsin,FLORENCE,4476,4373,9,45,103,0.976988382,0.010053619,0.023011618
Wisconsin,FOND DU LAC,101920,92696,1140,4849,9224,0.909497645,0.047576531,0.090502355
Wisconsin,FOREST,9150,7407,45,180,1743,0.809508197,0.019672131,0.190491803
Wisconsin,GRANT,51489,49238,656,697,2251,0.956281924,0.013536872,0.043718076
Wisconsin,GREEN,37044,35137,107,1072,1907,0.948520678,0.02893856,0.051479322
Wisconsin,GREEN LAKE,18966,17684,99,863,1282,0.932405357,0.045502478,0.067594643
Wisconsin,IOWA,23769,22871,92,396,898,0.962219698,0.016660356,0.037780302
Wisconsin,IRON,5907,5705,26,54,202,0.965803284,0.009141696,0.034196716
Wisconsin,JACKSON,20543,17807,463,638,2736,0.866815947,0.031056808,0.133184053
Wisconsin,JEFFERSON,84345,76047,633,5816,8298,0.901618353,0.068954888,0.098381647
Wisconsin,JUNEAU,26494,24394,601,757,2100,0.920736771,0.028572507,0.079263229
Wisconsin,KENOSHA,167738,129010,12057,20837,38728,0.769116122,0.124223491,0.230883878
Wisconsin,KEWAUNEE,20483,19563,64,492,920,0.955084704,0.024019919,0.044915296
Wisconsin,LA CROSSE,117048,106003,1604,1990,11045,0.905637004,0.017001572,0.094362996
Wisconsin,LAFAYETTE,16835,15976,65,595,859,0.948975349,0.035343035,0.051024651
Wisconsin,LANGLADE,19551,18551,152,373,1000,0.948851721,0.019078308,0.051148279
Wisconsin,LINCOLN,28286,27172,143,379,1114,0.960616559,0.013398855,0.039383441
Wisconsin,MANITOWOC,80521,73839,356,2782,6682,0.917015437,0.034549993,0.082984563
Wisconsin,MARATHON,135177,121051,926,3392,14126,0.895499974,0.025093026,0.104500026
Wisconsin,MARINETTE,41287,39556,142,623,1731,0.95807397,0.015089495,0.04192603
Wisconsin,MARQUETTE,15140,14321,66,446,819,0.945904888,0.029458388,0.054095112
Wisconsin,MENOMINEE,4451,468,19,246,3983,0.105144911,0.055268479,0.894855089
Wisconsin,MILWAUKEE,955939,508095,249456,134114,447844,0.53151404,0.140295563,0.46848596
Wisconsin,MONROE,45274,41470,450,1795,3804,0.915978266,0.03964748,0.084021734
Wisconsin,OCONTO,37476,35798,74,614,1678,0.955224677,0.016383819,0.044775323
Wisconsin,ONEIDA,35653,34014,223,483,1639,0.954029114,0.013547247,0.045970886
Wisconsin,OUTAGAMIE,180430,159830,1997,7093,20600,0.885828299,0.039311644,0.114171701
Wisconsin,OZAUKEE,87273,80776,1191,2290,6497,0.925555441,0.026239501,0.074444559
Wisconsin,PEPIN,7372,7154,26,100,218,0.970428649,0.01356484,0.029571351
Wisconsin,PIERCE,40799,38712,193,750,2087,0.948846785,0.018382804,0.051153215
Wisconsin,POLK,43572,41604,169,735,1968,0.954833379,0.016868631,0.045166621
Wisconsin,PORTAGE,70432,64811,432,2073,5621,0.920192526,0.029432644,0.079807474
Wisconsin,PRICE,13800,13187,48,202,613,0.95557971,0.014637681,0.04442029
Wisconsin,RACINE,194895,142862,21074,23900,52033,0.733020344,0.122630134,0.266979656
Wisconsin,RICHLAND,17746,16926,94,390,820,0.953792404,0.021976784,0.046207596
Wisconsin,ROCK,160727,134642,5524,12998,26085,0.837706173,0.080870047,0.162293827
Wisconsin,RUSK,14357,13769,140,217,588,0.959044369,0.015114578,0.040955631
Wisconsin,ST. CROIX,86118,81368,615,1873,4750,0.944843122,0.021749228,0.055156878
Wisconsin,SAUK,62992,57817,322,2962,5175,0.917846711,0.047021844,0.082153289
Wisconsin,SAWYER,16483,12817,114,341,3666,0.777589031,0.020687982,0.222410969
Wisconsin,SHAWANO,41563,36342,120,1068,5221,0.874383466,0.025695931,0.125616534
Wisconsin,SHEBOYGAN,115226,99022,1622,6777,16204,0.859372017,0.058814851,0.140627983
Wisconsin,TAYLOR,20569,19909,100,342,660,0.967912879,0.016626963,0.032087121
Wisconsin,TREMPEALEAU,29412,26941,137,1941,2471,0.915986672,0.065993472,0.084013328
Wisconsin,VERNON,30279,29213,152,467,1066,0.964794082,0.015423231,0.035205918
Wisconsin,VILAS,21355,18256,52,379,3099,0.854881761,0.0177476,0.145118239
Wisconsin,WALWORTH,103039,88257,959,11228,14782,0.856539757,0.108968449,0.143460243
Wisconsin,WASHBURN,15700,14878,71,251,822,0.947643312,0.015987261,0.052356688
Wisconsin,WASHINGTON,132921,124434,1362,3853,8487,0.936150044,0.028987143,0.063849956
Wisconsin,WAUKESHA,393873,352959,5469,17660,40914,0.896123877,0.044836787,0.103876123
Wisconsin,WAUPACA,52125,49524,186,1477,2601,0.950100719,0.028335731,0.049899281
Wisconsin,WAUSHARA,24321,21879,439,1514,2442,0.899592944,0.06225073,0.100407056
Wisconsin,WINNEBAGO,169004,151662,3274,6451,17342,0.897387044,0.038170694,0.102612956
Wisconsin,WOOD,74012,68944,394,1948,5068,0.931524618,0.026320056,0.068475382
Wyoming,ALBANY,37565,31337,479,3431,6228,0.834207374,0.091335019,0.165792626
Wyoming,BIG HORN,11895,10478,7,1055,1417,0.880874317,0.088692728,0.119125683
Wyoming,CAMPBELL,48013,42224,380,3935,5789,0.879428488,0.08195697,0.120571512
Wyoming,CARBON,15739,12343,218,2731,3396,0.784230256,0.173518013,0.215769744
Wyoming,CONVERSE,14101,12568,6,1054,1533,0.891284306,0.074746472,0.108715694
Wyoming,CROOK,7229,6996,14,183,233,0.967768709,0.025314705,0.032231291
Wyoming,FREMONT,40755,28750,197,2674,12005,0.705434916,0.065611581,0.294565084
Wyoming,GOSHEN,13544,11713,46,1409,1831,0.864810986,0.104031305,0.135189014
Wyoming,HOT SPRINGS,4809,4491,12,174,318,0.933873986,0.036182158,0.066126014
Wyoming,JOHNSON,8600,8153,4,375,447,0.948023256,0.043604651,0.051976744
Wyoming,LARAMIE,95431,75571,2691,13372,19860,0.791891524,0.140122183,0.208108476
Wyoming,LINCOLN,18316,16995,27,801,1321,0.927877266,0.043732256,0.072122734
Wyoming,NATRONA,80011,69745,883,6372,10266,0.871692642,0.07963905,0.128307358
Wyoming,NIOBRARA,2516,2303,7,65,213,0.915341812,0.025834658,0.084658188
Wyoming,PARK,28985,26226,236,1671,2759,0.904812834,0.057650509,0.095187166
Wyoming,PLATTE,8750,7827,3,672,923,0.894514286,0.0768,0.105485714
Wyoming,SHERIDAN,29738,27270,241,1246,2468,0.917008541,0.041899253,0.082991459
Wyoming,SUBLETTE,10117,8916,0,777,1201,0.88128892,0.076801423,0.11871108
Wyoming,SWEETWATER,44772,35751,375,7056,9021,0.798512463,0.157598499,0.201487537
Wyoming,TETON,22311,18115,35,3378,4196,0.811931334,0.151405136,0.188068666
Wyoming,UINTA,20930,18378,41,1858,2552,0.878069756,0.088772097,0.121930244
Wyoming,WASHAKIE,8400,6921,57,1175,1479,0.823928571,0.139880952,0.176071429