state,county,total_pop,white,black,latino,non_white,pct_white,pct_nonwhite,pct_latino
Alabama,AUTAUGA,43671,34823,7428,610,8848,0.797394152,0.202605848,0.01396808
Alabama,BALDWIN,140415,120868,14357,2466,19547,0.860791226,0.139208774,0.017562226
Alabama,BARBOUR,29038,14788,13369,478,14250,0.509263723,0.490736277,0.016461189
Alabama,BIBB,20826,15870,4584,210,4956,0.762028234,0.237971766,0.010083549
Alabama,BLOUNT,51024,46999,598,2718,4025,0.921115553,0.078884447,0.05326905
Alabama,BULLOCK,11714,2764,8486,322,8950,0.235956975,0.764043025,0.027488475
Alabama,BUTLER,21399,12429,8671,143,8970,0.580821534,0.419178466,0.006682555
Alabama,CALHOUN,112249,87598,20725,1753,24651,0.780390026,0.219609974,0.015617066
Alabama,CHAMBERS,36583,22111,13872,280,14472,0.604406418,0.395593582,0.007653828
Alabama,CHEROKEE,23988,22164,1327,204,1824,0.923961981,0.076038019,0.008504252
Alabama,CHILTON,39593,33897,4131,1152,5696,0.856136186,0.143863814,0.029096052
Alabama,CHOCTAW,15922,8724,6985,107,7198,0.547921115,0.452078885,0.006720261
Alabama,CLARKE,27867,15519,11918,180,12348,0.556895252,0.443104748,0.006459253
Alabama,CLAY,14254,11616,2219,253,2638,0.814929143,0.185070857,0.017749404
Alabama,CLEBURNE,14123,13235,521,198,888,0.937123841,0.062876159,0.014019684
Alabama,COFFEE,43615,32971,7950,1183,10644,0.75595552,0.24404448,0.027123696
Alabama,COLBERT,54984,44470,9096,618,10514,0.808780736,0.191219264,0.011239633
Alabama,CONECUH,14089,7760,6091,102,6329,0.5507843,0.4492157,0.007239691
Alabama,COOSA,12202,7742,4147,158,4460,0.63448615,0.36551385,0.012948697
Alabama,COVINGTON,37631,32247,4618,292,5384,0.85692647,0.14307353,0.00775956
Alabama,CRENSHAW,13665,10042,3369,87,3623,0.734870106,0.265129894,0.00636663
Alabama,CULLMAN,77483,73940,726,1688,3543,0.954273841,0.045726159,0.021785424
Alabama,DALE,49129,35771,9902,1642,13358,0.728103564,0.271896436,0.033422215
Alabama,DALLAS,46365,16417,29201,290,29948,0.354081743,0.645918257,0.006254718
Alabama,DEKALB,64452,58436,1064,3578,6016,0.906659219,0.093340781,0.055514181
Alabama,ELMORE,65874,50376,13505,805,15498,0.764732671,0.235267329,0.012220299
Alabama,ESCAMBIA,38440,24575,11799,379,13865,0.639308012,0.360691988,0.009859521
Alabama,ETOWAH,103459,84919,15120,1763,18540,0.820798577,0.179201423,0.017040567
Alabama,FAYETTE,18495,15994,2199,152,2501,0.864774263,0.135225737,0.008218437
Alabama,FRANKLIN,31223,27268,1307,2316,3955,0.873330558,0.126669442,0.074176088
Alabama,GENEVA,25764,22181,2725,453,3583,0.86092998,0.13907002,0.017582673
Alabama,GREENE,9974,1898,7964,58,8076,0.190294766,0.809705234,0.005815119
Alabama,HALE,17185,6803,10074,157,10382,0.39586849,0.60413151,0.009135874
Alabama,HENRY,16310,10647,5247,249,5663,0.6527897,0.3472103,0.015266708
Alabama,HOUSTON,88787,64312,21703,1122,24475,0.724340275,0.275659725,0.012636985
Alabama,JACKSON,53926,49200,2002,610,4726,0.912361384,0.087638616,0.011311798
Alabama,JEFFERSON,662047,379707,259623,10284,282340,0.573534809,0.426465191,0.01553364
Alabama,LAMAR,15904,13695,1899,207,2209,0.861104125,0.138895875,0.013015594
Alabama,LAUDERDALE,87966,77240,8624,894,10726,0.878066526,0.121933474,0.010163018
Alabama,LAWRENCE,34803,26899,4613,367,7904,0.772893141,0.227106859,0.010545068
Alabama,LEE,115092,84298,25954,1645,30794,0.732440135,0.267559865,0.014292913
Alabama,LIMESTONE,65676,54142,8703,1740,11534,0.824380291,0.175619709,0.026493696
Alabama,LOWNDES,13473,3464,9841,85,10009,0.257106806,0.742893194,0.006308914
Alabama,MACON,24105,3331,20298,173,20774,0.138187098,0.861812902,0.007176934
Alabama,MADISON,276700,196496,62602,5226,80204,0.710140947,0.289859053,0.018886881
Alabama,MARENGO,22539,10582,11581,219,11957,0.469497316,0.530502684,0.009716491
Alabama,MARION,31214,29387,1131,360,1827,0.941468572,0.058531428,0.011533286
Alabama,MARSHALL,82231,75081,1194,4656,7150,0.913049823,0.086950177,0.056620982
Alabama,MOBILE,399843,249763,132845,4887,150080,0.624652676,0.375347324,0.012222297
Alabama,MONROE,24324,13962,9683,190,10362,0.574000987,0.425999013,0.007811215
Alabama,MONTGOMERY,223510,107858,108146,2665,115652,0.482564538,0.517435462,0.011923404
Alabama,MORGAN,111064,92584,12383,3645,18480,0.83360945,0.16639055,0.032818915
Alabama,PERRY,11861,3642,8057,102,8219,0.307056741,0.692943259,0.008599612
Alabama,PICKENS,20949,11676,8940,147,9273,0.557353573,0.442646427,0.007017041
Alabama,PIKE,29605,17790,10766,365,11815,0.600912008,0.399087992,0.012328998
Alabama,RANDOLPH,22380,16940,4949,272,5440,0.756925827,0.243074173,0.012153709
Alabama,RUSSELL,49756,27925,20217,744,21831,0.561238846,0.438761154,0.01495297
Alabama,ST. CLAIR,64742,57917,5253,686,6825,0.89458157,0.10541843,0.010595904
Alabama,SHELBY,143293,126951,10570,2910,16342,0.885953954,0.114046046,0.02030804
Alabama,SUMTER,14798,3813,10718,165,10985,0.257669955,0.742330045,0.011150155
Alabama,TALLADEGA,80321,53399,25206,812,26922,0.66481991,0.33518009,0.010109436
Alabama,TALLAPOOSA,41475,30342,10488,242,11133,0.731573237,0.268426763,0.00583484
Alabama,TUSCALOOSA,164875,111367,48135,2130,53508,0.67546323,0.32453677,0.012918878
Alabama,WALKER,70713,64855,4323,607,5858,0.91715809,0.08284191,0.008583994
Alabama,WASHINGTON,18097,11673,4818,160,6424,0.645024037,0.354975963,0.008841244
Alabama,WILCOX,13183,3611,9423,97,9572,0.273913373,0.726086627,0.007357961
Alabama,WINSTON,24843,24055,93,372,788,0.968280803,0.031719197,0.014974037
Alaska,ALEUTIANS EAST BOROUGH,2697,521,42,339,2176,0.193177605,0.806822395,0.125695217
Alaska,ALEUTIANS WEST CENSUS AREA,5465,2059,165,573,3406,0.376761208,0.623238792,0.104849039
Alaska,ANCHORAGE MUNICIPALITY,260283,181982,14667,14799,78301,0.69916975,0.30083025,0.056857344
Alaska,BETHEL CENSUS AREA,16006,1958,59,140,14048,0.122329127,0.877670873,0.00874672
Alaska,BRISTOL BAY BOROUGH,1258,656,7,7,602,0.521462639,0.478537361,0.005564388
Alaska,DENALI BOROUGH,1893,1600,27,47,293,0.845219229,0.154780771,0.024828315
Alaska,DILLINGHAM CENSUS AREA,4922,1031,18,111,3891,0.209467696,0.790532304,0.022551808
Alaska,FAIRBANKS NORTH STAR BOROUGH,82840,62942,4719,3440,19898,0.759802028,0.240197972,0.041525833
Alaska,HAINES BOROUGH,2392,1960,3,33,432,0.819397993,0.180602007,0.013795987
Alaska,JUNEAU CITY AND BOROUGH,30711,22498,235,1040,8213,0.732571391,0.267428609,0.033864088
Alaska,KENAI PENINSULA BOROUGH,49691,42263,220,1087,7428,0.85051619,0.14948381,0.021875189
Alaska,KETCHIKAN GATEWAY BOROUGH,14070,10264,67,372,3806,0.72949538,0.27050462,0.026439232
Alaska,KODIAK ISLAND BOROUGH,13913,8001,129,848,5912,0.575073672,0.424926328,0.06095019
Alaska,LAKE AND PENINSULA BOROUGH,1823,342,1,21,1481,0.187602852,0.812397148,0.011519473
Alaska,MATANUSKA-SUSITNA BOROUGH,59322,51175,398,1485,8147,0.862664779,0.137335221,0.025032871
Alaska,NOME CENSUS AREA,9196,1752,35,92,7444,0.190517616,0.809482384,0.01000435
Alaska,NORTH SLOPE BOROUGH,7385,1228,51,175,6157,0.166283006,0.833716994,0.023696682
Alaska,NORTHWEST ARCTIC BOROUGH,7208,878,15,57,6330,0.121809101,0.878190899,0.00790788
Alaska,PRINCE OF WALES-OUTER KETCHIKAN CENSUS AREA,6146,3228,9,107,2918,0.525219655,0.474780345,0.017409697
Alaska,SITKA CITY AND BOROUGH,8835,5927,24,290,2908,0.670854556,0.329145444,0.032823995
Alaska,SKAGWAY-HOONAH-ANGOON CENSUS AREA,3436,1975,5,97,1461,0.574796275,0.425203725,0.028230501
Alaska,SOUTHEAST FAIRBANKS CENSUS AREA,6174,4780,118,167,1394,0.774214448,0.225785552,0.027048915
Alaska,VALDEZ-CORDOVA CENSUS AREA,10195,7612,33,286,2583,0.74664051,0.25335949,0.028052967
Alaska,WADE HAMPTON CENSUS AREA,7028,330,4,23,6698,0.046955037,0.953044963,0.003272624
Alaska,WRANGELL-PETERSBURG CENSUS AREA,6684,4846,15,132,1838,0.725014961,0.274985039,0.019748654
Alaska,YAKUTAT CITY AND BOROUGH,808,406,1,6,402,0.502475248,0.497524752,0.007425743
Alaska,YUKON-KOYUKUK CENSUS AREA,6551,1574,6,78,4977,0.240268661,0.759731339,0.011906579
Arizona,APACHE,69423,12281,163,3119,57142,0.176901027,0.823098973,0.044927474
Arizona,COCHISE,117755,70754,5062,36134,47001,0.600857713,0.399142287,0.306857458
Arizona,COCONINO,116320,66969,1150,12727,49351,0.575730743,0.424269257,0.109413686
Arizona,GILA,51335,35391,174,8546,15944,0.689412681,0.310587319,0.166475114
Arizona,GRAHAM,33489,18488,602,9054,15001,0.552061871,0.447938129,0.270357431
Arizona,GREENLEE,8547,4604,34,3681,3943,0.538668539,0.461331461,0.430677431
Arizona,LA PAZ,19715,12573,149,4420,7142,0.637737763,0.362262237,0.224194776
Arizona,MARICOPA,3072149,2034530,108521,763341,1037619,0.66224978,0.33775022,0.248471347
Arizona,MOHAVE,155032,130283,787,17182,24749,0.84036199,0.15963801,0.110828732
Arizona,NAVAJO,97470,41196,794,8011,56274,0.422653124,0.577346876,0.082189392
Arizona,PIMA,843746,518720,24047,247578,325026,0.614782174,0.385217826,0.293427169
Arizona,PINAL,179727,105641,4658,53671,74086,0.58778592,0.41221408,0.298625137
Arizona,SANTA CRUZ,38381,6835,75,31005,31546,0.178082906,0.821917094,0.807821578
Arizona,YAVAPAI,167517,145037,589,16376,22480,0.865804665,0.134195335,0.097757243
Arizona,YUMA,160026,70956,3136,80772,89070,0.443402947,0.556597053,0.504742979
Arkansas,ARKANSAS,20749,15516,4823,157,5233,0.747795074,0.252204926,0.00756663
Arkansas,ASHLEY,24209,16702,6506,776,7507,0.689908712,0.310091288,0.032054195
Arkansas,BAXTER,38386,37282,42,385,1104,0.971239514,0.028760486,0.010029698
Arkansas,BENTON,153406,133094,558,13469,20312,0.867593184,0.132406816,0.087799695
Arkansas,BOONE,33948,32907,39,360,1041,0.969335454,0.030664546,0.010604454
Arkansas,BRADLEY,12600,7851,3598,1040,4749,0.623095238,0.376904762,0.082539683
Arkansas,CALHOUN,5744,4248,1342,86,1496,0.739554318,0.260445682,0.014972145
Arkansas,CARROLL,25357,22249,25,2471,3108,0.877430295,0.122569705,0.097448436
Arkansas,CHICOT,14117,5980,7541,407,8137,0.423602748,0.576397252,0.028830488
Arkansas,CLARK,23546,17302,5166,566,6244,0.734816954,0.265183046,0.024038053
Arkansas,CLAY,17609,17177,29,140,432,0.975467091,0.024532909,0.00795048
Arkansas,CLEBURNE,24046,23392,29,282,654,0.972802129,0.027197871,0.011727522
Arkansas,CLEVELAND,8571,7199,1124,139,1372,0.83992533,0.16007467,0.016217478
Arkansas,COLUMBIA,25603,15776,9205,269,9827,0.616177792,0.383822208,0.010506581
Arkansas,CONWAY,20336,16973,2649,359,3363,0.834628245,0.165371755,0.017653423
Arkansas,CRAIGHEAD,82148,72489,6345,1739,9659,0.882419535,0.117580465,0.021169109
Arkansas,CRAWFORD,53247,48311,463,1743,4936,0.907299942,0.092700058,0.032734239
Arkansas,CRITTENDEN,50866,25643,23828,720,25223,0.504128494,0.495871506,0.014154838
Arkansas,CROSS,19526,14525,4608,181,5001,0.743879955,0.256120045,0.009269692
Arkansas,DALLAS,9210,5193,3743,177,4017,0.563843648,0.436156352,0.019218241
Arkansas,DESHA,15341,7611,7044,485,7730,0.496121504,0.503878496,0.031614627
Arkansas,DREW,18723,13047,5071,329,5676,0.696843455,0.303156545,0.01757197
Arkansas,FAULKNER,86014,75218,7261,1509,10796,0.874485549,0.125514451,0.017543656
Arkansas,FRANKLIN,17771,16943,108,310,828,0.953407237,0.046592763,0.017444151
Arkansas,FULTON,11642,11326,23,62,316,0.972856897,0.027143103,0.005325545
Arkansas,GARLAND,88068,76844,6829,2254,11224,0.872553027,0.127446973,0.025593859
Arkansas,GRANT,16464,15663,406,189,801,0.951348397,0.048651603,0.011479592
Arkansas,GREENE,37331,36145,48,434,1186,0.968230157,0.031769843,0.011625727
Arkansas,HEMPSTEAD,23587,14108,7107,1946,9479,0.598126086,0.401873914,0.082503074
Arkansas,HOT SPRING,30353,26295,3107,384,4058,0.866306461,0.133693539,0.012651138
Arkansas,HOWARD,14300,10220,3111,727,4080,0.714685315,0.285314685,0.050839161
Arkansas,INDEPENDENCE,34233,32253,685,523,1980,0.942161073,0.057838927,0.015277656
Arkansas,IZARD,13249,12702,189,133,547,0.958713865,0.041286135,0.010038493
Arkansas,JACKSON,18418,14725,3210,234,3693,0.79948963,0.20051037,0.012704963
Arkansas,JEFFERSON,84278,40475,41623,810,43803,0.48025582,0.51974418,0.009611049
Arkansas,JOHNSON,22781,20512,303,1527,2269,0.900399456,0.099600544,0.067029542
Arkansas,LAFAYETTE,8559,5262,3106,88,3297,0.614791448,0.385208552,0.010281575
Arkansas,LAWRENCE,17774,17305,78,121,469,0.973613143,0.026386857,0.006807697
Arkansas,LEE,12580,5074,7142,276,7506,0.403338633,0.596661367,0.021939587
Arkansas,LINCOLN,14492,9315,4760,263,5177,0.642768424,0.357231576,0.018147944
Arkansas,LITTLE RIVER,13628,10063,2891,235,3565,0.738406222,0.261593778,0.01724391
Arkansas,LOGAN,22486,21528,235,273,958,0.957395713,0.042604287,0.012140888
Arkansas,LONOKE,52828,47555,3393,922,5273,0.900185508,0.099814492,0.017452866
Arkansas,MADISON,14243,13462,15,436,781,0.945166046,0.054833954,0.030611528
Arkansas,MARION,16140,15646,18,122,494,0.969392813,0.030607187,0.00755886
Arkansas,MILLER,40443,29606,9250,641,10837,0.732042628,0.267957372,0.015849467
Arkansas,MISSISSIPPI,51979,33037,16909,1169,18942,0.635583601,0.364416399,0.022489852
Arkansas,MONROE,10254,6003,3964,132,4251,0.585430076,0.414569924,0.012873025
Arkansas,MONTGOMERY,9245,8740,27,234,505,0.945375879,0.054624121,0.025310979
Arkansas,NEVADA,9955,6618,3088,151,3337,0.664791562,0.335208438,0.015168257
Arkansas,NEWTON,8608,8333,12,93,275,0.968052974,0.031947026,0.010803903
Arkansas,OUACHITA,28790,17114,11084,210,11676,0.594442515,0.405557485,0.007294199
Arkansas,PERRY,10209,9711,177,120,498,0.951219512,0.048780488,0.011754334
Arkansas,PHILLIPS,26445,10245,15495,382,16200,0.387407828,0.612592172,0.014445075
Arkansas,PIKE,11303,10310,391,403,993,0.912147218,0.087852782,0.035654251
Arkansas,POINSETT,25614,23172,1815,366,2442,0.904661513,0.095338487,0.014289061
Arkansas,POLK,20229,18836,32,708,1393,0.931138465,0.068861535,0.034999258
Arkansas,POPE,54469,50535,1403,1123,3934,0.927775432,0.072224568,0.020617232
Arkansas,PRAIRIE,9539,8060,1304,77,1479,0.844952301,0.155047699,0.008072125
Arkansas,PULASKI,361474,227390,114732,8816,134084,0.629063224,0.370936776,0.024389029
Arkansas,RANDOLPH,18195,17559,174,149,636,0.965045342,0.034954658,0.008189063
Arkansas,ST. FRANCIS,29329,13224,14273,1431,16105,0.45088479,0.54911521,0.048791299
Arkansas,SALINE,83529,78968,1814,1090,4561,0.94539621,0.05460379,0.01304936
Arkansas,SCOTT,10996,9953,24,628,1043,0.905147326,0.094852674,0.057111677
Arkansas,SEARCY,8261,7993,3,86,268,0.967558407,0.032441593,0.010410362
Arkansas,SEBASTIAN,115071,92010,7011,7710,23061,0.799593295,0.200406705,0.067002112
Arkansas,SEVIER,15757,11423,757,3107,4334,0.724947642,0.275052358,0.197182205
Arkansas,SHARP,17119,16503,84,167,616,0.96401659,0.03598341,0.009755243
Arkansas,STONE,11499,11092,9,124,407,0.964605618,0.035394382,0.010783546
Arkansas,UNION,45629,29950,14543,520,15679,0.65638081,0.34361919,0.011396261
Arkansas,VAN BUREN,16192,15550,50,215,642,0.960350791,0.039649209,0.013278162
Arkansas,WASHINGTON,157715,133368,3408,12932,24347,0.845626605,0.154373395,0.081996005
Arkansas,WHITE,67165,62177,2389,1264,4988,0.92573513,0.07426487,0.018819326
Arkansas,WOODRUFF,8741,5899,2671,69,2842,0.674865576,0.325134424,0.007893834
Arkansas,YELL,21139,17650,296,2691,3489,0.834949619,0.165050381,0.127300251
California,ALAMEDA,1443741,591095,211124,273910,852646,0.409419002,0.590580998,0.189722395
California,ALPINE,1208,867,7,94,341,0.717715232,0.282284768,0.07781457
California,AMADOR,35100,28920,1348,3126,6180,0.823931624,0.176068376,0.089059829
California,BUTTE,203171,162564,2699,21339,40607,0.800133877,0.199866123,0.105029753
California,CALAVERAS,40554,35465,300,2765,5089,0.874512995,0.125487005,0.068180697
California,COLUSA,18804,9018,88,8752,9786,0.479578813,0.520421187,0.465432887
California,CONTRA COSTA,948816,549409,86851,167776,399407,0.579046939,0.420953061,0.176826698
California,DEL NORTE,27507,19294,1167,3829,8213,0.701421456,0.298578544,0.139200931
California,EL DORADO,156299,132725,745,14566,23574,0.849173699,0.150826301,0.093193175
California,FRESNO,799407,317522,40291,351636,481885,0.397196922,0.602803078,0.439871054
California,GLENN,26453,16548,117,7840,9905,0.625562318,0.374437682,0.296374702
California,HUMBOLDT,126518,103230,1035,8210,23288,0.81593133,0.18406867,0.064891952
California,IMPERIAL,142361,28768,5148,102817,113593,0.202077816,0.797922184,0.722227295
California,INYO,17945,13352,20,2257,4593,0.744051268,0.255948732,0.125773196
California,KERN,661645,327190,37845,254036,334455,0.494509896,0.505490104,0.383946074
California,KINGS,129461,53817,10418,56461,75644,0.415700481,0.584299519,0.43612362
California,LAKE,58309,46933,1209,6639,11376,0.804901473,0.195098527,0.113858924
California,LASSEN,33828,23893,2976,4681,9935,0.706308384,0.293691616,0.138376493
California,LOS ANGELES,9519338,2959614,901472,4242213,6559724,0.310905443,0.689094557,0.445641598
California,MADERA,123109,57391,4710,54515,65718,0.466180377,0.533819623,0.442818965
California,MARIN,247289,194254,6946,27351,53035,0.785534334,0.214465666,0.110603383
California,MARIPOSA,17130,14539,111,1329,2591,0.848744892,0.151255108,0.077583187
California,MENDOCINO,86265,64581,471,14213,21684,0.74863502,0.25136498,0.164759752
California,MERCED,210554,85585,7594,95466,124969,0.406475298,0.593524702,0.453403877
California,MODOC,9449,7663,59,1088,1786,0.810985289,0.189014711,0.11514446
California,MONO,12853,9837,53,2274,3016,0.765346612,0.234653388,0.176923675
California,MONTEREY,401762,162045,14085,187969,239717,0.403335806,0.596664194,0.46786157
California,NAPA,124279,85932,1527,29416,38347,0.69144425,0.30855575,0.236693247
California,NEVADA,92033,83098,234,5201,8935,0.902915259,0.097084741,0.056512338
California,ORANGE,2846289,1458978,42639,875579,1387311,0.512589551,0.487410449,0.307621257
California,PLACER,248399,207236,1896,24019,41163,0.834286772,0.165713228,0.096695236
California,PLUMAS,20824,18473,130,1177,2351,0.887101421,0.112898579,0.056521322
California,RIVERSIDE,1545387,788831,92403,559575,756556,0.510442368,0.489557632,0.362093767
California,SACRAMENTO,1223499,706655,118073,195890,516844,0.577568923,0.422431077,0.160106383
California,SAN BENITO,53234,24513,475,25516,28721,0.460476387,0.539523613,0.479317729
California,SAN BERNARDINO,1709434,752222,150201,669387,957212,0.440041558,0.559958442,0.391583998
California,SAN DIEGO,2813833,1548833,154487,750965,1265000,0.550435296,0.449564704,0.266883287
California,SAN FRANCISCO,776733,338909,58791,109504,437824,0.436326254,0.563673746,0.140980234
California,SAN JOAQUIN,563598,267002,36139,172073,296596,0.473745471,0.526254529,0.305311587
California,SAN LUIS OBISPO,246681,187840,4743,40196,58841,0.761469266,0.238530734,0.162947288
California,SAN MATEO,707161,352355,23778,154708,354806,0.498267014,0.501732986,0.218773377
California,SANTA BARBARA,399347,227083,8385,136668,172264,0.568635798,0.431364202,0.342228688
California,SANTA CLARA,1682585,744282,44475,403401,938303,0.442344369,0.557655631,0.239750741
California,SANTA CRUZ,255602,167464,2160,68486,88138,0.655174842,0.344825158,0.26794
California,SHASTA,163256,141097,1179,8998,22159,0.864268388,0.135731612,0.055115892
California,SIERRA,3555,3210,6,213,345,0.902953586,0.097046414,0.059915612
California,SISKIYOU,44301,36910,556,3354,7391,0.833164037,0.166835963,0.075709352
California,SOLANO,394542,194282,57597,69598,200260,0.492424127,0.507575873,0.176402005
California,SONOMA,458614,341686,6116,79511,116928,0.745040492,0.254959508,0.173372379
California,STANISLAUS,446997,256001,10621,141871,190996,0.572713016,0.427286984,0.317386918
California,SUTTER,78930,47532,1418,17529,31398,0.602204485,0.397795515,0.222082858
California,TEHAMA,56039,43972,279,8871,12067,0.784667821,0.215332179,0.158300469
California,TRINITY,13022,11271,54,517,1751,0.865535248,0.134464752,0.039702043
California,TULARE,368021,153916,5122,186846,214105,0.418226134,0.581773866,0.507704723
California,TUOLUMNE,54501,46377,1135,4445,8124,0.850938515,0.149061485,0.081558137
California,VENTURA,753197,427449,13490,251734,325748,0.567512882,0.432487118,0.334220662
California,YOLO,168660,97942,3133,43707,70718,0.580706747,0.419293253,0.259142654
California,YUBA,60219,39320,1795,10449,20899,0.652950066,0.347049934,0.173516664
Colorado,ADAMS,363857,230500,10206,102585,133357,0.63349063,0.36650937,0.281937684
Colorado,ALAMOSA,14966,8089,106,6197,6877,0.540491781,0.459508219,0.414071896
Colorado,ARAPAHOE,487967,360744,36254,57612,127223,0.7392795,0.2607205,0.118065361
Colorado,ARCHULETA,9898,7927,31,1659,1971,0.800868862,0.199131138,0.167609618
Colorado,BACA,4517,4084,1,317,433,0.904139916,0.095860084,0.070179323
Colorado,BENT,5998,3794,208,1814,2204,0.632544181,0.367455819,0.302434145
Colorado,BOULDER,291288,243512,2393,30456,47776,0.835983631,0.164016369,0.104556315
Colorado,CHAFFEE,16242,14174,257,1393,2068,0.872675779,0.127324221,0.0857653
Colorado,CHEYENNE,2231,2018,9,181,213,0.904527118,0.095472882,0.081129538
Colorado,CLEAR CREEK,9322,8759,26,361,563,0.939605235,0.060394765,0.038725595
Colorado,CONEJOS,8400,3298,9,4949,5102,0.392619048,0.607380952,0.589166667
Colorado,COSTILLA,3663,1033,21,2476,2630,0.282009282,0.717990718,0.675948676
Colorado,CROWLEY,5518,3671,386,1244,1847,0.665277274,0.334722726,0.225444001
Colorado,CUSTER,3503,3299,12,88,204,0.941764202,0.058235798,0.025121325
Colorado,DELTA,27834,23945,135,3171,3889,0.860278796,0.139721204,0.113925415
Colorado,DENVER,554636,287997,59921,175704,266639,0.519254069,0.480745931,0.316791553
Colorado,DOLORES,1844,1711,1,71,133,0.927874187,0.072125813,0.038503254
Colorado,DOUGLAS,175766,157686,1596,8886,18080,0.897135965,0.102864035,0.050555853
Colorado,EAGLE,41659,30892,104,9682,10767,0.741544444,0.258455556,0.232410764
Colorado,ELBERT,19872,18511,123,766,1361,0.931511675,0.068488325,0.038546699
Colorado,EL PASO,516929,393819,32393,58401,123110,0.761843503,0.238156497,0.11297683
Colorado,FREMONT,46145,37408,2439,4776,8737,0.810662044,0.189337956,0.103499837
Colorado,GARFIELD,43791,35449,128,7300,8342,0.809504236,0.190495764,0.16670092
Colorado,GILPIN,4757,4377,24,202,380,0.920117721,0.079882279,0.042463738
Colorado,GRAND,12442,11577,60,543,865,0.930477415,0.069522585,0.043642501
Colorado,GUNNISON,13956,12886,55,700,1070,0.923330467,0.076669533,0.050157638
Colorado,HINSDALE,790,763,0,12,27,0.965822785,0.034177215,0.015189873
Colorado,HUERFANO,7862,4590,210,2763,3272,0.583820911,0.416179089,0.351437293
Colorado,JACKSON,1577,1452,0,103,125,0.920735574,0.079264426,0.065313887
Colorado,JEFFERSON,527056,447416,4312,52449,79640,0.848896512,0.151103488,0.099513145
Colorado,KIOWA,1622,1530,8,51,92,0.943279901,0.056720099,0.031442663
Colorado,KIT CARSON,8011,6678,136,1095,1333,0.833603795,0.166396205,0.136687055
Colorado,LAKE,7812,4809,12,2823,3003,0.615591398,0.384408602,0.361367127
Colorado,LA PLATA,43941,36168,120,4571,7773,0.823103707,0.176896293,0.104025853
Colorado,LARIMER,251494,220159,1511,20811,31335,0.875404582,0.124595418,0.082749489
Colorado,LAS ANIMAS,15207,8387,52,6304,6820,0.551522325,0.448477675,0.414545933
Colorado,LINCOLN,6087,5126,298,519,961,0.842122556,0.157877444,0.085263677
Colorado,LOGAN,20504,17310,411,2439,3194,0.844225517,0.155774483,0.1189524
Colorado,MESA,116255,101110,460,11651,15145,0.869726033,0.130273967,0.100219345
Colorado,MINERAL,831,793,0,17,38,0.954271961,0.045728039,0.02045728
Colorado,MOFFAT,13184,11626,17,1247,1558,0.881826456,0.118173544,0.094584345
Colorado,MONTEZUMA,23830,18476,31,2263,5354,0.77532522,0.22467478,0.094964331
Colorado,MONTROSE,33432,27554,78,4967,5878,0.824180426,0.175819574,0.148570232
Colorado,MORGAN,27171,18191,57,8473,8980,0.66950057,0.33049943,0.311839829
Colorado,OTERO,20311,12014,111,7642,8297,0.591502142,0.408497858,0.376249323
Colorado,OURAY,3742,3487,3,152,255,0.931854623,0.068145377,0.040619989
Colorado,PARK,14523,13431,67,628,1092,0.924808924,0.075191076,0.043241754
Colorado,PHILLIPS,4480,3865,9,527,615,0.862723214,0.137276786,0.117633929
Colorado,PITKIN,14872,13479,55,973,1393,0.906334051,0.093665949,0.06542496
Colorado,PROWERS,14483,9427,35,4766,5056,0.650901056,0.349098944,0.329075468
Colorado,PUEBLO,141472,81624,2391,53710,59848,0.576962226,0.423037774,0.379651097
Colorado,RIO BLANCO,5986,5546,11,296,440,0.926495155,0.073504845,0.049448714
Colorado,RIO GRANDE,12413,7022,12,5172,5391,0.565697253,0.434302747,0.416659953
Colorado,ROUTT,19690,18662,23,634,1028,0.947790757,0.052209243,0.032199086
Colorado,SAGUACHE,5917,3053,1,2678,2864,0.515970931,0.484029069,0.45259422
Colorado,SAN JUAN,558,509,0,41,49,0.91218638,0.08781362,0.073476703
Colorado,SAN MIGUEL,6594,5959,10,439,635,0.903700334,0.096299666,0.066575675
Colorado,SEDGWICK,2747,2376,9,314,371,0.864943575,0.135056425,0.114306516
Colorado,SUMMIT,23548,20411,157,2306,3137,0.866782742,0.133217258,0.097927637
Colorado,TELLER,20555,19102,109,718,1453,0.929311603,0.070688397,0.034930674
Colorado,WASHINGTON,4926,4568,2,310,358,0.927324401,0.072675599,0.062931384
Colorado,WELD,180936,126573,817,48935,54363,0.699545696,0.300454304,0.270454746
Colorado,YUMA,9841,8474,10,1268,1367,0.861091353,0.138908647,0.128848694
Connecticut,FAIRFIELD,882567,645152,84724,104835,237415,0.730994927,0.269005073,0.118784183
Connecticut,HARTFORD,857183,625797,95157,98968,231386,0.730062309,0.269937691,0.115457259
Connecticut,LITCHFIELD,182193,172154,1837,3894,10039,0.944899091,0.055100909,0.02137294
Connecticut,MIDDLESEX,155071,138979,6588,4649,16092,0.896228179,0.103771821,0.029979816
Connecticut,NEW HAVEN,824008,616541,89286,83131,207467,0.748222105,0.251777895,0.100886156
Connecticut,NEW LONDON,259088,219542,12760,13236,39546,0.847364602,0.152635398,0.051086889
Connecticut,TOLLAND,136364,124014,3480,3873,12350,0.909433575,0.090566425,0.028401924
Connecticut,WINDHAM,109091,96666,1739,7737,12425,0.886104262,0.113895738,0.070922441
Delaware,KENT,126697,91325,25770,4069,35372,0.720814226,0.279185774,0.032115993
Delaware,NEW CASTLE,500265,353760,99648,26293,146505,0.707145213,0.292854787,0.052558144
Delaware,SUSSEX,156638,122888,23017,6915,33750,0.784535043,0.215464957,0.044146376
District of Columbia,DISTRICT OF COLUMBIA,572059,159178,340088,44953,412881,0.278254516,0.721745484,0.078581055
Florida,ALACHUA,217955,151817,41597,12493,66138,0.696552041,0.303447959,0.057319171
Florida,BAKER,22259,18389,3083,419,3870,0.826137742,0.173862258,0.018823847
Florida,BAY,148217,122708,15526,3591,25509,0.827894236,0.172105764,0.02422799
Florida,BRADFORD,26088,19559,5367,622,6529,0.749731677,0.250268323,0.02384238
Florida,BREVARD,476230,398695,39067,21970,77535,0.837190013,0.162809987,0.046133171
Florida,BROWARD,1623018,941674,325305,271652,681344,0.580199357,0.419800643,0.167374607
Florida,CALHOUN,13017,10105,2028,492,2912,0.776292541,0.223707459,0.037796727
Florida,CHARLOTTE,141627,128063,5992,4667,13564,0.904227301,0.095772699,0.032952756
Florida,CITRUS,118085,109828,2712,3141,8257,0.930075793,0.069924207,0.026599483
Florida,CLAY,140814,119587,9243,6059,21227,0.849255046,0.150744954,0.043028392
Florida,COLLIER,251377,185517,10999,49296,65860,0.738003079,0.261996921,0.19610386
Florida,COLUMBIA,56513,44058,9522,1546,12455,0.779608232,0.220391768,0.027356537
Florida,DESOTO,32209,19704,4031,8019,12505,0.611754479,0.388245521,0.24896768
Florida,DIXIE,13827,12132,1231,249,1695,0.877413756,0.122586244,0.018008245
Florida,DUVAL,778879,494747,214473,31946,284132,0.635203928,0.364796072,0.041015357
Florida,ESCAMBIA,294410,208678,62548,7935,85732,0.708800652,0.291199348,0.02695221
Florida,FLAGLER,49832,41636,4295,2537,8196,0.835527372,0.164472628,0.050911061
Florida,FRANKLIN,11057,8822,1762,268,2235,0.797865605,0.202134395,0.024238039
Florida,GADSDEN,45087,16174,25632,2782,28913,0.35872868,0.64127132,0.06170293
Florida,GILCHRIST,14437,12812,996,404,1625,0.887441989,0.112558011,0.027983653
Florida,GLADES,10576,7256,1106,1594,3320,0.686081694,0.313918306,0.150718608
Florida,GULF,13332,10492,2247,270,2840,0.786978698,0.213021302,0.020252025
Florida,HAMILTON,13327,7336,4967,847,5991,0.550461469,0.449538531,0.063555189
Florida,HARDEE,26938,14704,2165,9611,12234,0.545846017,0.454153983,0.356782241
Florida,HENDRY,36210,15890,5245,14336,20320,0.438829053,0.561170947,0.395912731
Florida,HERNANDO,130802,116670,5149,6587,14132,0.891958839,0.108041161,0.050358557
Florida,HIGHLANDS,87366,66814,7925,10542,20552,0.764759746,0.235240254,0.12066479
Florida,HILLSBOROUGH,998948,632605,144259,179692,366343,0.633271201,0.366728799,0.179881235
Florida,HOLMES,18564,16501,1190,358,2063,0.888870933,0.111129067,0.019284637
Florida,INDIAN RIVER,112947,94250,9143,7381,18697,0.834462181,0.165537819,0.065349235
Florida,JACKSON,46755,32086,12273,1361,14669,0.686258154,0.313741846,0.029109186
Florida,JEFFERSON,12902,7522,4903,290,5380,0.583010386,0.416989614,0.022477135
Florida,LAFAYETTE,7022,5286,989,642,1736,0.752776987,0.247223013,0.091426944
Florida,LAKE,210528,177285,17231,11808,33243,0.842097013,0.157902987,0.056087551
Florida,LEE,440888,361439,28020,42042,79449,0.819797772,0.180202228,0.095357551
Florida,LEON,239452,153474,69049,8407,85978,0.640938476,0.359061524,0.035109333
Florida,LEVY,34450,28654,3734,1339,5796,0.831756168,0.168243832,0.038867925
Florida,LIBERTY,7021,5233,1276,316,1788,0.745335422,0.254664578,0.045007834
Florida,MADISON,18733,10378,7475,600,8355,0.553995623,0.446004377,0.03202904
Florida,MANATEE,264002,212664,21136,24540,51338,0.805539352,0.194460648,0.092953841
Florida,MARION,258916,208232,29370,15616,50684,0.804245392,0.195754608,0.060312997
Florida,MARTIN,126731,108741,6482,9506,17990,0.858045782,0.141954218,0.075009272
Florida,MIAMI-DADE,2253362,465772,427140,1291737,1787590,0.206700921,0.793299079,0.573248772
Florida,MONROE,79589,61462,3567,12553,18127,0.772242395,0.227757605,0.157722801
Florida,NASSAU,57663,51323,4436,873,6340,0.890050812,0.109949188,0.015139691
Florida,OKALOOSA,170498,138059,15232,7302,32439,0.809739704,0.190260296,0.042827482
Florida,OKEECHOBEE,35910,25699,2796,6684,10211,0.715650237,0.284349763,0.186131997
Florida,ORANGE,896344,515701,157096,168361,380643,0.575338263,0.424661737,0.187830788
Florida,OSCEOLA,172493,102792,11075,50727,69701,0.595919834,0.404080166,0.294081499
Florida,PALM BEACH,1131184,798484,152433,140675,332700,0.705883393,0.294116607,0.124360847
Florida,PASCO,344765,310066,6833,19603,34699,0.899354633,0.100645367,0.05685902
Florida,PINELLAS,921482,762614,81146,42760,158868,0.827595113,0.172404887,0.046403511
Florida,POLK,483924,361366,64544,45933,122558,0.746741224,0.253258776,0.094917797
Florida,PUTNAM,70423,53087,11898,4168,17336,0.753830425,0.246169575,0.059185209
Florida,ST. JOHNS,123135,109622,7688,3244,13513,0.890258659,0.109741341,0.026345068
Florida,ST. LUCIE,192695,142768,29148,15733,49927,0.740901425,0.259098575,0.081647163
Florida,SANTA ROSA,117743,104919,4899,2968,12824,0.89108482,0.10891518,0.025207443
Florida,SARASOTA,325957,292603,13254,14142,33354,0.89767362,0.10232638,0.043386091
Florida,SEMINOLE,365196,274682,33688,40731,90514,0.752149531,0.247850469,0.11153189
Florida,SUMTER,53345,41796,7202,3356,11549,0.783503609,0.216496391,0.062911238
Florida,SUWANNEE,34844,28262,4177,1703,6582,0.811100907,0.188899093,0.048874986
Florida,TAYLOR,19256,14817,3640,295,4439,0.76947445,0.23052555,0.0153199
Florida,UNION,13442,9659,3038,477,3783,0.718568665,0.281431335,0.035485791
Florida,VOLUSIA,443343,363045,40380,29111,80298,0.818880641,0.181119359,0.065662478
Florida,WAKULLA,22863,19393,2586,443,3470,0.848226392,0.151773608,0.019376285
Florida,WALTON,40601,35425,2801,880,5176,0.872515455,0.127484545,0.021674343
Florida,WASHINGTON,20973,16876,2828,483,4097,0.804653602,0.195346398,0.023029609
Georgia,APPLING,17419,13053,3398,792,4366,0.749354154,0.250645846,0.045467593
Georgia,ATKINSON,7609,4760,1477,1290,2849,0.625574977,0.374425023,0.169536076
Georgia,BACON,10103,8068,1562,342,2035,0.798574681,0.201425319,0.033851331
Georgia,BAKER,4074,1889,2038,111,2185,0.463672067,0.536327933,0.02724595
Georgia,BALDWIN,44700,23920,19324,607,20780,0.535123043,0.464876957,0.013579418
Georgia,BANKS,14422,13256,459,493,1166,0.919151297,0.080848703,0.034183886
Georgia,BARROW,46144,38543,4456,1460,7601,0.835276526,0.164723474,0.031640083
Georgia,BARTOW,76019,65644,6558,2524,10375,0.863520962,0.136479038,0.033202226
Georgia,BEN HILL,17484,10818,5673,800,6666,0.618737131,0.381262869,0.04575612
Georgia,BERRIEN,16235,13761,1843,384,2474,0.847613181,0.152386819,0.023652602
Georgia,BIBB,153887,76262,72503,2023,77625,0.495571426,0.504428574,0.01314601
Georgia,BLECKLEY,11666,8505,2865,107,3161,0.72904166,0.27095834,0.009171953
Georgia,BRANTLEY,14629,13712,579,152,917,0.93731629,0.06268371,0.010390321
Georgia,BROOKS,16450,9303,6429,505,7147,0.565531915,0.434468085,0.030699088
Georgia,BRYAN,23417,19138,3272,465,4279,0.817269505,0.182730495,0.019857369
Georgia,BULLOCH,55983,37998,16000,1052,17985,0.678741761,0.321258239,0.018791419
Georgia,BURKE,22243,10336,11285,316,11907,0.464685519,0.535314481,0.014206717
Georgia,BUTTS,19522,13366,5601,277,6156,0.684663457,0.315336543,0.01418912
Georgia,CALHOUN,6320,2368,3726,189,3952,0.374683544,0.625316456,0.029905063
Georgia,CAMDEN,43664,31975,8719,1585,11689,0.732296629,0.267703371,0.036299927
Georgia,CANDLER,9577,6028,2576,882,3549,0.629424663,0.370575337,0.092095646
Georgia,CARROLL,87268,69258,14177,2243,18010,0.793624238,0.206375762,0.025702434
Georgia,CATOOSA,53282,51013,661,621,2269,0.957415262,0.042584738,0.011654968
Georgia,CHARLTON,10282,7014,2990,81,3268,0.682163003,0.317836997,0.007877845
Georgia,CHATHAM,232048,125802,93463,5403,106246,0.542137834,0.457862166,0.023283976
Georgia,CHATTAHOOCHEE,14882,8181,4353,1551,6701,0.549724499,0.450275501,0.104219863
Georgia,CHATTOOGA,25470,21776,2840,537,3694,0.854966627,0.145033373,0.021083628
Georgia,CHEROKEE,141903,127618,3483,7695,14285,0.899332643,0.100667357,0.054227183
Georgia,CLARKE,101489,62895,27496,6436,38594,0.619722334,0.380277666,0.06341574
Georgia,CLAY,3357,1282,2009,32,2075,0.381888591,0.618111409,0.009532321
Georgia,CLAYTON,236517,82637,120816,17728,153880,0.349391376,0.650608624,0.074954443
Georgia,CLINCH,6878,4713,2019,54,2165,0.685228264,0.314771736,0.00785112
Georgia,COBB,607751,417947,112924,46964,189804,0.687694467,0.312305533,0.077275068
Georgia,COFFEE,37413,24701,9629,2550,12712,0.660225055,0.339774945,0.068158127
Georgia,COLQUITT,42053,27252,9812,4554,14801,0.648039379,0.351960621,0.108291917
Georgia,COLUMBIA,89288,72438,9917,2313,16850,0.811284831,0.188715169,0.025904937
Georgia,COOK,15771,10526,4565,485,5245,0.667427557,0.332572443,0.030752647
Georgia,COWETA,89215,68867,15935,2797,20348,0.771921762,0.228078238,0.03135123
Georgia,CRAWFORD,12495,9037,2970,301,3458,0.7232493,0.2767507,0.024089636
Georgia,CRISP,21996,11778,9511,382,10218,0.535460993,0.464539007,0.017366794
Georgia,DADE,15154,14685,96,137,469,0.969051076,0.030948924,0.009040517
Georgia,DAWSON,15999,15429,57,254,570,0.964372773,0.035627227,0.015875992
Georgia,DECATUR,28240,15800,11227,905,12440,0.559490085,0.440509915,0.032046742
Georgia,DEKALB,665865,214685,358381,52542,451180,0.322415204,0.677584796,0.078907887
Georgia,DODGE,19171,13142,5623,248,6029,0.685514579,0.314485421,0.012936206
Georgia,DOOLY,11525,5161,5679,537,6364,0.447809111,0.552190889,0.04659436
Georgia,DOUGHERTY,96065,35794,57521,1292,60271,0.372601884,0.627398116,0.013449227
Georgia,DOUGLAS,92174,69965,16978,2640,22209,0.759053529,0.240946471,0.028641482
Georgia,EARLY,12354,6159,5901,152,6195,0.498542982,0.501457018,0.012303707
Georgia,ECHOLS,3754,2688,252,739,1066,0.716036228,0.283963772,0.196856686
Georgia,EFFINGHAM,37535,31493,4853,531,6042,0.839030238,0.160969762,0.014146796
Georgia,ELBERT,20511,13505,6305,489,7006,0.658427185,0.341572815,0.023840866
Georgia,EMANUEL,21837,13663,7253,745,8174,0.625681183,0.374318817,0.034116408
Georgia,EVANS,10495,6333,3439,625,4162,0.603430205,0.396569795,0.059552168
Georgia,FANNIN,19798,19312,22,130,486,0.975452066,0.024547934,0.00656632
Georgia,FAYETTE,91263,74820,10383,2582,16443,0.819828408,0.180171592,0.02829186
Georgia,FLOYD,90565,71674,11984,4983,18891,0.791409485,0.208590515,0.055021255
Georgia,FORSYTH,98407,90820,426,5477,7587,0.922901826,0.077098174,0.05565661
Georgia,FRANKLIN,20285,18064,1786,187,2221,0.890510229,0.109489771,0.009218634
Georgia,FULTON,816006,369997,361018,48056,446009,0.453424362,0.546575638,0.058891724
Georgia,GILMER,23456,21287,51,1815,2169,0.90752899,0.09247101,0.077378922
Georgia,GLASCOCK,2556,2309,212,12,247,0.903364632,0.096635368,0.004694836
Georgia,GLYNN,67568,46566,17711,2019,21002,0.689172389,0.310827611,0.029881009
Georgia,GORDON,44104,38642,1511,3268,5462,0.876156358,0.123843642,0.074097588
Georgia,GRADY,23659,14954,7074,1222,8705,0.632063908,0.367936092,0.051650535
Georgia,GREENE,14406,7481,6356,420,6925,0.519297515,0.480702485,0.029154519
Georgia,GWINNETT,588448,394164,76837,64137,194284,0.669836587,0.330163413,0.108993488
Georgia,HABERSHAM,35902,30486,1551,2750,5416,0.849144894,0.150855106,0.076597404
Georgia,HALL,139277,98942,9900,27242,40335,0.710397266,0.289602734,0.195595827
Georgia,HANCOCK,10076,2141,7820,54,7935,0.212485113,0.787514887,0.00535927
Georgia,HARALSON,25690,23799,1387,143,1891,0.926391592,0.073608408,0.005566368
Georgia,HARRIS,23695,18444,4597,260,5251,0.778392066,0.221607934,0.010972779
Georgia,HART,22997,18087,4430,196,4910,0.786493891,0.213506109,0.008522851
Georgia,HEARD,11012,9580,1181,116,1432,0.869960044,0.130039956,0.010533963
Georgia,HENRY,119341,95550,17435,2692,23791,0.800646886,0.199353114,0.02255721
Georgia,HOUSTON,110765,76391,27181,3363,34374,0.689667314,0.310332686,0.030361576
Georgia,IRWIN,9931,7102,2555,202,2829,0.715134428,0.284865572,0.020340348
Georgia,JACKSON,41589,36314,3197,1249,5275,0.873163577,0.126836423,0.03003198
Georgia,JASPER,11426,7964,3096,236,3462,0.697006827,0.302993173,0.020654647
Georgia,JEFF DAVIS,12684,9992,1904,651,2692,0.787764112,0.212235888,0.051324503
Georgia,JEFFERSON,17266,7215,9663,259,10051,0.417873277,0.582126723,0.015000579
Georgia,JENKINS,8575,4766,3437,287,3809,0.555801749,0.444198251,0.033469388
Georgia,JOHNSON,8560,5307,3131,78,3253,0.619976636,0.380023364,0.00911215
Georgia,JONES,23639,17649,5490,169,5990,0.746605186,0.253394814,0.007149203
Georgia,LAMAR,15912,10683,4806,172,5229,0.67138009,0.32861991,0.010809452
Georgia,LANIER,7241,5122,1845,126,2119,0.707360862,0.292639138,0.017400911
Georgia,LAURENS,44874,28199,15417,529,16675,0.628403976,0.371596024,0.011788564
Georgia,LEE,24757,20203,3823,300,4554,0.816052026,0.183947974,0.012117785
Georgia,LIBERTY,61610,27244,26025,5022,34366,0.442200941,0.557799059,0.081512741
Georgia,LINCOLN,8348,5321,2857,81,3027,0.637398179,0.362601821,0.009702923
Georgia,LONG,10304,6678,2429,870,3626,0.648097826,0.351902174,0.08443323
Georgia,LOWNDES,92115,55992,31128,2447,36123,0.607848885,0.392151115,0.02656462
Georgia,LUMPKIN,21016,19381,306,728,1635,0.922202132,0.077797868,0.034640274
Georgia,MCDUFFIE,21231,12795,7909,284,8436,0.602656493,0.397343507,0.013376666
Georgia,MCINTOSH,10847,6607,3971,99,4240,0.609108509,0.390891491,0.009126948
Georgia,MACON,14074,5184,8337,364,8890,0.368338781,0.631661219,0.025863294
Georgia,MADISON,25730,22713,2165,507,3017,0.882743879,0.117256121,0.019704625
Georgia,MARION,7144,4182,2410,413,2962,0.585386338,0.414613662,0.05781075
Georgia,MERIWETHER,22534,12579,9467,191,9955,0.558223129,0.441776871,0.008476081
Georgia,MILLER,6383,4456,1845,44,1927,0.69810434,0.30189566,0.00689331
Georgia,MITCHELL,23932,11746,11423,491,12186,0.490807287,0.509192713,0.020516463
Georgia,MONROE,21757,15150,6015,281,6607,0.696327619,0.303672381,0.012915384
Georgia,MONTGOMERY,8270,5684,2251,271,2586,0.687303507,0.312696493,0.032769045
Georgia,MORGAN,15457,10619,4385,248,4838,0.687002653,0.312997347,0.016044511
Georgia,MURRAY,36506,33890,191,2006,2616,0.928340547,0.071659453,0.054949871
Georgia,MUSCOGEE,186291,90668,80720,8372,95623,0.486700914,0.513299086,0.044940443
Georgia,NEWTON,62001,46007,13690,1157,15994,0.742036419,0.257963581,0.018660989
Georgia,OCONEE,26225,23112,1653,833,3113,0.881296473,0.118703527,0.031763584
Georgia,OGLETHORPE,12635,9817,2476,174,2818,0.776968738,0.223031262,0.01377127
Georgia,PAULDING,81678,73188,5634,1398,8490,0.896055241,0.103944759,0.017115992
Georgia,PEACH,23668,11654,10682,998,12014,0.492394795,0.507605205,0.042166638
Georgia,PICKENS,22983,21897,292,467,1086,0.952747683,0.047252317,0.020319366
Georgia,PIERCE,15636,13425,1691,357,2211,0.858595549,0.141404451,0.022831926
Georgia,PIKE,13688,11350,2019,167,2338,0.829193454,0.170806546,0.012200468
Georgia,POLK,38127,29684,5073,2921,8443,0.778555879,0.221444121,0.076612374
Georgia,PULASKI,9588,5932,3249,270,3656,0.618690029,0.381309971,0.0281602
Georgia,PUTNAM,18812,12471,5603,407,6341,0.662927918,0.337072082,0.021635127
Georgia,QUITMAN,2598,1351,1213,13,1247,0.520015396,0.479984604,0.005003849
Georgia,RABUN,15050,14023,118,683,1027,0.931760797,0.068239203,0.04538206
Georgia,RANDOLPH,7791,3016,4609,92,4775,0.387113336,0.612886664,0.011808497
Georgia,RICHMOND,199775,88660,98584,5545,111115,0.443799274,0.556200726,0.027756226
Georgia,ROCKDALE,70111,50967,12670,4182,19144,0.726947269,0.273052731,0.059648272
Georgia,SCHLEY,3766,2462,1169,89,1304,0.653744025,0.346255975,0.023632501
Georgia,SCREVEN,15374,8182,6923,147,7192,0.532197216,0.467802784,0.009561598
Georgia,SEMINOLE,9369,5734,3224,347,3635,0.612018358,0.387981642,0.037037037
Georgia,SPALDING,58417,38435,18076,947,19982,0.657942037,0.342057963,0.016211034
Georgia,STEPHENS,25435,21673,3029,250,3762,0.852093572,0.147906428,0.009828976
Georgia,STEWART,5252,1926,3201,79,3326,0.366717441,0.633282559,0.015041889
Georgia,SUMTER,33200,15672,16196,891,17528,0.472048193,0.527951807,0.026837349
Georgia,TALBOT,6498,2354,3974,82,4144,0.362265312,0.637734688,0.012619267
Georgia,TALIAFERRO,2077,787,1251,19,1290,0.378911892,0.621088108,0.009147809
Georgia,TATTNALL,22305,13218,6988,1883,9087,0.592602555,0.407397445,0.084420534
Georgia,TAYLOR,8815,4847,3736,163,3968,0.549858196,0.450141804,0.018491208
Georgia,TELFAIR,11794,6993,4515,215,4801,0.592928608,0.407071392,0.018229608
Georgia,TERRELL,10970,4101,6614,136,6869,0.373837739,0.626162261,0.012397448
Georgia,THOMAS,42737,24875,16497,734,17862,0.582048342,0.417951658,0.017174813
Georgia,TIFT,38407,24092,10695,2944,14315,0.627281485,0.372718515,0.076652694
Georgia,TOOMBS,26067,17226,6237,2310,8841,0.660835539,0.339164461,0.088617793
Georgia,TOWNS,9319,9159,12,67,160,0.982830776,0.017169224,0.007189613
Georgia,TREUTLEN,6854,4463,2253,79,2391,0.651152612,0.348847388,0.011526116
Georgia,TROUP,58779,38261,18650,1004,20518,0.650929754,0.349070246,0.01708093
Georgia,TURNER,9504,5315,3868,244,4189,0.559238215,0.440761785,0.025673401
Georgia,TWIGGS,10590,5784,4589,112,4806,0.546175637,0.453824363,0.010576015
Georgia,UNION,17289,16837,94,153,452,0.973856209,0.026143791,0.008849558
Georgia,UPSON,27597,19271,7675,327,8326,0.69830054,0.30169946,0.011849114
Georgia,WALKER,61053,57336,2300,565,3717,0.939118471,0.060881529,0.009254255
Georgia,WALTON,60687,49731,8703,1163,10956,0.819467102,0.180532898,0.019163907
Georgia,WARE,35483,24434,9907,688,11049,0.688611448,0.311388552,0.019389567
Georgia,WARREN,6336,2483,3755,51,3853,0.391887626,0.608112374,0.008049242
Georgia,WASHINGTON,21176,9620,11233,134,11556,0.454287873,0.545712127,0.006327918
Georgia,WAYNE,26565,19838,5333,1013,6727,0.746772069,0.253227931,0.038132882
Georgia,WEBSTER,2390,1186,1123,66,1204,0.49623431,0.50376569,0.027615063
Georgia,WHEELER,6179,3866,2045,219,2313,0.625667584,0.374332416,0.035442628
Georgia,WHITE,19944,18804,432,311,1140,0.942839952,0.057160048,0.015593662
Georgia,WHITFIELD,83525,60338,3066,18419,23187,0.722394493,0.277605507,0.220520802
Georgia,WILCOX,8577,5299,3091,139,3278,0.617815087,0.382184913,0.016206133
Georgia,WILKES,10687,5758,4591,212,4929,0.53878544,0.46121456,0.019837185
Georgia,WILKINSON,10220,5893,4153,101,4327,0.576614481,0.423385519,0.009882583
Georgia,WORTH,21967,14999,6482,240,6968,0.682796923,0.317203077,0.010925479
Hawaii,HAWAII,148677,44223,602,14111,104454,0.297443451,0.702556549,0.094910443
Hawaii,HONOLULU,876156,175633,19583,58729,700523,0.200458594,0.799541406,0.067030301
Hawaii,KALAWAO,147,33,0,6,114,0.224489796,0.775510204,0.040816327
Hawaii,KAUAI,58463,16284,163,4803,42179,0.278535142,0.721464858,0.082154525
Hawaii,MAUI,128094,40918,481,10050,87176,0.319437288,0.680562712,0.078458007
Idaho,ADA,300904,272569,1829,13467,28335,0.905833754,0.094166246,0.044755138
Idaho,ADAMS,3476,3318,2,54,158,0.954545455,0.045454545,0.015535098
Idaho,BANNOCK,75565,67636,411,3540,7929,0.895070469,0.104929531,0.046847085
Idaho,BEAR LAKE,6411,6195,6,154,216,0.966307908,0.033692092,0.024021214
Idaho,BENEWAH,9171,8055,11,142,1116,0.878312071,0.121687929,0.01548359
Idaho,BINGHAM,41735,32824,52,5550,8911,0.786486163,0.213513837,0.13298191
Idaho,BLAINE,18991,16531,12,2030,2460,0.870464957,0.129535043,0.106892739
Idaho,BOISE,6670,6222,7,228,448,0.932833583,0.067166417,0.034182909
Idaho,BONNER,36835,35206,38,604,1629,0.955775757,0.044224243,0.016397448
Idaho,BONNEVILLE,82522,74461,360,5703,8061,0.902316958,0.097683042,0.069108844
Idaho,BOUNDARY,9871,9198,9,335,673,0.931820484,0.068179516,0.033937798
Idaho,BUTTE,2899,2706,8,120,193,0.933425319,0.066574681,0.041393584
Idaho,CAMAS,991,910,1,55,81,0.918264379,0.081735621,0.055499495
Idaho,CANYON,131441,102428,337,24455,29013,0.779269786,0.220730214,0.186053058
Idaho,CARIBOU,7304,6929,3,289,375,0.948658269,0.051341731,0.03956736
Idaho,CASSIA,21416,16982,16,4013,4434,0.792958536,0.207041464,0.187383265
Idaho,CLARK,1022,653,1,350,369,0.638943249,0.361056751,0.342465753
Idaho,CLEARWATER,8930,8378,13,165,552,0.93818589,0.06181411,0.018477044
Idaho,CUSTER,4342,4100,0,183,242,0.944265316,0.055734684,0.042146476
Idaho,ELMORE,29130,23218,914,3492,5912,0.797047717,0.202952283,0.119876416
Idaho,FRANKLIN,11329,10619,10,591,710,0.937328979,0.062671021,0.052167005
Idaho,FREMONT,11819,10320,15,1255,1499,0.873170319,0.126829681,0.106184956
Idaho,GEM,15181,13762,11,1050,1419,0.906527897,0.093472103,0.069165404
Idaho,GOODING,14155,11373,8,2414,2782,0.803461674,0.196538326,0.170540445
Idaho,IDAHO,15511,14491,12,243,1020,0.934240217,0.065759783,0.015666301
Idaho,JEFFERSON,19155,16955,21,1907,2200,0.885147481,0.114852519,0.099556252
Idaho,JEROME,18342,14791,21,3150,3551,0.806400611,0.193599389,0.171736997
Idaho,KOOTENAI,108685,102570,176,2528,6115,0.943736486,0.056263514,0.023259879
Idaho,LATAH,34935,32433,199,740,2502,0.92838128,0.07161872,0.021182196
Idaho,LEMHI,7806,7452,8,170,354,0.954650269,0.045349731,0.021778119
Idaho,LEWIS,3747,3427,13,71,320,0.914598345,0.085401655,0.018948492
Idaho,LINCOLN,4044,3375,4,542,669,0.834569733,0.165430267,0.134025717
Idaho,MADISON,27467,25856,56,1078,1611,0.941347799,0.058652201,0.039247097
Idaho,MINIDOKA,20174,14552,38,5137,5622,0.721324477,0.278675523,0.254634678
Idaho,NEZ PERCE,37410,33880,101,721,3530,0.905640203,0.094359797,0.019272922
Idaho,ONEIDA,4125,3986,5,95,139,0.96630303,0.03369697,0.023030303
Idaho,OWYHEE,10644,7635,7,2459,3009,0.717305524,0.282694476,0.231022172
Idaho,PAYETTE,20578,17434,19,2453,3144,0.847215473,0.152784527,0.119204976
Idaho,POWER,7538,5592,5,1638,1946,0.741841337,0.258158663,0.217299018
Idaho,SHOSHONE,13771,13047,15,266,724,0.94742575,0.05257425,0.019315954
Idaho,TETON,5999,5210,6,705,789,0.86847808,0.13152192,0.117519587
Idaho,TWIN FALLS,64284,56390,97,6026,7894,0.87720117,0.12279883,0.093740278
Idaho,VALLEY,7651,7328,2,150,323,0.957783296,0.042216704,0.01960528
Idaho,WASHINGTON,9977,8294,10,1372,1683,0.831312018,0.168687982,0.137516287
Illinois,ADAMS,68277,64611,2077,567,3666,0.946306955,0.053693045,0.008304407
Illinois,ALEXANDER,9590,5968,3338,138,3622,0.622314911,0.377685089,0.01438999
Illinois,BOND,17633,15841,1297,253,1792,0.89837237,0.10162763,0.014348097
Illinois,BOONE,41786,35536,352,5219,6250,0.850428373,0.149571627,0.124898291
Illinois,BROWN,6950,5368,1257,273,1582,0.772374101,0.227625899,0.039280576
Illinois,BUREAU,35503,33196,110,1732,2307,0.935019576,0.064980424,0.04878461
Illinois,CALHOUN,5084,5001,0,32,83,0.983674272,0.016325728,0.006294256
Illinois,CARROLL,16674,15988,90,340,686,0.958858102,0.041141898,0.020391028
Illinois,CASS,13695,12346,39,1162,1349,0.901496897,0.098503103,0.084848485
Illinois,CHAMPAIGN,179669,139143,19881,5203,40526,0.774440777,0.225559223,0.028958808
Illinois,CHRISTIAN,35372,33921,754,345,1451,0.958978853,0.041021147,0.009753477
Illinois,CLARK,17008,16766,33,54,242,0.985771402,0.014228598,0.003174976
Illinois,CLAY,14560,14297,16,88,263,0.981936813,0.018063187,0.006043956
Illinois,CLINTON,35535,33220,1389,570,2315,0.934852962,0.065147038,0.016040523
Illinois,COLES,53196,50298,1208,737,2898,0.94552222,0.05447778,0.013854425
Illinois,COOK,5376741,2558709,1390448,1071740,2818032,0.475884741,0.524115259,0.199328924
Illinois,CRAWFORD,20452,18925,920,351,1527,0.925337375,0.074662625,0.017162136
Illinois,CUMBERLAND,11253,11086,11,68,167,0.985159513,0.014840487,0.006042833
Illinois,DEKALB,88969,75772,4040,5830,13197,0.851667435,0.148332565,0.065528442
Illinois,DE WITT,16798,16303,81,213,495,0.970532206,0.029467794,0.012680081
Illinois,DOUGLAS,19922,18993,59,690,929,0.953368136,0.046631864,0.034635077
Illinois,DUPAGE,904161,711966,26977,81366,192195,0.787432769,0.212567231,0.08999061
Illinois,EDGAR,19704,19052,362,154,652,0.966910272,0.033089728,0.007815672
Illinois,EDWARDS,6971,6869,10,32,102,0.985367953,0.014632047,0.004590446
Illinois,EFFINGHAM,34264,33658,55,252,606,0.982313799,0.017686201,0.007354658
Illinois,FAYETTE,21802,20386,1064,174,1416,0.93505183,0.06494817,0.007980919
Illinois,FORD,14241,13885,35,176,356,0.975001755,0.024998245,0.012358683
Illinois,FRANKLIN,39018,38323,57,249,695,0.982187708,0.017812292,0.00638167
Illinois,FULTON,38250,36068,1369,478,2182,0.942954248,0.057045752,0.012496732
Illinois,GALLATIN,6445,6308,16,56,137,0.978743212,0.021256788,0.008688906
Illinois,GREENE,14761,14442,109,77,319,0.978388998,0.021611002,0.005216449
Illinois,GRUNDY,37535,35502,67,1552,2033,0.945837219,0.054162781,0.041348075
Illinois,HAMILTON,8621,8434,57,55,187,0.978308781,0.021691219,0.00637977
Illinois,HANCOCK,20121,19780,38,105,341,0.983052532,0.016947468,0.005218429
Illinois,HARDIN,4800,4554,132,51,246,0.94875,0.05125,0.010625
Illinois,HENDERSON,8213,8041,21,72,172,0.979057592,0.020942408,0.00876659
Illinois,HENRY,51020,48425,569,1467,2595,0.949137593,0.050862407,0.02875343
Illinois,IROQUOIS,31334,29580,222,1217,1754,0.944022468,0.055977532,0.038839599
Illinois,JACKSON,59612,47445,7694,1443,12167,0.795896799,0.204103201,0.024206536
Illinois,JASPER,10117,10003,8,48,114,0.988731838,0.011268162,0.004744489
Illinois,JEFFERSON,40045,35709,3093,531,4336,0.891721813,0.108278187,0.013260082
Illinois,JERSEY,21668,21148,113,162,520,0.976001477,0.023998523,0.007476463
Illinois,JO DAVIESS,22289,21733,41,342,556,0.97505496,0.02494504,0.015343892
Illinois,JOHNSON,12878,10553,1821,368,2325,0.819459543,0.180540457,0.028575866
Illinois,KANE,404119,273390,22477,95924,130729,0.676508652,0.323491348,0.237365726
Illinois,KANKAKEE,103833,80829,15942,4959,23004,0.778451937,0.221548063,0.047759383
Illinois,KENDALL,54544,48677,693,4086,5867,0.892435465,0.107564535,0.074911998
Illinois,KNOX,55836,49355,3472,1896,6481,0.883927932,0.116072068,0.033956587
Illinois,LAKE,644356,472968,43580,92716,171388,0.7340166,0.2659834,0.143889403
Illinois,LA SALLE,111509,102444,1687,5791,9065,0.918706113,0.081293887,0.051933028
Illinois,LAWRENCE,15452,15053,118,137,399,0.9741781,0.0258219,0.008866166
Illinois,LEE,36062,32643,1753,1147,3419,0.90519106,0.09480894,0.031806334
Illinois,LIVINGSTON,39678,36145,2032,1056,3533,0.910958214,0.089041786,0.026614245
Illinois,LOGAN,31183,28247,2037,503,2936,0.905846134,0.094153866,0.016130584
Illinois,MCDONOUGH,32913,30284,1126,488,2629,0.920122748,0.079877252,0.014826968
Illinois,MCHENRY,260077,233026,1379,19602,27051,0.895988496,0.104011504,0.075369987
Illinois,MCLEAN,150433,132224,9189,3833,18209,0.87895608,0.12104392,0.025479782
Illinois,MACON,114706,95128,16036,1120,19578,0.829320175,0.170679825,0.009764093
Illinois,MACOUPIN,49019,47828,396,305,1191,0.975703299,0.024296701,0.006222077
Illinois,MADISON,258941,231313,18825,3925,27628,0.89330388,0.10669612,0.015157893
Illinois,MARION,41691,38951,1593,378,2740,0.934278381,0.065721619,0.009066705
Illinois,MARSHALL,13180,12860,45,138,320,0.975720789,0.024279211,0.01047041
Illinois,MASON,16038,15799,19,80,239,0.985097893,0.014902107,0.004988153
Illinois,MASSAC,15161,13962,826,123,1199,0.920915507,0.079084493,0.008112921
Illinois,MENARD,12486,12240,48,94,246,0.980297934,0.019702066,0.007528432
Illinois,MERCER,16957,16551,48,216,406,0.976057086,0.023942914,0.012738102
Illinois,MONROE,27619,27156,11,203,463,0.983236178,0.016763822,0.007350013
Illinois,MONTGOMERY,30652,28928,1141,326,1724,0.943755709,0.056244291,0.010635521
Illinois,MORGAN,36616,33589,1950,496,3027,0.917331221,0.082668779,0.013545991
Illinois,MOULTRIE,14287,14078,28,68,209,0.985371317,0.014628683,0.004759572
Illinois,OGLE,51032,47057,204,3066,3975,0.922107697,0.077892303,0.06007995
Illinois,PEORIA,183433,143932,29320,3827,39501,0.784657068,0.215342932,0.020863203
Illinois,PERRY,23094,20563,1849,406,2531,0.890404434,0.109595566,0.017580324
Illinois,PIATT,16365,16090,39,101,275,0.983195845,0.016804155,0.006171708
Illinois,PIKE,17384,16868,260,87,516,0.970317533,0.029682467,0.005004602
Illinois,POPE,4413,4104,158,40,309,0.929979606,0.070020394,0.009064129
Illinois,PULASKI,7348,4841,2249,107,2507,0.658818726,0.341181274,0.014561786
Illinois,PUTNAM,6086,5817,37,171,269,0.955800197,0.044199803,0.028097272
Illinois,RANDOLPH,33893,29860,3132,521,4033,0.881007878,0.118992122,0.015371906
Illinois,RICHLAND,16149,15772,42,124,377,0.976654901,0.023345099,0.007678494
Illinois,ROCK ISLAND,149374,121705,11099,12791,27669,0.814766961,0.185233039,0.085630699
Illinois,ST. CLAIR,256082,171151,73282,5604,84931,0.668344515,0.331655485,0.021883615
Illinois,SALINE,26733,25035,1079,258,1698,0.936482999,0.063517001,0.009650993
Illinois,SANGAMON,188951,163967,18134,2000,24984,0.867775243,0.132224757,0.010584755
Illinois,SCHUYLER,7189,7090,16,39,99,0.986228961,0.013771039,0.005424955
Illinois,SCOTT,5537,5497,2,10,40,0.992775871,0.007224129,0.001806032
Illinois,SHELBY,22893,22581,35,110,312,0.98637138,0.01362862,0.004804962
Illinois,STARK,6332,6213,4,54,119,0.98120657,0.01879343,0.008528111
Illinois,STEPHENSON,48979,43404,3732,747,5575,0.886175708,0.113824292,0.015251434
Illinois,TAZEWELL,128485,124270,1115,1331,4215,0.967194614,0.032805386,0.010359186
Illinois,UNION,18293,17407,149,481,886,0.951566173,0.048433827,0.026294211
Illinois,VERMILION,83919,71038,8802,2504,12881,0.846506751,0.153493249,0.029838296
Illinois,WABASH,12937,12602,51,95,335,0.974105279,0.025894721,0.007343279
Illinois,WARREN,18735,17672,296,507,1063,0.943261276,0.056738724,0.027061649
Illinois,WASHINGTON,15148,14846,49,108,302,0.980063375,0.019936625,0.007129654
Illinois,WAYNE,17151,16853,19,103,298,0.98262492,0.01737508,0.006005481
Illinois,WHITE,15371,15033,40,103,338,0.978010539,0.021989461,0.00670093
Illinois,WHITESIDE,60653,53946,577,5347,6707,0.889420144,0.110579856,0.088157222
Illinois,WILL,502266,388523,51980,43768,113743,0.773540315,0.226459685,0.087141077
Illinois,WILLIAMSON,61296,58006,1498,763,3290,0.946326025,0.053673975,0.012447794
Illinois,WINNEBAGO,278418,220817,29038,19206,57601,0.793113233,0.206886767,0.068982609
Illinois,WOODFORD,35469,34760,84,241,709,0.980010714,0.019989286,0.006794666
Indiana,ADAMS,33625,32203,43,1118,1422,0.957710037,0.042289963,0.033249071
Indiana,ALLEN,331849,269732,37149,13877,62117,0.812815467,0.187184533,0.041817212
Indiana,BARTHOLOMEW,71435,66422,1281,1598,5013,0.929824316,0.070175684,0.022369987
Indiana,BENTON,9421,9040,18,245,381,0.959558433,0.040441567,0.026005732
Indiana,BLACKFORD,14048,13773,16,83,275,0.98042426,0.01957574,0.005908314
Indiana,BOONE,46107,44847,157,534,1260,0.972672262,0.027327738,0.011581755
Indiana,BROWN,14957,14609,32,131,348,0.976733302,0.023266698,0.008758441
Indiana,CARROLL,20165,19413,36,591,752,0.962707662,0.037292338,0.029308207
Indiana,CASS,40930,36921,499,2905,4009,0.902052284,0.097947716,0.070974835
Indiana,CLARK,96472,86194,6345,1799,10278,0.893461315,0.106538685,0.018647898
Indiana,CLAY,26556,26038,86,155,518,0.98049405,0.01950595,0.005836722
Indiana,CLINTON,33866,31052,67,2478,2814,0.916907813,0.083092187,0.073170732
Indiana,CRAWFORD,10743,10519,16,100,224,0.979149213,0.020850787,0.009308387
Indiana,DAVIESS,29820,28815,123,620,1005,0.966297787,0.033702213,0.020791415
Indiana,DEARBORN,46109,45048,285,266,1061,0.976989308,0.023010692,0.005768939
Indiana,DECATUR,24555,24092,12,132,463,0.98114437,0.01885563,0.005375687
Indiana,DEKALB,40285,39009,101,676,1276,0.96832568,0.03167432,0.016780439
Indiana,DELAWARE,118769,107068,7906,1304,11701,0.901481026,0.098518974,0.010979296
Indiana,DUBOIS,39674,38266,53,1103,1408,0.964510763,0.035489237,0.027801583
Indiana,ELKHART,182791,152421,9390,16300,30370,0.833853964,0.166146036,0.089172881
Indiana,FAYETTE,25588,24773,428,132,815,0.968149132,0.031850868,0.005158668
Indiana,FLOYD,70823,65652,3099,772,5171,0.926986996,0.073013004,0.010900414
Indiana,FOUNTAIN,17954,17599,19,190,355,0.980227247,0.019772753,0.0105826
Indiana,FRANKLIN,22151,21862,7,104,289,0.986953185,0.013046815,0.004695048
Indiana,FULTON,20511,19503,154,473,1008,0.950855638,0.049144362,0.023060797
Indiana,GIBSON,32500,31208,621,229,1292,0.960246154,0.039753846,0.007046154
Indiana,GRANT,73403,64607,5229,1787,8796,0.880168385,0.119831615,0.024345054
Indiana,GREENE,33157,32515,25,268,642,0.980637573,0.019362427,0.008082758
Indiana,HAMILTON,182740,170674,2775,2911,12066,0.933971763,0.066028237,0.015929736
Indiana,HANCOCK,55391,54155,74,526,1236,0.977685906,0.022314094,0.009496128
Indiana,HARRISON,34325,33518,123,331,807,0.976489439,0.023510561,0.009643117
Indiana,HENDRICKS,104093,99978,1143,1162,4115,0.960468043,0.039531957,0.011163095
Indiana,HENRY,48508,47274,412,387,1234,0.974560897,0.025439103,0.007978065
Indiana,HOWARD,84964,75378,5523,1709,9586,0.887175745,0.112824255,0.020114401
Indiana,HUNTINGTON,38075,37156,65,363,919,0.975863427,0.024136573,0.009533815
Indiana,JACKSON,41335,39323,217,1112,2012,0.951324543,0.048675457,0.026902141
Indiana,JASPER,30043,28941,102,733,1102,0.963319242,0.036680758,0.024398362
Indiana,JAY,21806,21131,54,390,675,0.969045217,0.030954783,0.017884986
Indiana,JEFFERSON,31705,30321,453,332,1384,0.956347579,0.043652421,0.010471534
Indiana,JENNINGS,27554,26745,205,193,809,0.970639472,0.029360528,0.007004428
Indiana,JOHNSON,115209,110839,900,1591,4370,0.962068936,0.037931064,0.013809685
Indiana,KNOX,39256,37667,726,322,1589,0.959522111,0.040477889,0.008202568
Indiana,KOSCIUSKO,74057,68816,428,3722,5241,0.929230188,0.070769812,0.050258585
Indiana,LAGRANGE,34909,33405,61,1097,1504,0.956916554,0.043083446,0.031424561
Indiana,LAKE,484564,293457,121372,59128,191107,0.605610404,0.394389596,0.122023097
Indiana,LAPORTE,110106,93330,11052,3402,16776,0.847637731,0.152362269,0.030897499
Indiana,LAWRENCE,45922,44711,177,416,1211,0.973629197,0.026370803,0.009058839
Indiana,MADISON,133358,118874,10437,1993,14484,0.891390093,0.108609907,0.014944735
Indiana,MARION,860454,592540,206716,33290,267914,0.688636464,0.311363536,0.038688878
Indiana,MARSHALL,45128,41761,114,2664,3367,0.925390002,0.074609998,0.059032087
Indiana,MARTIN,10369,10225,16,42,144,0.986112451,0.013887549,0.004050535
Indiana,MIAMI,36082,33560,1066,478,2522,0.930103653,0.069896347,0.013247603
Indiana,MONROE,120563,108314,3567,2235,12249,0.898401666,0.101598334,0.018538026
Indiana,MONTGOMERY,37629,36223,281,611,1406,0.962635202,0.037364798,0.016237476
Indiana,MORGAN,66689,65398,50,490,1291,0.980641485,0.019358515,0.007347539
Indiana,NEWTON,14566,13947,24,422,619,0.957503776,0.042496224,0.028971578
Indiana,NOBLE,46275,42221,172,3299,4054,0.912393301,0.087606699,0.071291194
Indiana,OHIO,5623,5531,27,25,92,0.983638627,0.016361373,0.004446025
Indiana,ORANGE,19306,18833,113,108,473,0.975499845,0.024500155,0.005594116
Indiana,OWEN,21786,21291,52,164,495,0.977278987,0.022721013,0.00752777
Indiana,PARKE,17241,16560,368,104,681,0.960501131,0.039498869,0.006032133
Indiana,PERRY,18899,18345,272,133,554,0.97068628,0.02931372,0.007037409
Indiana,PIKE,12837,12666,11,74,171,0.986679131,0.013320869,0.005764587
Indiana,PORTER,146798,135334,1314,7079,11464,0.921906293,0.078093707,0.048222728
Indiana,POSEY,27061,26443,231,118,618,0.977162706,0.022837294,0.004360519
Indiana,PULASKI,13755,13294,126,191,461,0.966484915,0.033515085,0.01388586
Indiana,PUTNAM,36019,33972,1044,412,2047,0.943168883,0.056831117,0.011438408
Indiana,RANDOLPH,27401,26716,64,333,685,0.975000912,0.024999088,0.012152841
Indiana,RIPLEY,26523,25971,13,247,552,0.979187875,0.020812125,0.009312672
Indiana,RUSH,18261,17794,108,92,467,0.974426373,0.025573627,0.005038059
Indiana,ST. JOSEPH,265559,213890,30105,12557,51669,0.805433068,0.194566932,0.047285161
Indiana,SCOTT,22960,22538,10,222,422,0.981620209,0.018379791,0.00966899
Indiana,SHELBY,43445,42006,325,497,1439,0.966877661,0.033122339,0.011439751
Indiana,SPENCER,20391,19793,110,303,598,0.970673336,0.029326664,0.014859497
Indiana,STARKE,23556,22685,51,514,871,0.963024283,0.036975717,0.021820343
Indiana,STEUBEN,33214,31931,119,683,1283,0.961371711,0.038628289,0.020563618
Indiana,SULLIVAN,21751,20380,928,179,1371,0.936968415,0.063031585,0.008229507
Indiana,SWITZERLAND,9065,8908,21,78,157,0.98268064,0.01731936,0.008604523
Indiana,TIPPECANOE,148955,128653,3698,7834,20302,0.863703803,0.136296197,0.052593065
Indiana,TIPTON,16577,16188,22,201,389,0.976533752,0.023466248,0.012125234
Indiana,UNION,7349,7237,17,22,112,0.984759831,0.015240169,0.002993605
Indiana,VANDERBURGH,171922,152547,14008,1679,19375,0.887303545,0.112696455,0.009766057
Indiana,VERMILLION,16788,16454,44,107,334,0.980104837,0.019895163,0.0063736
Indiana,VIGO,105848,95184,6334,1275,10664,0.899251757,0.100748243,0.012045575
Indiana,WABASH,34960,33803,139,414,1157,0.966905034,0.033094966,0.011842105
Indiana,WARREN,8419,8318,7,37,101,0.988003326,0.011996674,0.004394821
Indiana,WARRICK,52383,50805,516,340,1578,0.969875723,0.030124277,0.006490655
Indiana,WASHINGTON,27223,26749,36,200,474,0.982588253,0.017411747,0.007346729
Indiana,WAYNE,71097,64967,3594,971,6130,0.913779766,0.086220234,0.013657398
Indiana,WELLS,27600,26884,41,397,716,0.974057971,0.025942029,0.014384058
Indiana,WHITE,25267,23580,35,1349,1687,0.933233071,0.066766929,0.053389797
Indiana,WHITLEY,30707,30040,57,276,667,0.978278568,0.021721432,0.008988179
Iowa,ADAIR,8243,8115,6,58,128,0.984471673,0.015528327,0.007036273
Iowa,ADAMS,4482,4414,2,26,68,0.984828202,0.015171798,0.005800982
Iowa,ALLAMAKEE,14675,13983,21,520,692,0.952844974,0.047155026,0.035434412
Iowa,APPANOOSE,13721,13382,58,135,339,0.975293346,0.024706654,0.009838933
Iowa,AUDUBON,6830,6743,9,33,87,0.987262079,0.012737921,0.004831625
Iowa,BENTON,25308,24894,50,156,414,0.983641536,0.016358464,0.006164059
Iowa,BLACK HAWK,128012,112223,10108,2359,15789,0.876660001,0.123339999,0.01842796
Iowa,BOONE,26224,25729,79,218,495,0.981124161,0.018875839,0.008312996
Iowa,BREMER,23325,22836,110,130,489,0.97903537,0.02096463,0.005573419
Iowa,BUCHANAN,21093,20667,54,131,426,0.979803726,0.020196274,0.006210591
Iowa,BUENA VISTA,20411,16758,61,2560,3653,0.821027877,0.178972123,0.125422566
Iowa,BUTLER,15305,15086,13,89,219,0.985690951,0.014309049,0.005815093
Iowa,CALHOUN,11115,10849,76,100,266,0.976068376,0.023931624,0.008996851
Iowa,CARROLL,21421,21119,35,115,302,0.985901685,0.014098315,0.005368564
Iowa,CASS,14684,14457,31,101,227,0.984540997,0.015459003,0.006878235
Iowa,CEDAR,18187,17804,34,171,383,0.978941002,0.021058998,0.00940232
Iowa,CERRO GORDO,46447,43977,358,1291,2470,0.946821108,0.053178892,0.027795121
Iowa,CHEROKEE,13035,12749,41,124,286,0.978059072,0.021940928,0.00951285
Iowa,CHICKASAW,13095,12902,7,82,193,0.98526155,0.01473845,0.006261932
Iowa,CLARKE,9133,8648,10,369,485,0.946895872,0.053104128,0.040402934
Iowa,CLAY,17372,16902,30,196,470,0.972944969,0.027055031,0.011282524
Iowa,CLAYTON,18678,18386,25,142,292,0.984366635,0.015633365,0.007602527
Iowa,CLINTON,50149,47722,930,627,2427,0.951604219,0.048395781,0.012502742
Iowa,CRAWFORD,16942,15149,117,1482,1793,0.894168339,0.105831661,0.087474914
Iowa,DALLAS,40750,37658,281,2199,3092,0.924122699,0.075877301,0.05396319
Iowa,DAVIS,8541,8371,13,61,170,0.980096007,0.019903993,0.007142021
Iowa,DECATUR,8689,8296,79,148,393,0.954770399,0.045229601,0.01703303
Iowa,DELAWARE,18404,18179,12,121,225,0.987774397,0.012225603,0.006574658
Iowa,DES MOINES,42351,39308,1488,740,3043,0.928148096,0.071851904,0.017473023
Iowa,DICKINSON,16424,16164,20,109,260,0.984169508,0.015830492,0.006636629
Iowa,DUBUQUE,89143,86020,736,1065,3123,0.964966402,0.035033598,0.011947096
Iowa,EMMET,11027,10424,26,475,603,0.945316042,0.054683958,0.043076086
Iowa,FAYETTE,22008,21327,111,330,681,0.969056707,0.030943293,0.014994547
Iowa,FLOYD,16900,16466,37,222,434,0.974319527,0.025680473,0.013136095
Iowa,FRANKLIN,10704,10000,9,642,704,0.934230194,0.065769806,0.059977578
Iowa,FREMONT,8010,7758,3,174,252,0.968539326,0.031460674,0.021722846
Iowa,GREENE,10366,10094,13,172,272,0.97376037,0.02623963,0.016592707
Iowa,GRUNDY,12369,12197,10,72,172,0.986094268,0.013905732,0.005821004
Iowa,GUTHRIE,11353,11129,14,120,224,0.980269532,0.019730468,0.010569893
Iowa,HAMILTON,16438,15792,38,234,646,0.960700815,0.039299185,0.014235308
Iowa,HANCOCK,12100,11696,7,301,404,0.96661157,0.03338843,0.024876033
Iowa,HARDIN,18812,18081,111,455,731,0.961141824,0.038858176,0.024186689
Iowa,HARRISON,15666,15384,13,113,282,0.981999234,0.018000766,0.007213073
Iowa,HENRY,20336,19154,295,256,1182,0.941876475,0.058123525,0.012588513
Iowa,HOWARD,9932,9797,11,55,135,0.986407571,0.013592429,0.005537656
Iowa,HUMBOLDT,10381,10188,7,100,193,0.981408342,0.018591658,0.009632983
Iowa,IDA,7837,7737,8,37,100,0.987240015,0.012759985,0.004721194
Iowa,IOWA,15671,15390,25,152,281,0.982068789,0.017931211,0.009699445
Iowa,JACKSON,20296,20000,19,121,296,0.985415845,0.014584155,0.005961766
Iowa,JASPER,37213,36072,309,375,1141,0.969338672,0.030661328,0.010077124
Iowa,JEFFERSON,16181,15329,102,297,852,0.947345652,0.052654348,0.018354861
Iowa,JOHNSON,111006,98619,3148,2781,12387,0.888411437,0.111588563,0.0250527
Iowa,JONES,20221,19414,356,213,807,0.960090995,0.039909005,0.010533604
Iowa,KEOKUK,11400,11260,8,61,140,0.987719298,0.012280702,0.005350877
Iowa,KOSSUTH,17163,16867,19,139,296,0.982753598,0.017246402,0.008098817
Iowa,LEE,38052,35401,1050,902,2651,0.930332177,0.069667823,0.023704404
Iowa,LINN,191701,178449,4857,2722,13252,0.930871513,0.069128487,0.014199196
Iowa,LOUISA,12183,10529,26,1537,1654,0.864237052,0.135762948,0.126159402
Iowa,LUCAS,9422,9238,12,82,184,0.980471238,0.019528762,0.008703035
Iowa,LYON,11763,11637,11,42,126,0.989288447,0.010711553,0.003570518
Iowa,MADISON,14019,13763,12,105,256,0.981739068,0.018260932,0.007489835
Iowa,MAHASKA,22335,21609,140,190,726,0.967494963,0.032505037,0.008506828
Iowa,MARION,32052,31074,129,257,978,0.969487083,0.030512917,0.00801822
Iowa,MARSHALL,39311,34640,348,3523,4671,0.881178296,0.118821704,0.089618682
Iowa,MILLS,14547,14134,41,179,413,0.971609267,0.028390733,0.012304943
Iowa,MITCHELL,10874,10752,19,63,122,0.988780578,0.011219422,0.005793636
Iowa,MONONA,10020,9811,8,70,209,0.979141717,0.020858283,0.006986028
Iowa,MONROE,8016,7864,16,40,152,0.981037924,0.018962076,0.00499002
Iowa,MONTGOMERY,11771,11489,9,153,282,0.976042817,0.023957183,0.012998046
Iowa,MUSCATINE,41722,35746,271,4973,5976,0.856766214,0.143233786,0.119193711
Iowa,O'BRIEN,15102,14623,46,267,479,0.968282347,0.031717653,0.017679778
Iowa,OSCEOLA,7003,6812,8,125,191,0.972725975,0.027274025,0.017849493
Iowa,PAGE,16976,16153,277,265,823,0.951519793,0.048480207,0.015610273
Iowa,PALO ALTO,10147,9956,9,77,191,0.981176702,0.018823298,0.00758845
Iowa,PLYMOUTH,24849,24215,67,328,634,0.974485895,0.025514105,0.013199726
Iowa,POCAHONTAS,8662,8490,21,77,172,0.980143154,0.019856846,0.008889402
Iowa,POLK,374601,323785,17874,16490,50816,0.864346331,0.135653669,0.044020171
Iowa,POTTAWATTAMIE,87704,82667,658,2892,5037,0.942568184,0.057431816,0.032974551
Iowa,POWESHIEK,18815,18096,101,226,719,0.961785809,0.038214191,0.012011693
Iowa,RINGGOLD,5469,5406,6,13,63,0.988480527,0.011519473,0.002377034
Iowa,SAC,11529,11300,29,111,229,0.980137046,0.019862954,0.009627895
Iowa,SCOTT,158668,137382,9498,6445,21286,0.865845665,0.134154335,0.040619407
Iowa,SHELBY,13173,12938,13,88,235,0.98216048,0.01783952,0.006680331
Iowa,SIOUX,31589,30374,57,808,1215,0.961537244,0.038462756,0.025578524
Iowa,STORY,79981,72221,1441,1238,7760,0.902976957,0.097023043,0.015478676
Iowa,TAMA,18103,16140,44,679,1963,0.891564934,0.108435066,0.037507595
Iowa,TAYLOR,6958,6633,2,265,325,0.953291176,0.046708824,0.038085657
Iowa,UNION,12309,12044,28,125,265,0.978471037,0.021528963,0.010155171
Iowa,VAN BUREN,7809,7659,5,60,150,0.980791395,0.019208605,0.007683442
Iowa,WAPELLO,36051,34339,329,799,1712,0.95251172,0.04748828,0.022163047
Iowa,WARREN,40671,39635,106,441,1036,0.974527304,0.025472696,0.010843107
Iowa,WASHINGTON,20670,19838,58,564,832,0.959748428,0.040251572,0.027285922
Iowa,WAYNE,6730,6614,4,48,116,0.982763744,0.017236256,0.007132244
Iowa,WEBSTER,40235,37166,1339,944,3069,0.923723127,0.076276873,0.02346216
Iowa,WINNEBAGO,11723,11297,21,237,426,0.963661179,0.036338821,0.020216668
Iowa,WINNESHIEK,21310,20757,108,170,553,0.974049742,0.025950258,0.007977475
Iowa,WOODBURY,103877,86821,2013,9468,17056,0.835805809,0.164194191,0.09114626
Iowa,WORTH,7909,7693,21,124,216,0.972689341,0.027310659,0.015678341
Iowa,WRIGHT,14334,13489,19,706,845,0.941049254,0.058950746,0.049253523
Kansas,ALLEN,14385,13516,233,278,869,0.939589851,0.060410149,0.019325686
Kansas,ANDERSON,8110,7857,25,88,253,0.968803946,0.031196054,0.010850801
Kansas,ATCHISON,16774,15170,883,327,1604,0.90437582,0.09562418,0.019494456
Kansas,BARBER,5307,5105,16,107,202,0.961937064,0.038062936,0.02016205
Kansas,BARTON,28205,25094,304,2344,3111,0.889700408,0.110299592,0.083105832
Kansas,BOURBON,15379,14345,466,199,1034,0.932765459,0.067234541,0.012939723
Kansas,BROWN,10724,9230,161,249,1494,0.860686311,0.139313689,0.023218948
Kansas,BUTLER,59482,55655,810,1336,3827,0.935661208,0.064338792,0.022460576
Kansas,CHASE,3030,2910,28,53,120,0.96039604,0.03960396,0.017491749
Kansas,CHAUTAUQUA,4359,4054,13,59,305,0.930029823,0.069970177,0.013535214
Kansas,CHEROKEE,22605,20700,137,291,1905,0.915726609,0.084273391,0.012873258
Kansas,CHEYENNE,3165,3052,1,82,113,0.964296998,0.035703002,0.025908373
Kansas,CLARK,2390,2248,5,96,142,0.940585774,0.059414226,0.040167364
Kansas,CLAY,8822,8577,50,73,245,0.97222852,0.02777148,0.008274768
Kansas,CLOUD,10268,10058,34,62,210,0.979548111,0.020451889,0.006038177
Kansas,COFFEY,8865,8535,21,137,330,0.962774958,0.037225042,0.015454033
Kansas,COMANCHE,1967,1906,1,35,61,0.968988307,0.031011693,0.017793594
Kansas,COWLEY,36291,32091,971,1304,4200,0.884268827,0.115731173,0.035931774
Kansas,CRAWFORD,38242,35282,671,910,2960,0.92259819,0.07740181,0.023795827
Kansas,DECATUR,3472,3385,17,34,87,0.974942396,0.025057604,0.009792627
Kansas,DICKINSON,19344,18406,101,445,938,0.951509512,0.048490488,0.023004549
Kansas,DONIPHAN,8249,7775,164,96,474,0.94253849,0.05746151,0.011637774
Kansas,DOUGLAS,99962,84543,4148,3268,15419,0.845751386,0.154248614,0.032692423
Kansas,EDWARDS,3449,3068,9,335,381,0.889533198,0.110466802,0.097129603
Kansas,ELK,3261,3081,7,71,180,0.944802208,0.055197792,0.021772462
Kansas,ELLIS,27507,26160,173,652,1347,0.951030647,0.048969353,0.023703057
Kansas,ELLSWORTH,6525,5954,227,234,571,0.912490421,0.087509579,0.035862069
Kansas,FINNEY,40523,20820,397,17548,19703,0.513782296,0.486217704,0.433038028
Kansas,FORD,32458,18607,469,12231,13851,0.57326391,0.42673609,0.376825436
Kansas,FRANKLIN,24784,23193,287,650,1591,0.935805358,0.064194642,0.026226598
Kansas,GEARY,27947,17187,6007,2362,10760,0.614985508,0.385014492,0.084517122
Kansas,GOVE,3068,2989,3,38,79,0.974250326,0.025749674,0.012385919
Kansas,GRAHAM,2946,2790,95,23,156,0.947046843,0.052953157,0.007807196
Kansas,GRANT,7909,5024,9,2742,2885,0.635225692,0.364774308,0.34669364
Kansas,GRAY,5904,5231,10,579,673,0.886009485,0.113990515,0.098069106
Kansas,GREELEY,1534,1338,2,177,196,0.872229465,0.127770535,0.115384615
Kansas,GREENWOOD,7673,7352,11,132,321,0.958164994,0.041835006,0.01720318
Kansas,HAMILTON,2670,2059,13,550,611,0.771161049,0.228838951,0.205992509
Kansas,HARPER,6536,6322,15,70,214,0.967258262,0.032741738,0.010709914
Kansas,HARVEY,32869,28973,502,2620,3896,0.881468861,0.118531139,0.079710365
Kansas,HASKELL,4307,3188,7,1015,1119,0.740190388,0.259809612,0.235662874
Kansas,HODGEMAN,2085,1992,19,56,93,0.955395683,0.044604317,0.026858513
Kansas,JACKSON,12657,11344,66,189,1313,0.896262938,0.103737062,0.014932448
Kansas,JEFFERSON,18426,17683,65,236,743,0.959676544,0.040323456,0.012807989
Kansas,JEWELL,3791,3723,1,27,68,0.98206278,0.01793722,0.007122131
Kansas,JOHNSON,451086,401428,11568,17957,49658,0.889914562,0.110085438,0.039808374
Kansas,KEARNY,4531,3223,20,1203,1308,0.711322004,0.288677996,0.265504304
Kansas,KINGMAN,8673,8368,17,125,305,0.964833391,0.035166609,0.014412545
Kansas,KIOWA,3278,3155,7,67,123,0.96247712,0.03752288,0.020439292
Kansas,LABETTE,22835,20043,1050,700,2792,0.877731552,0.122268448,0.030654697
Kansas,LANE,2155,2091,0,31,64,0.970301624,0.029698376,0.014385151
Kansas,LEAVENWORTH,68691,56355,7018,2620,12336,0.820413155,0.179586845,0.038141824
Kansas,LINCOLN,3578,3491,4,37,87,0.97568474,0.02431526,0.010340973
Kansas,LINN,9570,9274,57,87,296,0.96907001,0.03092999,0.009090909
Kansas,LOGAN,3046,2931,18,50,115,0.962245568,0.037754432,0.01641497
Kansas,LYON,35935,27786,785,6010,8149,0.773229442,0.226770558,0.167246417
Kansas,MCPHERSON,29554,28240,232,573,1314,0.955539013,0.044460987,0.019388238
Kansas,MARION,13361,12833,63,257,528,0.960482,0.039518,0.019235087
Kansas,MARSHALL,10965,10716,24,83,249,0.977291382,0.022708618,0.007569539
Kansas,MEADE,4631,4019,16,505,612,0.867847117,0.132152883,0.109047722
Kansas,MIAMI,28351,26924,429,451,1427,0.949666678,0.050333322,0.015907728
Kansas,MITCHELL,6932,6732,35,61,200,0.971148298,0.028851702,0.008799769
Kansas,MONTGOMERY,36252,30615,2163,1118,5637,0.844505131,0.155494869,0.030839678
Kansas,MORRIS,6104,5871,21,136,233,0.961828309,0.038171691,0.022280472
Kansas,MORTON,3496,2891,7,493,605,0.82694508,0.17305492,0.141018307
Kansas,NEMAHA,10717,10492,51,76,225,0.979005319,0.020994681,0.007091537
Kansas,NEOSHO,16997,15876,140,494,1121,0.934047185,0.065952815,0.029063952
Kansas,NESS,3454,3369,1,52,85,0.975390851,0.024609149,0.015055009
Kansas,NORTON,5953,5485,240,141,468,0.921384176,0.078615824,0.023685537
Kansas,OSAGE,16712,16109,36,255,603,0.963918143,0.036081857,0.015258497
Kansas,OSBORNE,4452,4378,3,17,74,0.983378257,0.016621743,0.003818509
Kansas,OTTAWA,6163,5969,31,80,194,0.968521824,0.031478176,0.012980691
Kansas,PAWNEE,7233,6423,354,301,810,0.888013273,0.111986727,0.041614821
Kansas,PHILLIPS,6001,5868,15,40,133,0.977837027,0.022162973,0.006665556
Kansas,POTTAWATOMIE,18209,17288,119,411,921,0.949420616,0.050579384,0.022571256
Kansas,PRATT,9647,9095,91,298,552,0.942780139,0.057219861,0.030890432
Kansas,RAWLINS,2966,2906,9,24,60,0.979770735,0.020229265,0.008091706
Kansas,RENO,64790,57797,1812,3661,6993,0.892066677,0.107933323,0.056505634
Kansas,REPUBLIC,5835,5718,15,55,117,0.979948586,0.020051414,0.009425878
Kansas,RICE,10761,9837,122,604,924,0.914134374,0.085865626,0.056128613
Kansas,RILEY,62843,51954,4221,2872,10889,0.826726923,0.173273077,0.045701192
Kansas,ROOKS,5685,5486,64,60,199,0.964995602,0.035004398,0.01055409
Kansas,RUSH,3551,3471,11,37,80,0.977471135,0.022528865,0.0104196
Kansas,RUSSELL,7370,7146,36,67,224,0.969606513,0.030393487,0.009090909
Kansas,SALINE,53597,46645,1622,3228,6952,0.870291248,0.129708752,0.060227252
Kansas,SCOTT,5120,4746,4,323,374,0.926953125,0.073046875,0.063085938
Kansas,SEDGWICK,452869,345925,40748,36397,106944,0.76385224,0.23614776,0.08036982
Kansas,SEWARD,22510,11126,806,9486,11384,0.494269214,0.505730786,0.421412705
Kansas,SHAWNEE,169871,135752,14917,12330,34119,0.799147588,0.200852412,0.072584491
Kansas,SHERIDAN,2813,2753,4,41,60,0.978670459,0.021329541,0.014575187
Kansas,SHERMAN,6760,6085,24,571,675,0.900147929,0.099852071,0.084467456
Kansas,SMITH,4536,4463,5,33,73,0.983906526,0.016093474,0.007275132
Kansas,STAFFORD,4789,4455,7,259,334,0.930256839,0.069743161,0.054082272
Kansas,STANTON,2406,1780,15,570,626,0.739817124,0.260182876,0.236907731
Kansas,STEVENS,5463,4122,43,1187,1341,0.754530478,0.245469522,0.217279883
Kansas,SUMNER,25946,24067,175,929,1879,0.927580359,0.072419641,0.035805134
Kansas,THOMAS,8180,7882,35,151,298,0.963569682,0.036430318,0.018459658
Kansas,TREGO,3319,3230,6,26,89,0.973184694,0.026815306,0.007833685
Kansas,WABAUNSEE,6885,6628,26,128,257,0.962672476,0.037327524,0.01859114
Kansas,WALLACE,1749,1623,11,84,126,0.927958834,0.072041166,0.048027444
Kansas,WASHINGTON,6483,6380,7,42,103,0.984112294,0.015887706,0.006478482
Kansas,WICHITA,2531,2024,2,466,507,0.799683919,0.200316081,0.18411695
Kansas,WILSON,10332,9907,34,173,425,0.95886566,0.04113434,0.016744096
Kansas,WOODSON,3788,3645,29,52,143,0.962249208,0.037750792,0.013727561
Kansas,WYANDOTTE,157882,81534,44328,25257,76348,0.516423658,0.483576342,0.159973905
Kentucky,ADAIR,17244,16462,434,132,782,0.954650893,0.045349107,0.007654836
Kentucky,ALLEN,17800,17293,190,147,507,0.971516854,0.028483146,0.008258427
Kentucky,ANDERSON,19111,18351,442,153,760,0.960232327,0.039767673,0.00800586
Kentucky,BALLARD,8286,7867,238,52,419,0.949432778,0.050567222,0.006275646
Kentucky,BARREN,38033,35662,1553,355,2371,0.937659401,0.062340599,0.009333999
Kentucky,BATH,11085,10700,200,89,385,0.965268381,0.034731619,0.008028868
Kentucky,BELL,30060,28740,720,194,1320,0.956087824,0.043912176,0.006453759
Kentucky,BOONE,85991,80871,1276,1702,5120,0.940458885,0.059541115,0.019792769
Kentucky,BOURBON,19360,17285,1330,503,2075,0.892820248,0.107179752,0.025981405
Kentucky,BOYD,49752,47326,1224,558,2426,0.951238141,0.048761859,0.01121563
Kentucky,BOYLE,27697,24086,2669,398,3611,0.869624869,0.130375131,0.014369787
Kentucky,BRACKEN,8279,8130,48,39,149,0.982002657,0.017997343,0.004710714
Kentucky,BREATHITT,16100,15797,62,106,303,0.981180124,0.018819876,0.006583851
Kentucky,BRECKINRIDGE,18648,17787,520,134,861,0.953828829,0.046171171,0.007185757
Kentucky,BULLITT,61236,59798,232,383,1438,0.976517081,0.023482919,0.006254491
Kentucky,BUTLER,13010,12684,67,135,326,0.974942352,0.025057648,0.010376633
Kentucky,CALDWELL,13060,12231,623,80,829,0.936523737,0.063476263,0.006125574
Kentucky,CALLOWAY,34177,31688,1200,473,2489,0.927173245,0.072826755,0.013839717
Kentucky,CAMPBELL,88616,85145,1388,765,3471,0.960831001,0.039168999,0.008632753
Kentucky,CARLISLE,5351,5204,51,44,147,0.972528499,0.027471501,0.008222762
Kentucky,CARROLL,10155,9487,196,330,668,0.934219596,0.065780404,0.032496307
Kentucky,CARTER,26889,26494,34,158,395,0.985309978,0.014690022,0.005876009
Kentucky,CASEY,15447,15057,51,198,390,0.974752379,0.025247621,0.012818023
Kentucky,CHRISTIAN,72265,49246,16896,3494,23019,0.681464056,0.318535944,0.048349824
Kentucky,CLARK,33144,30832,1568,393,2312,0.930243785,0.069756215,0.01185735
Kentucky,CLAY,24556,22833,1151,333,1723,0.929833849,0.070166151,0.013560841
Kentucky,CLINTON,9634,9450,10,118,184,0.980900976,0.019099024,0.012248287
Kentucky,CRITTENDEN,9384,9190,61,48,194,0.979326513,0.020673487,0.00511509
Kentucky,CUMBERLAND,7147,6793,242,43,354,0.950468728,0.049531272,0.00601651
Kentucky,DAVIESS,91545,85302,3962,845,6243,0.931804031,0.068195969,0.009230433
Kentucky,EDMONSON,11644,11408,67,65,236,0.979732051,0.020267949,0.005582274
Kentucky,ELLIOTT,6748,6655,2,40,93,0.986218139,0.013781861,0.005927682
Kentucky,ESTILL,15307,15102,17,81,205,0.986607435,0.013392565,0.005291697
Kentucky,FAYETTE,260512,206174,34876,8561,54338,0.791418438,0.208581562,0.03286221
Kentucky,FLEMING,13792,13359,195,103,433,0.968604988,0.031395012,0.007468097
Kentucky,FLOYD,42441,41282,543,260,1159,0.972691501,0.027308499,0.006126152
Kentucky,FRANKLIN,47687,41681,4442,531,6006,0.874053725,0.125946275,0.01113511
Kentucky,FULTON,7752,5798,1792,56,1954,0.747936017,0.252063983,0.007223942
Kentucky,GALLATIN,7870,7563,125,82,307,0.960991105,0.039008895,0.010419314
Kentucky,GARRARD,14792,14047,448,195,745,0.949634938,0.050365062,0.013182802
Kentucky,GRANT,22384,21863,53,232,521,0.976724446,0.023275554,0.010364546
Kentucky,GRAVES,37028,33971,1636,888,3057,0.917440856,0.082559144,0.023981852
Kentucky,GRAYSON,24053,23504,119,186,549,0.977175404,0.022824596,0.007732923
Kentucky,GREEN,11518,11004,299,109,514,0.955374197,0.044625803,0.009463449
Kentucky,GREENUP,36891,36027,208,204,864,0.976579654,0.023420346,0.005529804
Kentucky,HANCOCK,8392,8174,71,64,218,0.974022879,0.025977121,0.007626311
Kentucky,HARDIN,94174,75785,10969,3159,18389,0.804733791,0.195266209,0.03354429
Kentucky,HARLAN,33202,31566,865,216,1636,0.95072586,0.04927414,0.006505632
Kentucky,HARRISON,17983,17119,452,207,864,0.951954624,0.048045376,0.011510871
Kentucky,HART,17445,16047,1069,150,1398,0.919862425,0.080137575,0.008598452
Kentucky,HENDERSON,44829,40643,3154,433,4186,0.906622945,0.093377055,0.009658926
Kentucky,HENRY,15060,14034,493,339,1026,0.93187251,0.06812749,0.02250996
Kentucky,HICKMAN,5262,4614,520,54,648,0.876852908,0.123147092,0.010262258
Kentucky,HOPKINS,46519,42568,2876,423,3951,0.915066962,0.084933038,0.009093059
Kentucky,JACKSON,13495,13322,7,72,173,0.987180437,0.012819563,0.005335309
Kentucky,JEFFERSON,693604,530056,130003,12370,163548,0.764205512,0.235794488,0.017834384
Kentucky,JESSAMINE,39041,36600,1217,512,2441,0.937475987,0.062524013,0.013114418
Kentucky,JOHNSON,23445,23018,57,143,427,0.981787161,0.018212839,0.006099382
Kentucky,KENTON,151464,141315,5782,1669,10149,0.932993979,0.067006021,0.01101912
Kentucky,KNOTT,17649,17252,129,112,397,0.977505808,0.022494192,0.006345969
Kentucky,KNOX,31795,30970,262,180,825,0.974052524,0.025947476,0.005661267
Kentucky,LARUE,13373,12564,470,140,809,0.939504973,0.060495027,0.010468855
Kentucky,LAUREL,52715,51254,324,291,1461,0.972284928,0.027715072,0.00552025
Kentucky,LAWRENCE,15569,15348,14,64,221,0.985805126,0.014194874,0.004110733
Kentucky,LEE,7916,7510,298,29,406,0.94871147,0.05128853,0.003663466
Kentucky,LESLIE,12401,12232,9,77,169,0.986372067,0.013627933,0.006209177
Kentucky,LETCHER,25277,24853,129,110,424,0.983225857,0.016774143,0.004351782
Kentucky,LEWIS,14092,13891,29,62,201,0.985736588,0.014263412,0.004399659
Kentucky,LINCOLN,23361,22349,582,208,1012,0.956679937,0.043320063,0.008903728
Kentucky,LIVINGSTON,9804,9608,13,74,196,0.98000816,0.01999184,0.00754794
Kentucky,LOGAN,26573,23922,2014,288,2651,0.900237083,0.099762917,0.010838069
Kentucky,LYON,8080,7401,541,59,679,0.915965347,0.084034653,0.00730198
Kentucky,MCCRACKEN,65514,56464,7099,694,9050,0.861861587,0.138138413,0.010593156
Kentucky,MCCREARY,17080,16671,106,106,409,0.976053864,0.023946136,0.006206089
Kentucky,MCLEAN,9938,9749,36,83,189,0.980982089,0.019017911,0.008351781
Kentucky,MADISON,70872,65484,3138,685,5388,0.923975618,0.076024382,0.009665312
Kentucky,MAGOFFIN,13332,13191,19,56,141,0.989423942,0.010576058,0.00420042
Kentucky,MARION,18212,16176,1650,144,2036,0.888205579,0.111794421,0.007906875
Kentucky,MARSHALL,30125,29547,36,229,578,0.980813278,0.019186722,0.00760166
Kentucky,MARTIN,12578,12413,4,78,165,0.986881857,0.013118143,0.006201304
Kentucky,MASON,16800,15201,1200,160,1599,0.904821429,0.095178571,0.00952381
Kentucky,MEADE,26349,24050,1068,567,2299,0.912748112,0.087251888,0.021518843
Kentucky,MENIFEE,6556,6356,71,73,200,0.969493594,0.030506406,0.011134838
Kentucky,MERCER,20817,19448,757,265,1369,0.934236441,0.065763559,0.01272998
Kentucky,METCALFE,10037,9719,165,53,318,0.968317226,0.031682774,0.005280462
Kentucky,MONROE,11756,11178,321,170,578,0.950833617,0.049166383,0.014460701
Kentucky,MONTGOMERY,22554,21276,779,259,1278,0.943335994,0.056664006,0.011483551
Kentucky,MORGAN,13948,13132,605,85,816,0.941496989,0.058503011,0.006094064
Kentucky,MUHLENBERG,31839,29836,1472,232,2003,0.937089733,0.062910267,0.007286661
Kentucky,NELSON,37477,34579,2054,395,2898,0.922672573,0.077327427,0.010539798
Kentucky,NICHOLAS,6813,6676,57,37,137,0.979891384,0.020108616,0.005430794
Kentucky,OHIO,22916,22276,169,231,640,0.972071915,0.027928085,0.010080293
Kentucky,OLDHAM,46178,42921,1933,602,3257,0.929468578,0.070531422,0.013036511
Kentucky,OWEN,10547,10188,118,105,359,0.965961885,0.034038115,0.009955438
Kentucky,OWSLEY,4858,4785,5,35,73,0.98497324,0.01502676,0.007204611
Kentucky,PENDLETON,14390,14114,69,97,276,0.980820014,0.019179986,0.006740792
Kentucky,PERRY,29390,28469,478,154,921,0.96866281,0.03133719,0.005239878
Kentucky,PIKE,68736,67267,309,450,1469,0.978628375,0.021371625,0.006546788
Kentucky,POWELL,13237,12969,82,88,268,0.979753721,0.020246279,0.006648032
Kentucky,PULASKI,56217,54457,602,454,1760,0.968692744,0.031307256,0.008075849
Kentucky,ROBERTSON,2266,2233,1,21,33,0.985436893,0.014563107,0.009267432
Kentucky,ROCKCASTLE,16582,16301,23,102,281,0.983053914,0.016946086,0.006151248
Kentucky,ROWAN,22094,21063,342,235,1031,0.953335747,0.046664253,0.010636372
Kentucky,RUSSELL,16315,15942,92,140,373,0.977137603,0.022862397,0.00858106
Kentucky,SCOTT,33061,30167,1749,531,2894,0.912464838,0.087535162,0.01606122
Kentucky,SHELBY,33337,28293,2923,1505,5044,0.848696643,0.151303357,0.045145034
Kentucky,SIMPSON,16405,14314,1670,150,2091,0.87253886,0.12746114,0.009143554
Kentucky,SPENCER,11766,11377,132,132,389,0.966938637,0.033061363,0.011218766
Kentucky,TAYLOR,22927,21342,1150,189,1585,0.930867536,0.069132464,0.008243556
Kentucky,TODD,11971,10612,1046,199,1359,0.886475649,0.113524351,0.016623507
Kentucky,TRIGG,12597,11047,1233,113,1550,0.876954831,0.123045169,0.00897039
Kentucky,TRIMBLE,8125,7898,24,111,227,0.972061538,0.027938462,0.013661538
Kentucky,UNION,15637,13200,1977,244,2437,0.844151692,0.155848308,0.015604016
Kentucky,WARREN,92522,79376,7913,2466,13146,0.857914874,0.142085126,0.02665312
Kentucky,WASHINGTON,10916,9786,817,175,1130,0.896482228,0.103517772,0.016031513
Kentucky,WAYNE,19923,19156,287,291,767,0.961501782,0.038498218,0.014606234
Kentucky,WEBSTER,14120,13083,654,268,1037,0.926558074,0.073441926,0.01898017
Kentucky,WHITLEY,35865,35062,122,249,803,0.977610484,0.022389516,0.006942702
Kentucky,WOLFE,7065,6981,17,36,84,0.988110403,0.011889597,0.005095541
Kentucky,WOODFORD,23208,20944,1256,695,2264,0.902447432,0.097552568,0.02994657
Louisiana,ACADIA PARISH,58861,47150,10705,538,11711,0.801039738,0.198960262,0.009140178
Louisiana,ALLEN PARISH,25440,17329,6175,1146,8111,0.681171384,0.318828616,0.04504717
Louisiana,ASCENSION PARISH,76627,58378,15466,1883,18249,0.761846347,0.238153653,0.024573584
Louisiana,ASSUMPTION PARISH,23388,15565,7303,284,7823,0.665512228,0.334487772,0.012142979
Louisiana,AVOYELLES PARISH,41481,28147,12173,404,13334,0.678551626,0.321448374,0.009739399
Louisiana,BEAUREGARD PARISH,32986,27513,4229,468,5473,0.834081125,0.165918875,0.014187837
Louisiana,BIENVILLE PARISH,15752,8607,6860,149,7145,0.546406805,0.453593195,0.009459116
Louisiana,BOSSIER PARISH,98310,71701,20347,3063,26609,0.729335775,0.270664225,0.031156546
Louisiana,CADDO PARISH,252161,131527,111984,3750,120634,0.521599296,0.478400704,0.014871451
Louisiana,CALCASIEU PARISH,183577,133716,43769,2463,49861,0.728391901,0.271608099,0.013416713
Louisiana,CALDWELL PARISH,10560,8396,1884,157,2164,0.795075758,0.204924242,0.014867424
Louisiana,CAMERON PARISH,9991,9244,388,215,747,0.925232709,0.074767291,0.021519367
Louisiana,CATAHOULA PARISH,10920,7785,2942,101,3135,0.712912088,0.287087912,0.009249084
Louisiana,CLAIBORNE PARISH,16851,8679,7925,128,8172,0.515043618,0.484956382,0.007595988
Louisiana,CONCORDIA PARISH,20247,12172,7573,300,8075,0.601175483,0.398824517,0.01481701
Louisiana,DE SOTO PARISH,25494,14089,10691,396,11405,0.552639837,0.447360163,0.015533067
Louisiana,EAST BATON ROUGE PARISH,412852,227445,164853,7363,185407,0.550911707,0.449088293,0.017834478
Louisiana,EAST CARROLL PARISH,9421,2933,6297,112,6488,0.311325762,0.688674238,0.011888335
Louisiana,EAST FELICIANA PARISH,21360,10989,10012,157,10371,0.514466292,0.485533708,0.007350187
Louisiana,EVANGELINE PARISH,35434,24730,10041,368,10704,0.697917255,0.302082745,0.010385505
Louisiana,FRANKLIN PARISH,21263,14197,6692,160,7066,0.667685651,0.332314349,0.007524808
Louisiana,GRANT PARISH,18698,15859,2212,213,2839,0.848165579,0.151834421,0.011391593
Louisiana,IBERIA PARISH,73266,47122,22451,1101,26144,0.643163268,0.356836732,0.015027434
Louisiana,IBERVILLE PARISH,33320,16202,16486,343,17118,0.486254502,0.513745498,0.010294118
Louisiana,JACKSON PARISH,15397,10887,4282,94,4510,0.707085796,0.292914204,0.006105085
Louisiana,JEFFERSON PARISH,455466,298062,103376,32418,157404,0.654411087,0.345588913,0.071175455
Louisiana,JEFFERSON DAVIS PARISH,31435,25138,5571,312,6297,0.799681883,0.200318117,0.009925243
Louisiana,LAFAYETTE PARISH,190503,137762,45149,3320,52741,0.723148717,0.276851283,0.017427547
Louisiana,LAFOURCHE PARISH,89974,73937,11287,1284,16037,0.821759619,0.178240381,0.014270789
Louisiana,LA SALLE PARISH,14282,12225,1732,117,2057,0.855972553,0.144027447,0.00819213
Louisiana,LINCOLN PARISH,42509,24206,16846,492,18303,0.569432356,0.430567644,0.01157402
Louisiana,LIVINGSTON PARISH,91814,85882,3846,1017,5932,0.935391117,0.064608883,0.011076742
Louisiana,MADISON PARISH,13728,5087,8259,288,8641,0.370556527,0.629443473,0.020979021
Louisiana,MOREHOUSE PARISH,31021,17215,13353,230,13806,0.554946649,0.445053351,0.007414332
Louisiana,NATCHITOCHES PARISH,39080,22357,14917,566,16723,0.572082907,0.427917093,0.014483112
Louisiana,ORLEANS PARISH,484674,128871,323392,14826,355803,0.265892125,0.734107875,0.030589633
Louisiana,OUACHITA PARISH,147250,94013,49270,1747,53237,0.638458404,0.361541596,0.011864177
Louisiana,PLAQUEMINES PARISH,26757,18412,6227,433,8345,0.688118997,0.311881003,0.016182681
Louisiana,POINTE COUPEE PARISH,22763,13720,8553,245,9043,0.602732505,0.397267495,0.01076308
Louisiana,RAPIDES PARISH,126337,83059,38298,1739,43278,0.657440022,0.342559978,0.013764772
Louisiana,RED RIVER PARISH,9622,5540,3899,97,4082,0.575763874,0.424236126,0.010081064
Louisiana,RICHLAND PARISH,20981,12667,7927,227,8314,0.603736714,0.396263286,0.010819313
Louisiana,SABINE PARISH,23459,16726,3934,642,6733,0.712988618,0.287011382,0.027366895
Louisiana,ST. BERNARD PARISH,67229,56723,5095,3425,10506,0.843728153,0.156271847,0.050945277
Louisiana,ST. CHARLES PARISH,48072,33901,12043,1346,14171,0.705213014,0.294786986,0.027999667
Louisiana,ST. HELENA PARISH,10525,4859,5480,104,5666,0.461662708,0.538337292,0.009881235
Louisiana,ST. JAMES PARISH,21216,10538,10444,130,10678,0.496700603,0.503299397,0.006127451
Louisiana,ST. JOHN THE BAPTIST PARISH,43044,21946,19204,1230,21098,0.509850386,0.490149614,0.028575411
Louisiana,ST. LANDRY PARISH,87700,49160,36762,794,38540,0.56054732,0.43945268,0.009053592
Louisiana,ST. MARTIN PARISH,48583,31813,15464,405,16770,0.654817529,0.345182471,0.008336249
Louisiana,ST. MARY PARISH,53500,33051,16945,1152,20449,0.617775701,0.382224299,0.02153271
Louisiana,ST. TAMMANY PARISH,191268,163061,18788,4737,28207,0.852526298,0.147473702,0.024766297
Louisiana,TANGIPAHOA PARISH,100588,69300,28388,1536,31288,0.68894898,0.31105102,0.015270211
Louisiana,TENSAS PARISH,6618,2842,3642,83,3776,0.429434875,0.570565125,0.012541553
Louisiana,TERREBONNE PARISH,104503,76548,18517,1631,27955,0.732495718,0.267504282,0.015607207
Louisiana,UNION PARISH,22803,15772,6355,461,7031,0.691663378,0.308336622,0.020216638
Louisiana,VERMILION PARISH,53807,44026,7527,742,9781,0.818220678,0.181779322,0.013790027
Louisiana,VERNON PARISH,52531,37483,8782,3111,15048,0.713540576,0.286459424,0.059222174
Louisiana,WASHINGTON PARISH,43926,29396,13781,334,14530,0.669216409,0.330783591,0.007603697
Louisiana,WEBSTER PARISH,41831,27233,13662,378,14598,0.65102436,0.34897564,0.009036361
Louisiana,WEST BATON ROUGE PARISH,21601,13394,7649,313,8207,0.620063886,0.379936114,0.01449007
Louisiana,WEST CARROLL PARISH,12314,9741,2315,166,2573,0.791050836,0.208949164,0.013480591
Louisiana,WEST FELICIANA PARISH,15111,7263,7575,157,7848,0.48064324,0.51935676,0.010389782
Louisiana,WINN PARISH,16894,11100,5396,147,5794,0.657038002,0.342961998,0.008701314
Maine,ANDROSCOGGIN,103793,100059,647,988,3734,0.964024549,0.035975451,0.009518946
Maine,AROOSTOOK,73938,71309,269,441,2629,0.964443182,0.035556818,0.005964457
Maine,CUMBERLAND,265612,252915,2690,2526,12697,0.95219719,0.04780281,0.009510112
Maine,FRANKLIN,29467,28750,70,159,717,0.975667696,0.024332304,0.005395867
Maine,HANCOCK,51791,50316,123,336,1475,0.971520148,0.028479852,0.006487614
Maine,KENNEBEC,117114,113566,384,852,3548,0.969704732,0.030295268,0.007274963
Maine,KNOX,39618,38777,78,225,841,0.978772275,0.021227725,0.005679237
Maine,LINCOLN,33616,32986,56,155,630,0.981258924,0.018741076,0.0046109
Maine,OXFORD,54755,53588,86,292,1167,0.978686878,0.021313122,0.005332846
Maine,PENOBSCOT,144919,139461,684,882,5458,0.962337582,0.037662418,0.006086158
Maine,PISCATAQUIS,17235,16801,36,89,434,0.974818683,0.025181317,0.005163911
Maine,SAGADAHOC,35214,33762,307,391,1452,0.9587664,0.0412336,0.011103538
Maine,SOMERSET,50888,49699,117,234,1189,0.976634963,0.023365037,0.004598334
Maine,WALDO,36280,35382,62,215,898,0.975248071,0.024751929,0.00592613
Maine,WASHINGTON,33941,31640,79,274,2301,0.932205887,0.067794113,0.008072832
Maine,YORK,186742,181286,752,1301,5456,0.97078322,0.02921678,0.006966831
Maryland,ALLEGANY,74930,69340,3962,571,5590,0.925397037,0.074602963,0.007620446
Maryland,ANNE ARUNDEL,489656,390519,65755,12902,99137,0.797537455,0.202462545,0.02634911
Maryland,BALTIMORE,754292,553890,150456,13774,200402,0.734317744,0.265682256,0.018260833
Maryland,CALVERT,74563,61894,9728,1135,12669,0.830089991,0.169910009,0.015222027
Maryland,CAROLINE,29772,24029,4368,789,5743,0.807100631,0.192899369,0.026501411
Maryland,CARROLL,150897,143455,3400,1489,7442,0.950681591,0.049318409,0.009867658
Maryland,CECIL,85951,79546,3321,1306,6405,0.925480797,0.074519203,0.015194704
Maryland,CHARLES,120546,81111,31203,2722,39435,0.672863471,0.327136529,0.022580592
Maryland,DORCHESTER,30674,21117,8658,385,9557,0.688433201,0.311566799,0.012551346
Maryland,FREDERICK,195277,171966,12253,4664,23311,0.880625983,0.119374017,0.023884021
Maryland,GARRETT,29846,29378,127,131,468,0.984319507,0.015680493,0.004389198
Maryland,HARFORD,218590,187548,20007,4169,31042,0.857989844,0.142010156,0.019072236
Maryland,HOWARD,247842,180010,35353,7490,67832,0.726309504,0.273690496,0.030220867
Maryland,KENT,19197,15050,3317,546,4147,0.783976663,0.216023337,0.028441944
Maryland,MONTGOMERY,873341,519318,129371,100604,354023,0.594633711,0.405366289,0.115194409
Maryland,PRINCE GEORGE'S,801515,194836,498301,57057,606679,0.243084658,0.756915342,0.071186441
Maryland,QUEEN ANNE'S,40563,35863,3537,444,4700,0.884130858,0.115869142,0.010945936
Maryland,ST. MARY'S,86211,69336,11908,1720,16875,0.804259317,0.195740683,0.01995105
Maryland,SOMERSET,24747,13814,10108,334,10933,0.558209076,0.441790924,0.013496585
Maryland,TALBOT,33812,27456,5161,615,6356,0.812019401,0.187980599,0.018188809
Maryland,WASHINGTON,131923,117518,10150,1570,14405,0.890807517,0.109192483,0.011900882
Maryland,WICOMICO,84644,60552,19583,1842,24092,0.715372619,0.284627381,0.021761731
Maryland,WORCESTER,46543,37435,7699,596,9108,0.804309993,0.195690007,0.012805363
Maryland,BALTIMORE CITY,651154,201566,417009,11061,449588,0.309551965,0.690448035,0.016986765
Massachusetts,BARNSTABLE,222230,207518,3848,3000,14712,0.933798317,0.066201683,0.013499528
Massachusetts,BERKSHIRE,134953,126961,2570,2286,7992,0.940779382,0.059220618,0.016939231
Massachusetts,BRISTOL,534678,477938,9788,19242,56740,0.893880055,0.106119945,0.035988015
Massachusetts,DUKES,14987,13489,346,155,1498,0.900046707,0.099953293,0.010342297
Massachusetts,ESSEX,723419,601340,14399,79871,122079,0.831247175,0.168752825,0.110407661
Massachusetts,FRANKLIN,71535,67518,594,1425,4017,0.94384567,0.05615433,0.019920319
Massachusetts,HAMPDEN,456228,339625,34034,69197,116603,0.744419457,0.255580543,0.151671971
Massachusetts,HAMPSHIRE,152251,136319,2740,5212,15932,0.895357009,0.104642991,0.034232944
Massachusetts,MIDDLESEX,1465396,1224771,46598,66707,240625,0.835795239,0.164204761,0.045521484
Massachusetts,NANTUCKET,9520,8275,783,212,1245,0.869222689,0.130777311,0.022268908
Massachusetts,NORFOLK,650308,571733,20106,11990,78575,0.879172638,0.120827362,0.018437417
Massachusetts,PLYMOUTH,472822,414110,20449,11537,58712,0.875826421,0.124173579,0.024400303
Massachusetts,SUFFOLK,689807,359535,143817,107031,330272,0.521211005,0.478788995,0.155160791
Massachusetts,WORCESTER,750963,649227,18257,50864,101736,0.864525949,0.135474051,0.067731699
Michigan,ALCONA,11719,11419,19,81,300,0.974400546,0.025599454,0.006911853
Michigan,ALGER,9862,8625,595,99,1237,0.874569053,0.125430947,0.010038532
Michigan,ALLEGAN,105665,96167,1315,6040,9498,0.910112147,0.089887853,0.057161785
Michigan,ALPENA,31314,30626,73,181,688,0.978028997,0.021971003,0.005780162
Michigan,ANTRIM,23110,22235,42,284,875,0.962137603,0.037862397,0.012289052
Michigan,ARENAC,17269,16298,309,238,971,0.943772077,0.056227923,0.013781921
Michigan,BARAGA,8746,6849,432,81,1897,0.783100846,0.216899154,0.009261377
Michigan,BARRY,56755,54795,137,831,1960,0.965465598,0.034534402,0.014641882
Michigan,BAY,110157,102119,1343,4308,8038,0.927031419,0.072968581,0.039107819
Michigan,BENZIE,15998,15270,43,233,728,0.954494312,0.045505688,0.014564321
Michigan,BERRIEN,162453,126798,25729,4888,35655,0.780521135,0.219478865,0.030088703
Michigan,BRANCH,45787,42134,1187,1365,3653,0.920217529,0.079782471,0.029811955
Michigan,CALHOUN,137985,113723,14912,4351,24262,0.824169294,0.175830706,0.031532413
Michigan,CASS,51104,45069,3107,1233,6035,0.881907483,0.118092517,0.02412727
Michigan,CHARLEVOIX,26090,24990,42,272,1100,0.957838252,0.042161748,0.01042545
Michigan,CHEBOYGAN,26448,24947,62,202,1501,0.943247126,0.056752874,0.007637629
Michigan,CHIPPEWA,38543,28987,2088,599,9556,0.752069118,0.247930882,0.015541084
Michigan,CLARE,31252,30210,100,340,1042,0.966658134,0.033341866,0.010879304
Michigan,CLINTON,64753,61416,401,1688,3337,0.948465708,0.051534292,0.02606829
Michigan,CRAWFORD,14273,13660,213,142,613,0.957051776,0.042948224,0.009948854
Michigan,DELTA,38520,36791,35,187,1729,0.955114226,0.044885774,0.004854621
Michigan,DICKINSON,27472,26794,32,187,678,0.975320326,0.024679674,0.006806931
Michigan,EATON,103655,91895,5397,3323,11760,0.886546717,0.113453283,0.03205827
Michigan,EMMET,31437,29483,142,285,1954,0.937843942,0.062156058,0.009065751
Michigan,GENESEE,436141,323136,88356,10152,113005,0.740898012,0.259101988,0.023276876
Michigan,GLADWIN,26023,25256,32,249,767,0.970526073,0.029473927,0.009568459
Michigan,GOGEBIC,17370,16297,299,153,1073,0.938226828,0.061773172,0.00880829
Michigan,GRAND TRAVERSE,77654,74258,295,1155,3396,0.956267546,0.043732454,0.01487367
Michigan,GRATIOT,42285,38024,1554,1875,4261,0.899231406,0.100768594,0.044341965
Michigan,HILLSDALE,46527,45042,197,558,1485,0.968083049,0.031916951,0.011993036
Michigan,HOUGHTON,36016,34239,334,251,1777,0.950660817,0.049339183,0.006969125
Michigan,HURON,36079,34923,69,591,1156,0.967959201,0.032040799,0.01638072
Michigan,INGHAM,279320,214685,29712,16190,64635,0.76859874,0.23140126,0.057962194
Michigan,IONIA,61518,55749,2759,1711,5769,0.906222569,0.093777431,0.027812998
Michigan,IOSCO,27339,26327,106,269,1012,0.962983284,0.037016716,0.009839424
Michigan,IRON,13138,12601,144,84,537,0.959126199,0.040873801,0.006393667
Michigan,ISABELLA,63351,57294,1211,1419,6057,0.904389828,0.095610172,0.022399015
Michigan,JACKSON,158422,138528,12396,3493,19894,0.874424007,0.125575993,0.022048705
Michigan,KALAMAZOO,238603,199180,22968,6311,39423,0.834775757,0.165224243,0.026449793
Michigan,KALKASKA,16571,16063,34,142,508,0.969344035,0.030655965,0.008569187
Michigan,KENT,574335,461162,49994,40183,113173,0.802949498,0.197050502,0.069964394
Michigan,KEWEENAW,2301,2177,79,18,124,0.946110387,0.053889613,0.007822686
Michigan,LAKE,11333,9511,1252,191,1822,0.839230566,0.160769434,0.016853437
Michigan,LAPEER,87904,82998,709,2731,4906,0.944189115,0.055810885,0.031067983
Michigan,LEELANAU,21119,19424,49,694,1695,0.919740518,0.080259482,0.032861404
Michigan,LENAWEE,98890,88188,2033,6884,10702,0.891778744,0.108221256,0.069612701
Michigan,LIVINGSTON,156951,151170,716,1953,5781,0.963166848,0.036833152,0.012443374
Michigan,LUCE,7024,5787,505,123,1237,0.823889522,0.176110478,0.01751139
Michigan,MACKINAC,11943,9506,23,107,2437,0.795947417,0.204052583,0.008959223
Michigan,MACOMB,788149,721882,21151,12435,66267,0.915920721,0.084079279,0.015777474
Michigan,MANISTEE,24527,22781,388,639,1746,0.928813145,0.071186855,0.026052921
Michigan,MARQUETTE,64634,61205,846,444,3429,0.946947427,0.053052573,0.00686945
Michigan,MASON,28274,26576,200,852,1698,0.939944826,0.060055174,0.030133692
Michigan,MECOSTA,40553,37259,1450,520,3294,0.918772964,0.081227036,0.012822726
Michigan,MENOMINEE,25326,24270,25,190,1056,0.958303719,0.041696281,0.007502172
Michigan,MIDLAND,82874,78333,857,1287,4541,0.945205975,0.054794025,0.015529599
Michigan,MISSAUKEE,14478,14030,27,169,448,0.9690565,0.0309435,0.011672883
Michigan,MONROE,145945,137391,2686,3110,8554,0.941388879,0.058611121,0.021309397
Michigan,MONTCALM,61266,57313,1308,1394,3953,0.935478079,0.064521921,0.02275324
Michigan,MONTMORENCY,10315,10094,25,67,221,0.978574891,0.021425109,0.006495395
Michigan,MUSKEGON,170200,135379,23971,6001,34821,0.795411281,0.204588719,0.035258519
Michigan,NEWAYGO,47874,44508,519,1845,3366,0.929690437,0.070309563,0.038538664
Michigan,OAKLAND,1194156,971752,119708,28999,222404,0.813756327,0.186243673,0.024284097
Michigan,OCEANA,26873,23066,77,3119,3807,0.858333643,0.141666357,0.116064451
Michigan,OGEMAW,21645,20906,28,252,739,0.965858166,0.034141834,0.011642412
Michigan,ONTONAGON,7818,7567,2,58,251,0.967894602,0.032105398,0.007418777
Michigan,OSCEOLA,23197,22461,79,230,736,0.968271759,0.031728241,0.009915075
Michigan,OSCODA,9418,9162,8,89,256,0.972818008,0.027181992,0.009449989
Michigan,OTSEGO,23301,22603,42,175,698,0.970044204,0.029955796,0.007510407
Michigan,OTTAWA,238314,211058,2380,16692,27256,0.885629883,0.114370117,0.070042045
Michigan,PRESQUE ISLE,14411,14079,37,79,332,0.976962043,0.023037957,0.005481924
Michigan,ROSCOMMON,25469,24795,81,204,674,0.973536456,0.026463544,0.008009737
Michigan,SAGINAW,210039,151977,38675,14075,58062,0.723565624,0.276434376,0.067011365
Michigan,ST. CLAIR,164235,153893,3381,3593,10342,0.937029257,0.062970743,0.021877188
Michigan,ST. JOSEPH,62422,56994,1561,2488,5428,0.913043478,0.086956522,0.039857742
Michigan,SANILAC,44547,42518,120,1239,2029,0.954452601,0.045547399,0.027813321
Michigan,SCHOOLCRAFT,8903,7846,140,83,1057,0.881275974,0.118724026,0.0093227
Michigan,SHIAWASSEE,71687,69016,135,1295,2671,0.962740804,0.037259196,0.018064642
Michigan,TUSCOLA,58266,55200,613,1342,3066,0.947379261,0.052620739,0.0230323
Michigan,VAN BUREN,76263,64466,3939,5634,11797,0.845311619,0.154688381,0.073875929
Michigan,WASHTENAW,322895,245033,39326,8839,77862,0.758862788,0.241137212,0.027374224
Michigan,WAYNE,2061162,1028984,864627,77207,1032178,0.499225194,0.500774806,0.037457997
Michigan,WEXFORD,30484,29469,54,307,1015,0.966703845,0.033296155,0.010070857
Minnesota,AITKIN,15301,14698,31,92,603,0.960590811,0.039409189,0.006012679
Minnesota,ANOKA,298084,276586,4683,4961,21498,0.92787939,0.07212061,0.01664296
Minnesota,BECKER,30000,26699,54,230,3301,0.889966667,0.110033333,0.007666667
Minnesota,BELTRAMI,39650,30243,139,394,9407,0.762749054,0.237250946,0.009936948
Minnesota,BENTON,34226,32768,262,307,1458,0.957400806,0.042599194,0.008969789
Minnesota,BIG STONE,5820,5719,10,20,101,0.982646048,0.017353952,0.003436426
Minnesota,BLUE EARTH,55941,52620,658,988,3321,0.940633882,0.059366118,0.017661465
Minnesota,BROWN,26911,26080,20,545,831,0.969120434,0.030879566,0.020251942
Minnesota,CARLTON,31671,28907,297,266,2764,0.912727732,0.087272268,0.008398851
Minnesota,CARVER,70205,66268,399,1791,3937,0.943921373,0.056078627,0.025511003
Minnesota,CASS,27150,23377,31,220,3773,0.861031308,0.138968692,0.008103131
Minnesota,CHIPPEWA,13088,12550,21,251,538,0.958893643,0.041106357,0.019177873
Minnesota,CHISAGO,41101,39640,197,473,1461,0.96445342,0.03554658,0.011508236
Minnesota,CLAY,51229,47330,261,1872,3899,0.923890765,0.076109235,0.036541802
Minnesota,CLEARWATER,8423,7507,16,65,916,0.891250148,0.108749852,0.007716965
Minnesota,COOK,5168,4609,15,39,559,0.891834365,0.108165635,0.00754644
Minnesota,COTTONWOOD,12167,11509,39,267,658,0.94591929,0.05408071,0.021944604
Minnesota,CROW WING,55099,53580,167,381,1519,0.972431442,0.027568558,0.006914826
Minnesota,DAKOTA,355904,320242,7941,10459,35662,0.899798822,0.100201178,0.029387138
Minnesota,DODGE,17731,16974,35,530,757,0.957306412,0.042693588,0.029891151
Minnesota,DOUGLAS,32821,32216,58,193,605,0.98156668,0.01843332,0.005880381
Minnesota,FARIBAULT,16181,15402,39,566,779,0.951857116,0.048142884,0.034979297
Minnesota,FILLMORE,21122,20823,34,113,299,0.985844144,0.014155856,0.005349872
Minnesota,FREEBORN,32584,30061,65,2049,2523,0.922569359,0.077430641,0.062883624
Minnesota,GOODHUE,44127,42405,273,473,1722,0.960976273,0.039023727,0.010719061
Minnesota,GRANT,6289,6170,13,33,119,0.981078073,0.018921927,0.005247257
Minnesota,HENNEPIN,1116200,881016,98698,45439,235184,0.789299409,0.210700591,0.040708654
Minnesota,HOUSTON,19718,19338,58,121,380,0.980728269,0.019271731,0.006136525
Minnesota,HUBBARD,18376,17625,32,124,751,0.959131476,0.040868524,0.006747932
Minnesota,ISANTI,31287,30383,78,259,904,0.97110621,0.02889379,0.008278199
Minnesota,ITASCA,43992,41494,69,263,2498,0.943216949,0.056783051,0.00597836
Minnesota,JACKSON,11268,10839,10,210,429,0.961927583,0.038072417,0.018636848
Minnesota,KANABEC,14996,14490,22,140,506,0.966257669,0.033742331,0.009335823
Minnesota,KANDIYOHI,41203,37212,173,3295,3991,0.903138121,0.096861879,0.079969905
Minnesota,KITTSON,5285,5142,8,67,143,0.972942289,0.027057711,0.012677389
Minnesota,KOOCHICHING,14355,13744,27,81,611,0.957436433,0.042563567,0.005642633
Minnesota,LAC QUI PARLE,8067,7965,13,21,102,0.987355894,0.012644106,0.002603198
Minnesota,LAKE,11058,10803,11,63,255,0.976939772,0.023060228,0.005697233
Minnesota,LAKE OF THE WOODS,4522,4373,12,29,149,0.967049978,0.032950022,0.006413092
Minnesota,LE SUEUR,25426,24097,38,997,1329,0.947730669,0.052269331,0.03921183
Minnesota,LINCOLN,6429,6329,3,55,100,0.984445481,0.015554519,0.008554985
Minnesota,LYON,25425,23338,364,1009,2087,0.917915438,0.082084562,0.039685349
Minnesota,MCLEOD,34898,33108,67,1268,1790,0.948707662,0.051292338,0.03633446
Minnesota,MAHNOMEN,5190,3252,7,46,1938,0.626589595,0.373410405,0.008863198
Minnesota,MARSHALL,10155,9750,9,298,405,0.960118168,0.039881832,0.02934515
Minnesota,MARTIN,21802,21100,53,421,702,0.967801119,0.032198881,0.019310155
Minnesota,MEEKER,22644,21907,39,487,737,0.967452747,0.032547253,0.021506801
Minnesota,MILLE LACS,22330,20760,59,214,1570,0.929690999,0.070309001,0.00958352
Minnesota,MORRISON,31712,31094,65,203,618,0.980512109,0.019487891,0.006401362
Minnesota,MOWER,38603,35884,206,1646,2719,0.92956506,0.07043494,0.042639173
Minnesota,MURRAY,9165,8930,7,135,235,0.974358974,0.025641026,0.014729951
Minnesota,NICOLLET,29771,28405,232,535,1366,0.954116422,0.045883578,0.017970508
Minnesota,NOBLES,20832,17232,212,2325,3600,0.82718894,0.17281106,0.111607143
Minnesota,NORMAN,7442,6957,7,227,485,0.934829347,0.065170653,0.030502553
Minnesota,OLMSTED,124277,110598,3293,2959,13679,0.889931363,0.110068637,0.023809715
Minnesota,OTTER TAIL,57159,55137,160,957,2022,0.964624993,0.035375007,0.01674277
Minnesota,PENNINGTON,13584,13095,27,169,489,0.964001767,0.035998233,0.012441107
Minnesota,PINE,26530,24702,335,465,1828,0.931096871,0.068903129,0.017527328
Minnesota,PIPESTONE,9895,9538,17,69,357,0.963921172,0.036078828,0.006973219
Minnesota,POLK,31369,28994,86,1502,2375,0.92428831,0.07571169,0.047881667
Minnesota,POPE,11236,11078,23,57,158,0.985938056,0.014061944,0.00507298
Minnesota,RAMSEY,511035,384648,37978,26979,126387,0.752684258,0.247315742,0.052792862
Minnesota,RED LAKE,4299,4181,8,13,118,0.972551756,0.027448244,0.003023959
Minnesota,REDWOOD,16815,15879,22,192,936,0.944335415,0.055664585,0.011418376
Minnesota,RENVILLE,17154,16085,10,876,1069,0.937682173,0.062317827,0.051066807
Minnesota,RICE,56665,51257,713,3117,5408,0.904561899,0.095438101,0.0550075
Minnesota,ROCK,9721,9396,52,124,325,0.966567226,0.033432774,0.012755889
Minnesota,ROSEAU,16338,15625,20,71,713,0.956359408,0.043640592,0.004345697
Minnesota,ST. LOUIS,200528,189314,1676,1597,11214,0.944077635,0.055922365,0.007963975
Minnesota,SCOTT,89498,82733,802,2381,6765,0.924411719,0.075588281,0.026603946
Minnesota,SHERBURNE,64417,61935,542,709,2482,0.961469798,0.038530202,0.011006411
Minnesota,SIBLEY,15356,14337,15,834,1019,0.933641573,0.066358427,0.054311018
Minnesota,STEARNS,133166,126764,1064,1827,6402,0.951924665,0.048075335,0.013719718
Minnesota,STEELE,33680,31414,357,1266,2266,0.932719715,0.067280285,0.037589074
Minnesota,STEVENS,10053,9627,92,90,426,0.95762459,0.04237541,0.008952551
Minnesota,SWIFT,11956,10728,319,320,1228,0.897290064,0.102709936,0.026764804
Minnesota,TODD,24426,23603,27,463,823,0.966306395,0.033693605,0.018955212
Minnesota,TRAVERSE,4134,3946,1,50,188,0.954523464,0.045476536,0.012094823
Minnesota,WABASHA,21610,20968,53,364,642,0.970291532,0.029708468,0.016844054
Minnesota,WADENA,13713,13340,65,128,373,0.972799533,0.027200467,0.009334208
Minnesota,WASECA,19526,18198,435,566,1328,0.931988118,0.068011882,0.028986992
Minnesota,WASHINGTON,201130,186133,3612,3892,14997,0.925436285,0.074563715,0.019350669
Minnesota,WATONWAN,11876,9848,36,1804,2028,0.829235433,0.170764567,0.151902998
Minnesota,WILKIN,7138,6912,11,110,226,0.96833847,0.03166153,0.015410479
Minnesota,WINONA,49985,47522,384,686,2463,0.950725218,0.049274782,0.013724117
Minnesota,WRIGHT,89986,87489,232,994,2497,0.972251239,0.027748761,0.011046163
Minnesota,YELLOW MEDICINE,11080,10569,9,195,511,0.953880866,0.046119134,0.017599278
Mississippi,ADAMS,34340,15701,18026,273,18639,0.457221899,0.542778101,0.007949913
Mississippi,ALCORN,34558,29977,3814,443,4581,0.867440245,0.132559755,0.012819029
Mississippi,AMITE,13599,7636,5756,113,5963,0.561511876,0.438488124,0.008309435
Mississippi,ATTALA,19661,11369,7826,280,8292,0.578251361,0.421748639,0.014241392
Mississippi,BENTON,8026,4936,2919,84,3090,0.615001246,0.384998754,0.010465986
Mississippi,BOLIVAR,40633,13365,26345,477,27268,0.328919843,0.671080157,0.011739227
Mississippi,CALHOUN,15069,10339,4308,318,4730,0.686110558,0.313889442,0.021102927
Mississippi,CARROLL,10769,6705,3926,79,4064,0.622620485,0.377379515,0.007335871
Mississippi,CHICKASAW,19440,10887,7967,445,8553,0.560030864,0.439969136,0.022890947
Mississippi,CHOCTAW,9758,6613,2980,79,3145,0.677700348,0.322299652,0.008095921
Mississippi,CLAIBORNE,11831,1783,9892,94,10048,0.150705773,0.849294227,0.007945229
Mississippi,CLARKE,17955,11518,6220,120,6437,0.64149262,0.35850738,0.006683375
Mississippi,CLAY,21979,9332,12331,190,12647,0.424587106,0.575412894,0.008644615
Mississippi,COAHOMA,30622,8898,21099,276,21724,0.290575403,0.709424597,0.009013128
Mississippi,COPIAH,28757,13627,14577,332,15130,0.473867232,0.526132768,0.011545015
Mississippi,COVINGTON,19407,12249,6860,155,7158,0.631164013,0.368835987,0.007986809
Mississippi,DESOTO,107199,90816,12166,2516,16383,0.847172082,0.152827918,0.023470368
Mississippi,FORREST,72604,46225,24225,912,26379,0.636672911,0.363327089,0.012561291
Mississippi,FRANKLIN,8448,5286,3048,45,3162,0.625710227,0.374289773,0.005326705
Mississippi,GEORGE,19144,16976,1681,307,2168,0.88675303,0.11324697,0.016036356
Mississippi,GREENE,13299,9637,3467,106,3662,0.72464095,0.27535905,0.007970524
Mississippi,GRENADA,23263,13414,9480,145,9849,0.576623823,0.423376177,0.006233074
Mississippi,HANCOCK,42967,38180,2925,775,4787,0.888588917,0.111411083,0.018037098
Mississippi,HARRISON,189601,136141,39694,4910,53460,0.718039462,0.281960538,0.025896488
Mississippi,HINDS,250800,92804,152652,1978,157996,0.370031898,0.629968102,0.007886762
Mississippi,HOLMES,21609,4395,16850,194,17214,0.203387477,0.796612523,0.008977741
Mississippi,HUMPHREYS,11206,3006,7955,168,8200,0.268249152,0.731750848,0.014991969
Mississippi,ISSAQUENA,2274,822,1426,10,1452,0.361477573,0.638522427,0.004397537
Mississippi,ITAWAMBA,22770,20942,1449,226,1828,0.919718928,0.080281072,0.00992534
Mississippi,JACKSON,131420,97461,27308,2807,33959,0.741599452,0.258400548,0.021359002
Mississippi,JASPER,18149,8378,9561,117,9771,0.46162323,0.53837677,0.006446636
Mississippi,JEFFERSON,9740,1263,8373,64,8477,0.129671458,0.870328542,0.006570842
Mississippi,JEFFERSON DAVIS,13962,5781,7961,107,8181,0.414052428,0.585947572,0.007663659
Mississippi,JONES,64958,45955,17032,1271,19003,0.707457126,0.292542874,0.019566489
Mississippi,KEMPER,10453,4068,6028,76,6385,0.389170573,0.610829427,0.00727064
Mississippi,LAFAYETTE,38744,27611,9647,427,11133,0.712652282,0.287347718,0.011021061
Mississippi,LAMAR,39070,33090,5027,426,5980,0.846941387,0.153058613,0.010903507
Mississippi,LAUDERDALE,78161,46587,29706,888,31574,0.596038945,0.403961055,0.011361165
Mississippi,LAWRENCE,13258,8835,4233,89,4423,0.666390104,0.333609896,0.006712928
Mississippi,LEAKE,20940,11631,7793,440,9309,0.555444126,0.444555874,0.021012416
Mississippi,LEE,75755,55367,18495,882,20388,0.73086925,0.26913075,0.011642796
Mississippi,LEFLORE,37947,11238,25526,720,26709,0.296149893,0.703850107,0.018973832
Mississippi,LINCOLN,33166,22866,9807,229,10300,0.689440994,0.310559006,0.006904661
Mississippi,LOWNDES,61586,34489,25486,684,27097,0.560013639,0.439986361,0.01110642
Mississippi,MADISON,74674,44613,27897,742,30061,0.597436859,0.402563141,0.009936524
Mississippi,MARION,25595,17063,8106,158,8532,0.666653643,0.333346357,0.006173081
Mississippi,MARSHALL,34993,16774,17496,425,18219,0.479353013,0.520646987,0.012145286
Mississippi,MONROE,38014,25832,11652,261,12182,0.679539117,0.320460883,0.006865892
Mississippi,MONTGOMERY,12189,6570,5437,103,5619,0.539010583,0.460989417,0.008450242
Mississippi,NESHOBA,28684,18630,5515,332,10054,0.649491005,0.350508995,0.011574397
Mississippi,NEWTON,21838,14095,6617,198,7743,0.645434564,0.354565436,0.009066764
Mississippi,NOXUBEE,12548,3667,8634,141,8881,0.292237807,0.707762193,0.01123685
Mississippi,OKTIBBEHA,42902,24973,15994,461,17929,0.582094075,0.417905925,0.01074542
Mississippi,PANOLA,34274,17191,16478,384,17083,0.501575538,0.498424462,0.011203828
Mississippi,PEARL RIVER,48621,41181,5888,686,7440,0.8469797,0.1530203,0.01410913
Mississippi,PERRY,12138,9194,2713,122,2944,0.757455924,0.242544076,0.010051079
Mississippi,PIKE,38940,19841,18433,284,19099,0.509527478,0.490472522,0.007293272
Mississippi,PONTOTOC,26726,22336,3711,481,4390,0.835740477,0.164259523,0.017997456
Mississippi,PRENTISS,25556,21845,3285,176,3711,0.854789482,0.145210518,0.006886837
Mississippi,QUITMAN,10117,3065,6919,55,7052,0.302955422,0.697044578,0.005436394
Mississippi,RANKIN,115327,92552,19669,1520,22775,0.802518057,0.197481943,0.013179915
Mississippi,SCOTT,28423,15546,10944,1660,12877,0.546951413,0.453048587,0.058403406
Mississippi,SHARKEY,6580,1911,4527,86,4669,0.290425532,0.709574468,0.013069909
Mississippi,SIMPSON,27639,17686,9432,318,9953,0.639892905,0.360107095,0.011505481
Mississippi,SMITH,16182,12268,3728,96,3914,0.758126313,0.241873687,0.005932518
Mississippi,STONE,13622,10724,2591,170,2898,0.78725591,0.21274409,0.012479812
Mississippi,SUNFLOWER,34369,9799,23871,448,24570,0.285111583,0.714888417,0.013035002
Mississippi,TALLAHATCHIE,14903,5867,8784,137,9036,0.393679125,0.606320875,0.00919278
Mississippi,TATE,25370,17093,7844,223,8277,0.673748522,0.326251478,0.008789909
Mississippi,TIPPAH,20826,16890,3306,434,3936,0.811005474,0.188994526,0.020839335
Mississippi,TISHOMINGO,19163,18067,595,343,1096,0.94280645,0.05719355,0.017899076
Mississippi,TUNICA,9227,2482,6414,233,6745,0.268993172,0.731006828,0.025251978
Mississippi,UNION,25362,20969,3784,413,4393,0.826788108,0.173211892,0.016284205
Mississippi,WALTHALL,15156,8208,6593,201,6948,0.541567696,0.458432304,0.013262074
Mississippi,WARREN,49644,27049,21341,514,22595,0.544859399,0.455140601,0.010353718
Mississippi,WASHINGTON,62977,21243,40495,531,41734,0.337313622,0.662686378,0.00843165
Mississippi,WAYNE,21216,12955,8017,134,8261,0.610624057,0.389375943,0.006315988
Mississippi,WEBSTER,10294,7919,2134,174,2375,0.769283078,0.230716922,0.01690305
Mississippi,WILKINSON,10312,3202,7015,45,7110,0.310512025,0.689487975,0.004363848
Mississippi,WINSTON,20160,11024,8687,243,9136,0.546825397,0.453174603,0.012053571
Mississippi,YALOBUSHA,13051,7827,5006,127,5224,0.599724159,0.400275841,0.009731055
Mississippi,YAZOO,28149,11558,15074,1233,16591,0.410600732,0.589399268,0.043802622
Missouri,ADAIR,24977,23738,291,315,1239,0.950394363,0.049605637,0.012611603
Missouri,ANDREW,16492,16129,67,138,363,0.977989328,0.022010672,0.008367693
Missouri,ATCHISON,6430,6211,132,43,219,0.965940902,0.034059098,0.006687403
Missouri,AUDRAIN,25853,23425,1849,189,2428,0.9060844,0.0939156,0.007310564
Missouri,BARRY,34010,31486,30,1713,2524,0.925786533,0.074213467,0.050367539
Missouri,BARTON,12541,12078,36,119,463,0.963081094,0.036918906,0.009488876
Missouri,BATES,16653,16114,101,179,539,0.967633459,0.032366541,0.010748814
Missouri,BENTON,17180,16709,24,153,471,0.9725844,0.0274156,0.008905704
Missouri,BOLLINGER,12029,11714,25,68,315,0.973813285,0.026186715,0.005653005
Missouri,BOONE,135454,114367,11479,2413,21087,0.844323534,0.155676466,0.017814166
Missouri,BUCHANAN,85998,78406,3714,2086,7592,0.911718877,0.088281123,0.024256378
Missouri,BUTLER,40867,37435,2105,412,3432,0.916020261,0.083979739,0.010081484
Missouri,CALDWELL,8969,8786,12,67,183,0.979596388,0.020403612,0.007470175
Missouri,CALLAWAY,40766,37191,2303,377,3575,0.912304371,0.087695629,0.009247903
Missouri,CAMDEN,37051,35954,94,346,1097,0.970392162,0.029607838,0.009338479
Missouri,CAPE GIRARDEAU,68693,62926,3607,624,5767,0.916046759,0.083953241,0.009083895
Missouri,CARROLL,10285,9919,177,73,366,0.964414195,0.035585805,0.007097715
Missouri,CARTER,5941,5685,3,72,256,0.956909611,0.043090389,0.012119172
Missouri,CASS,82092,77284,1147,1816,4808,0.941431565,0.058568435,0.022121522
Missouri,CEDAR,13733,13180,44,153,553,0.959732032,0.040267968,0.011141047
Missouri,CHARITON,8438,8067,264,47,371,0.956032235,0.043967765,0.00557004
Missouri,CHRISTIAN,54285,52409,139,714,1876,0.965441651,0.034558349,0.013152805
Missouri,CLARK,7416,7294,5,52,122,0.983549083,0.016450917,0.007011866
Missouri,CLAY,184006,166445,4794,6594,17561,0.904562895,0.095437105,0.035835788
Missouri,CLINTON,18979,18191,284,205,788,0.958480426,0.041519574,0.010801412
Missouri,COLE,71397,61684,7049,915,9713,0.863957869,0.136042131,0.012815665
Missouri,COOPER,16670,14762,1482,143,1908,0.885542891,0.114457109,0.008578284
Missouri,CRAWFORD,22804,22281,32,176,523,0.977065427,0.022934573,0.007717944
Missouri,DADE,7923,7670,21,67,253,0.968067651,0.031932349,0.008456393
Missouri,DALLAS,15661,15164,19,147,497,0.968265117,0.031734883,0.009386374
Missouri,DAVIESS,8016,7877,4,55,139,0.982659681,0.017340319,0.006861277
Missouri,DEKALB,11597,10250,1020,125,1347,0.883849271,0.116150729,0.01077865
Missouri,DENT,14927,14420,55,112,507,0.966034702,0.033965298,0.007503182
Missouri,DOUGLAS,13084,12607,14,110,477,0.963543259,0.036456741,0.008407215
Missouri,DUNKLIN,33155,28963,2873,824,4192,0.873563565,0.126436435,0.024852963
Missouri,FRANKLIN,93807,90993,880,678,2814,0.970002239,0.029997761,0.007227606
Missouri,GASCONADE,15342,15101,17,64,241,0.984291487,0.015708513,0.004171555
Missouri,GENTRY,6861,6723,8,44,138,0.979886314,0.020113686,0.006413059
Missouri,GREENE,240391,222447,5322,4434,17944,0.925354943,0.074645057,0.01844495
Missouri,GRUNDY,10432,10088,41,165,344,0.96702454,0.03297546,0.015816718
Missouri,HARRISON,8850,8654,12,89,196,0.977853107,0.022146893,0.010056497
Missouri,HENRY,21997,21157,212,201,840,0.961812974,0.038187026,0.00913761
Missouri,HICKORY,8940,8675,7,68,265,0.970357942,0.029642058,0.007606264
Missouri,HOLT,5351,5255,5,21,96,0.982059428,0.017940572,0.0039245
Missouri,HOWARD,10212,9267,694,88,945,0.90746181,0.09253819,0.008617313
Missouri,HOWELL,37238,35623,114,450,1615,0.956630324,0.043369676,0.01208443
Missouri,IRON,10697,10314,163,62,383,0.964195569,0.035804431,0.005796018
Missouri,JACKSON,654880,443427,151333,35160,211453,0.677111837,0.322888163,0.053689226
Missouri,JASPER,104686,95336,1520,3615,9350,0.910685287,0.089314713,0.034531838
Missouri,JEFFERSON,198099,191753,1340,2002,6346,0.967965512,0.032034488,0.010106058
Missouri,JOHNSON,48258,42803,2064,1407,5455,0.886961747,0.113038253,0.029155788
Missouri,KNOX,4361,4277,4,26,84,0.980738363,0.019261637,0.005961935
Missouri,LACLEDE,32513,31296,138,401,1217,0.962568819,0.037431181,0.012333528
Missouri,LAFAYETTE,32960,31290,745,386,1670,0.949332524,0.050667476,0.011711165
Missouri,LAWRENCE,35204,33213,68,1195,1991,0.943443927,0.056556073,0.033945006
Missouri,LEWIS,10494,10032,264,77,462,0.955974843,0.044025157,0.007337526
Missouri,LINCOLN,38944,37184,672,444,1760,0.954806902,0.045193098,0.011400986
Missouri,LINN,13754,13406,82,104,348,0.97469827,0.02530173,0.007561437
Missouri,LIVINGSTON,14558,13911,331,94,647,0.955557082,0.044442918,0.006456931
Missouri,MCDONALD,21681,18348,33,2030,3333,0.846270928,0.153729072,0.093630368
Missouri,MACON,15762,15071,347,121,691,0.956160386,0.043839614,0.007676691
Missouri,MADISON,11800,11552,15,66,248,0.978983051,0.021016949,0.00559322
Missouri,MARIES,8903,8609,29,103,294,0.966977423,0.033022577,0.011569134
Missouri,MARION,28289,26236,1303,252,2053,0.927427622,0.072572378,0.008908056
Missouri,MERCER,3757,3704,7,11,53,0.985893,0.014107,0.002927868
Missouri,MILLER,23564,22934,63,231,630,0.973264301,0.026735699,0.009803089
Missouri,MISSISSIPPI,13427,10411,2735,129,3016,0.77537797,0.22462203,0.009607507
Missouri,MONITEAU,14827,13556,557,435,1271,0.914278006,0.085721994,0.029338369
Missouri,MONROE,9311,8769,357,52,542,0.941789281,0.058210719,0.005584792
Missouri,MONTGOMERY,12136,11596,245,94,540,0.955504285,0.044495715,0.00774555
Missouri,MORGAN,19309,18693,97,161,616,0.968097778,0.031902222,0.008338081
Missouri,NEW MADRID,19760,16345,3024,183,3415,0.827176113,0.172823887,0.009261134
Missouri,NEWTON,52636,48642,298,1147,3994,0.924120374,0.075879626,0.02179117
Missouri,NODAWAY,21912,21067,294,155,845,0.961436656,0.038563344,0.00707375
Missouri,OREGON,10344,9696,10,113,648,0.937354988,0.062645012,0.010924207
Missouri,OSAGE,13062,12828,16,77,234,0.982085439,0.017914561,0.005894962
Missouri,OZARK,9542,9249,14,90,293,0.969293649,0.030706351,0.009431985
Missouri,PEMISCOT,20047,14244,5231,315,5803,0.710530254,0.289469746,0.015713074
Missouri,PERRY,18132,17739,33,93,393,0.978325612,0.021674388,0.005129054
Missouri,PETTIS,39403,35810,1181,1527,3593,0.90881405,0.09118595,0.038753394
Missouri,PHELPS,39825,36884,586,485,2941,0.926151915,0.073848085,0.01217828
Missouri,PIKE,18351,16110,1672,295,2241,0.877881314,0.122118686,0.016075418
Missouri,PLATTE,73781,66230,2542,2211,7551,0.897656578,0.102343422,0.029967065
Missouri,POLK,26992,26024,119,350,968,0.964137522,0.035862478,0.012966805
Missouri,PULASKI,41165,31200,4858,2404,9965,0.757925422,0.242074578,0.058399125
Missouri,PUTNAM,5223,5155,3,32,68,0.986980662,0.013019338,0.006126747
Missouri,RALLS,9626,9393,106,42,233,0.975794723,0.024205277,0.004363183
Missouri,RANDOLPH,24663,22164,1717,282,2499,0.898674127,0.101325873,0.011434132
Missouri,RAY,23354,22384,340,253,970,0.958465359,0.041534641,0.010833262
Missouri,REYNOLDS,6689,6366,32,55,323,0.951711766,0.048288234,0.008222455
Missouri,RIPLEY,13509,13019,5,132,490,0.963727885,0.036272115,0.009771264
Missouri,ST. CHARLES,283883,266158,7573,4176,17725,0.937562306,0.062437694,0.014710286
Missouri,ST. CLAIR,9652,9338,20,95,314,0.967467882,0.032532118,0.00984252
Missouri,STE. GENEVIEVE,17842,17404,124,132,438,0.975451183,0.024548817,0.007398274
Missouri,ST. FRANCOIS,55641,53228,1105,447,2413,0.956632699,0.043367301,0.008033644
Missouri,ST. LOUIS,1016315,772041,192544,14577,244274,0.759647353,0.240352647,0.014342994
Missouri,SALINE,23756,20923,1268,1050,2833,0.880745917,0.119254083,0.04419936
Missouri,SCHUYLER,4170,4086,2,27,84,0.979856115,0.020143885,0.00647482
Missouri,SCOTLAND,4983,4890,10,42,93,0.981336544,0.018663456,0.008428657
Missouri,SCOTT,40422,35221,4217,448,5201,0.871332443,0.128667557,0.011083074
Missouri,SHANNON,8324,7864,14,77,460,0.944738107,0.055261893,0.00925036
Missouri,SHELBY,6799,6628,66,43,171,0.974849243,0.025150757,0.006324459
Missouri,STODDARD,29705,28772,268,231,933,0.968591146,0.031408854,0.007776469
Missouri,STONE,28658,27797,17,298,861,0.969956033,0.030043967,0.010398493
Missouri,SULLIVAN,7219,6508,9,634,711,0.901509904,0.098490096,0.087823798
Missouri,TANEY,39703,37651,129,962,2052,0.948316248,0.051683752,0.024229907
Missouri,TEXAS,23003,22034,47,221,969,0.95787506,0.04212494,0.009607443
Missouri,VERNON,20454,19742,125,172,712,0.965190183,0.034809817,0.008409113
Missouri,WARREN,24525,23330,474,314,1195,0.95127421,0.04872579,0.012803262
Missouri,WASHINGTON,23344,22159,577,170,1185,0.949237491,0.050762509,0.007282385
Missouri,WAYNE,13259,12899,21,65,360,0.972848631,0.027151369,0.00490233
Missouri,WEBSTER,31045,29607,358,400,1438,0.953680142,0.046319858,0.012884522
Missouri,WORTH,2382,2351,4,7,31,0.986985726,0.013014274,0.002938707
Missouri,WRIGHT,17955,17440,49,139,515,0.971317182,0.028682818,0.007741576
Missouri,ST. LOUIS CITY,348189,149329,177446,7022,198860,0.428873399,0.571126601,0.020167208
Montana,BEAVERHEAD,9202,8687,12,246,515,0.944033906,0.055966094,0.026733319
Montana,BIG HORN,12671,4457,4,465,8214,0.351748086,0.648251914,0.036697972
Montana,BLAINE,7009,3670,10,70,3339,0.523612498,0.476387502,0.009987159
Montana,BROADWATER,4385,4214,12,58,171,0.961003421,0.038996579,0.01322691
Montana,CARBON,9552,9188,22,169,364,0.961892797,0.038107203,0.01769263
Montana,CARTER,1360,1339,1,8,21,0.984558824,0.015441176,0.005882353
Montana,CASCADE,80357,71880,846,1949,8477,0.894508257,0.105491743,0.024254265
Montana,CHOUTEAU,5970,5009,2,40,961,0.839028476,0.160971524,0.006700168
Montana,CUSTER,11696,11228,11,177,468,0.95998632,0.04001368,0.015133379
Montana,DANIELS,2017,1931,0,32,86,0.957362419,0.042637581,0.015865146
Montana,DAWSON,9059,8786,23,81,273,0.969864223,0.030135777,0.008941384
Montana,DEER LODGE,9417,8914,16,155,503,0.946585962,0.053414038,0.016459594
Montana,FALLON,2837,2790,4,11,47,0.983433204,0.016566796,0.003877335
Montana,FERGUS,11893,11496,10,96,397,0.96661902,0.03338098,0.008071975
Montana,FLATHEAD,74471,71046,108,1061,3425,0.954008943,0.045991057,0.014247157
Montana,GALLATIN,67831,64672,148,1047,3159,0.953428373,0.046571627,0.01543542
Montana,GARFIELD,1279,1264,1,5,15,0.988272088,0.011727912,0.003909304
Montana,GLACIER,13247,4675,11,159,8572,0.352910093,0.647089907,0.012002718
Montana,GOLDEN VALLEY,1042,1020,0,13,22,0.978886756,0.021113244,0.012476008
Montana,GRANITE,2830,2696,0,36,134,0.952650177,0.047349823,0.012720848
Montana,HILL,16673,13191,15,208,3482,0.791159359,0.208840641,0.012475259
Montana,JEFFERSON,10049,9564,13,149,485,0.951736491,0.048263509,0.014827346
Montana,JUDITH BASIN,2329,2286,1,13,43,0.98153714,0.01846286,0.005581795
Montana,LAKE,26507,18704,30,668,7803,0.705624929,0.294375071,0.02520089
Montana,LEWIS AND CLARK,55716,52571,104,843,3145,0.943553019,0.056446981,0.015130304
Montana,LIBERTY,2158,2138,0,4,20,0.990732159,0.009267841,0.001853568
Montana,LINCOLN,18837,17917,19,271,920,0.951159951,0.048840049,0.01438658
Montana,MCCONE,1977,1903,6,19,74,0.96256955,0.03743045,0.009610521
Montana,MADISON,6851,6575,3,130,276,0.95971391,0.04028609,0.018975332
Montana,MEAGHER,1932,1870,0,29,62,0.967908903,0.032091097,0.015010352
Montana,MINERAL,3884,3637,8,61,247,0.936405767,0.063594233,0.015705458
Montana,MISSOULA,95802,89226,255,1543,6576,0.931358427,0.068641573,0.016106136
Montana,MUSSELSHELL,4497,4314,3,72,183,0.959306204,0.040693796,0.016010674
Montana,PARK,15694,14994,58,288,700,0.955396967,0.044603033,0.018350962
Montana,PETROLEUM,493,484,0,6,9,0.981744422,0.018255578,0.012170385
Montana,PHILLIPS,4601,4085,5,53,516,0.887850467,0.112149533,0.011519235
Montana,PONDERA,6424,5347,6,54,1077,0.832347447,0.167652553,0.008405978
Montana,POWDER RIVER,1858,1803,0,11,55,0.970398278,0.029601722,0.005920344
Montana,POWELL,7180,6568,35,140,612,0.914763231,0.085236769,0.019498607
Montana,PRAIRIE,1199,1171,0,8,28,0.976647206,0.023352794,0.006672227
Montana,RAVALLI,36070,34449,45,678,1621,0.955059606,0.044940394,0.018796784
Montana,RICHLAND,9667,9221,9,209,446,0.95386366,0.04613634,0.021619944
Montana,ROOSEVELT,10620,4331,5,131,6289,0.407815443,0.592184557,0.012335217
Montana,ROSEBUD,9383,5959,21,219,3424,0.635084728,0.364915272,0.023340083
Montana,SANDERS,10227,9299,13,159,928,0.909259802,0.090740198,0.015547081
Montana,SHERIDAN,4105,3958,4,44,147,0.964190012,0.035809988,0.010718636
Montana,SILVER BOW,34606,32410,45,950,2196,0.936542796,0.063457204,0.027451887
Montana,STILLWATER,8195,7860,10,165,335,0.959121415,0.040878585,0.020134228
Montana,SWEET GRASS,3609,3467,2,54,142,0.960653921,0.039346079,0.014962594
Montana,TETON,6445,6164,12,73,281,0.95640031,0.04359969,0.01132661
Montana,TOOLE,5267,4912,8,61,355,0.932599203,0.067400797,0.011581545
Montana,TREASURE,861,823,1,13,38,0.955865273,0.044134727,0.015098722
Montana,VALLEY,7675,6741,10,60,934,0.878306189,0.121693811,0.00781759
Montana,WHEATLAND,2259,2177,3,25,82,0.963700753,0.036299247,0.011066844
Montana,WIBAUX,1068,1044,2,4,24,0.97752809,0.02247191,0.003745318
Montana,YELLOWSTONE,129352,117698,542,4788,11654,0.909904756,0.090095244,0.037015276
Nebraska,ADAMS,31151,28735,184,1428,2416,0.922442297,0.077557703,0.045841225
Nebraska,ANTELOPE,7452,7343,4,52,109,0.985373054,0.014626946,0.006977992
Nebraska,ARTHUR,444,425,0,6,19,0.957207207,0.042792793,0.013513514
Nebraska,BANNER,819,769,1,46,50,0.938949939,0.061050061,0.056166056
Nebraska,BLAINE,583,576,0,1,7,0.987993139,0.012006861,0.001715266
Nebraska,BOONE,6259,6181,3,56,78,0.987537945,0.012462055,0.008947116
Nebraska,BOX BUTTE,12158,10663,41,930,1495,0.877035697,0.122964303,0.076492844
Nebraska,BOYD,2438,2409,0,2,29,0.988105004,0.011894996,0.000820345
Nebraska,BROWN,3525,3459,1,29,66,0.981276596,0.018723404,0.00822695
Nebraska,BUFFALO,42259,39313,229,1970,2946,0.930287039,0.069712961,0.046617289
Nebraska,BURT,7791,7538,12,98,253,0.967526633,0.032473367,0.012578616
Nebraska,BUTLER,8767,8556,6,145,211,0.975932474,0.024067526,0.016539295
Nebraska,CASS,24334,23571,43,355,763,0.968644695,0.031355305,0.014588641
Nebraska,CEDAR,9615,9505,10,41,110,0.988559542,0.011440458,0.004264171
Nebraska,CHASE,4068,3900,7,139,168,0.958702065,0.041297935,0.034169125
Nebraska,CHERRY,6148,5769,4,57,379,0.938353936,0.061646064,0.009271308
Nebraska,CHEYENNE,9830,9235,11,438,595,0.939471007,0.060528993,0.044557477
Nebraska,CLAY,7039,6726,8,245,313,0.955533456,0.044466544,0.03480608
Nebraska,COLFAX,10441,7617,5,2732,2824,0.729527823,0.270472177,0.26166076
Nebraska,CUMING,10203,9552,7,559,651,0.936195237,0.063804763,0.054787808
Nebraska,CUSTER,11793,11553,8,108,240,0.979648944,0.020351056,0.009157975
Nebraska,DAKOTA,20253,14368,111,4581,5885,0.709425764,0.290574236,0.226188713
Nebraska,DAWES,9060,8372,70,220,688,0.92406181,0.07593819,0.024282561
Nebraska,DAWSON,24365,17746,58,6178,6619,0.728339832,0.271660168,0.253560435
Nebraska,DEUEL,2098,2014,1,57,84,0.959961868,0.040038132,0.027168732
Nebraska,DIXON,6339,5927,2,348,412,0.935005521,0.064994479,0.054898249
Nebraska,DODGE,36160,34110,145,1421,2050,0.943307522,0.056692478,0.039297566
Nebraska,DOUGLAS,463585,362528,52821,30928,101057,0.782009772,0.217990228,0.066714842
Nebraska,DUNDY,2292,2171,1,74,121,0.947207679,0.052792321,0.032286213
Nebraska,FILLMORE,6634,6442,13,110,192,0.971058185,0.028941815,0.016581248
Nebraska,FRANKLIN,3574,3527,0,23,47,0.986849468,0.013150532,0.006435367
Nebraska,FRONTIER,3099,3036,3,30,63,0.979670862,0.020329138,0.009680542
Nebraska,FURNAS,5324,5197,2,61,127,0.976145755,0.023854245,0.011457551
Nebraska,GAGE,22993,22354,69,196,639,0.972208933,0.027791067,0.008524333
Nebraska,GARDEN,2292,2230,2,33,62,0.972949389,0.027050611,0.014397906
Nebraska,GARFIELD,1902,1867,0,19,35,0.981598318,0.018401682,0.009989485
Nebraska,GOSPER,2143,2101,0,27,42,0.980401307,0.019598693,0.01259916
Nebraska,GRANT,747,734,0,10,13,0.982597055,0.017402945,0.013386881
Nebraska,GREELEY,2714,2657,18,23,57,0.978997789,0.021002211,0.008474576
Nebraska,HALL,53534,44818,159,7497,8716,0.837187582,0.162812418,0.140041843
Nebraska,HAMILTON,9403,9212,17,107,191,0.979687334,0.020312666,0.011379347
Nebraska,HARLAN,3786,3729,5,29,57,0.984944532,0.015055468,0.007659799
Nebraska,HAYES,1068,1030,2,27,38,0.964419476,0.035580524,0.025280899
Nebraska,HITCHCOCK,3111,3031,3,44,80,0.974284796,0.025715204,0.014143362
Nebraska,HOLT,11551,11377,3,82,174,0.984936369,0.015063631,0.007098952
Nebraska,HOOKER,783,766,0,8,17,0.978288633,0.021711367,0.010217114
Nebraska,HOWARD,6567,6438,19,66,129,0.980356327,0.019643673,0.010050251
Nebraska,JEFFERSON,8333,8139,4,109,194,0.976719069,0.023280931,0.013080523
Nebraska,JOHNSON,4488,4167,5,129,321,0.928475936,0.071524064,0.028743316
Nebraska,KEARNEY,6882,6659,9,161,223,0.967596629,0.032403371,0.023394362
Nebraska,KEITH,8875,8386,7,375,489,0.944901408,0.055098592,0.042253521
Nebraska,KEYA PAHA,983,941,0,38,42,0.957273652,0.042726348,0.038657172
Nebraska,KIMBALL,4089,3866,9,136,223,0.945463438,0.054536562,0.033259966
Nebraska,KNOX,9374,8559,8,85,815,0.913057393,0.086942607,0.009067634
Nebraska,LANCASTER,250291,222067,6892,8437,28224,0.887235258,0.112764742,0.033708763
Nebraska,LINCOLN,34632,32072,179,1880,2560,0.926079926,0.073920074,0.054285054
Nebraska,LOGAN,774,756,1,7,18,0.976744186,0.023255814,0.009043928
Nebraska,LOUP,712,696,0,12,16,0.97752809,0.02247191,0.016853933
Nebraska,MCPHERSON,533,518,0,8,15,0.971857411,0.028142589,0.015009381
Nebraska,MADISON,35226,31122,318,3042,4104,0.883495146,0.116504854,0.086356668
Nebraska,MERRICK,8204,7973,17,168,231,0.971843003,0.028156997,0.020477816
Nebraska,MORRILL,5440,4820,2,549,620,0.886029412,0.113970588,0.100919118
Nebraska,NANCE,4038,3954,0,46,84,0.979197623,0.020802377,0.011391778
Nebraska,NEMAHA,7576,7358,27,76,218,0.971224921,0.028775079,0.010031679
Nebraska,NUCKOLLS,5057,4979,1,51,78,0.984575835,0.015424165,0.010085031
Nebraska,OTOE,15396,14822,38,377,574,0.962717589,0.037282411,0.02448688
Nebraska,PAWNEE,3087,3042,0,21,45,0.985422741,0.014577259,0.006802721
Nebraska,PERKINS,3200,3090,1,74,110,0.965625,0.034375,0.023125
Nebraska,PHELPS,9747,9418,10,220,329,0.966246024,0.033753976,0.022571048
Nebraska,PIERCE,7857,7714,6,56,143,0.981799669,0.018200331,0.007127402
Nebraska,PLATTE,31662,29126,93,2072,2536,0.919903986,0.080096014,0.065441223
Nebraska,POLK,5639,5543,1,61,96,0.982975705,0.017024295,0.010817521
Nebraska,RED WILLOW,11448,11020,16,281,428,0.962613557,0.037386443,0.024545772
Nebraska,RICHARDSON,9531,9062,16,100,469,0.950792152,0.049207848,0.010492078
Nebraska,ROCK,1756,1735,0,9,21,0.988041002,0.011958998,0.005125285
Nebraska,SALINE,13843,12496,43,911,1347,0.902694503,0.097305497,0.065809434
Nebraska,SARPY,122595,106823,5231,5358,15772,0.87134875,0.12865125,0.043704882
Nebraska,SAUNDERS,19830,19410,21,205,420,0.97881997,0.02118003,0.010337872
Nebraska,SCOTTS BLUFF,36951,29457,87,6352,7494,0.797190874,0.202809126,0.171903331
Nebraska,SEWARD,16496,16077,47,179,419,0.974599903,0.025400097,0.010851115
Nebraska,SHERIDAN,6198,5430,3,91,768,0.876089061,0.123910939,0.014682156
Nebraska,SHERMAN,3318,3253,2,34,65,0.980409885,0.019590115,0.010247137
Nebraska,SIOUX,1475,1424,0,34,51,0.965423729,0.034576271,0.023050847
Nebraska,STANTON,6455,6198,27,149,257,0.960185902,0.039814098,0.023082881
Nebraska,THAYER,6055,5942,1,61,113,0.981337737,0.018662263,0.010074319
Nebraska,THOMAS,729,720,0,6,9,0.987654321,0.012345679,0.008230453
Nebraska,THURSTON,7171,3262,9,174,3909,0.454887742,0.545112258,0.024264398
Nebraska,VALLEY,4647,4531,2,75,116,0.975037659,0.024962341,0.016139445
Nebraska,WASHINGTON,18780,18313,62,202,467,0.97513312,0.02486688,0.010756124
Nebraska,WAYNE,9851,9475,91,146,376,0.961831286,0.038168714,0.01482083
Nebraska,WEBSTER,4061,3971,6,22,90,0.977837971,0.022162029,0.005417385
Nebraska,WHEELER,886,878,0,5,8,0.990970655,0.009029345,0.005643341
Nebraska,YORK,14598,14053,137,205,545,0.962666119,0.037333881,0.01404302
Nevada,CHURCHILL,23982,19156,375,2076,4826,0.798765741,0.201234259,0.086564924
Nevada,CLARK,1375765,828669,121401,302143,547096,0.602333247,0.397666753,0.219618176
Nevada,DOUGLAS,41259,36231,122,3057,5028,0.878135679,0.121864321,0.074092925
Nevada,ELKO,45291,32771,257,8935,12520,0.723565388,0.276434612,0.197279813
Nevada,ESMERALDA,971,781,1,99,190,0.804325438,0.195674562,0.101956746
Nevada,EUREKA,1651,1402,6,158,249,0.849182314,0.150817686,0.095699576
Nevada,HUMBOLDT,16106,11985,78,3040,4121,0.744132621,0.255867379,0.188749534
Nevada,LANDER,5794,4385,10,1073,1409,0.756817397,0.243182603,0.185191577
Nevada,LINCOLN,4165,3709,71,221,456,0.890516206,0.109483794,0.053061224
Nevada,LYON,34501,28791,202,3784,5710,0.834497551,0.165502449,0.10967798
Nevada,MINERAL,5071,3555,235,428,1516,0.701045159,0.298954841,0.084401499
Nevada,NYE,32485,27511,373,2713,4974,0.846883177,0.153116823,0.083515469
Nevada,PERSHING,6693,4663,356,1294,2030,0.696698043,0.303301957,0.193336322
Nevada,STOREY,3399,3058,9,174,341,0.899676375,0.100323625,0.051191527
Nevada,WASHOE,339486,247835,6734,56301,91651,0.730030104,0.269969896,0.16584189
Nevada,WHITE PINE,9181,7295,370,1008,1886,0.794575754,0.205424246,0.109791962
Nevada,CARSON CITY,52457,41204,909,7466,11253,0.785481442,0.214518558,0.142326096
New Hampshire,BELKNAP,56325,54685,151,418,1640,0.970883267,0.029116733,0.007421216
New Hampshire,CARROLL,43666,42741,69,209,925,0.97881647,0.02118353,0.004786333
New Hampshire,CHESHIRE,73825,71809,250,529,2016,0.972692177,0.027307823,0.007165594
New Hampshire,COOS,33111,32337,36,201,774,0.976624083,0.023375917,0.00607049
New Hampshire,GRAFTON,81743,77730,419,914,4013,0.950907111,0.049092889,0.011181386
New Hampshire,HILLSBOROUGH,380841,351337,4493,12166,29504,0.92252935,0.07747065,0.03194509
New Hampshire,MERRIMACK,136225,131343,688,1362,4882,0.964162232,0.035837768,0.009998165
New Hampshire,ROCKINGHAM,277359,266424,1497,3314,10935,0.960574562,0.039425438,0.011948413
New Hampshire,STRAFFORD,112233,107364,658,1155,4869,0.956617038,0.043382962,0.010291091
New Hampshire,SULLIVAN,40458,39482,93,221,976,0.975876217,0.024123783,0.005462455
New Jersey,ATLANTIC,252552,161486,42691,30729,91066,0.639416833,0.360583167,0.121673952
New Jersey,BERGEN,884118,638953,44149,91377,245165,0.722701042,0.277298958,0.103353851
New Jersey,BURLINGTON,423394,323171,62476,17632,100223,0.763286679,0.236713321,0.041644426
New Jersey,CAMDEN,508932,344998,88017,49166,163934,0.67788624,0.32211376,0.096606226
New Jersey,CAPE MAY,102326,92137,4978,3378,10189,0.900426089,0.099573911,0.033012138
New Jersey,CUMBERLAND,146438,85510,28134,27823,60928,0.583933132,0.416066868,0.189998498
New Jersey,ESSEX,793633,298708,319883,122347,494925,0.376380518,0.623619482,0.154160676
New Jersey,GLOUCESTER,254673,218262,22562,6583,36411,0.857028425,0.142971575,0.025848834
New Jersey,HUDSON,608975,215216,74040,242123,393759,0.353406954,0.646593046,0.397591034
New Jersey,HUNTERDON,121989,112473,2638,3371,9516,0.921992967,0.078007033,0.027633639
New Jersey,MERCER,350761,225284,67922,33898,125477,0.642272088,0.357727912,0.096641303
New Jersey,MIDDLESEX,750162,464537,64435,101940,285625,0.619248909,0.380751091,0.135890648
New Jersey,MONMOUTH,615301,495902,47745,38175,119399,0.805950258,0.194049742,0.062042805
New Jersey,MORRIS,470212,385582,12506,36626,84630,0.820017354,0.179982646,0.077892525
New Jersey,OCEAN,510916,459174,14431,25638,51742,0.898726992,0.101273008,0.05018046
New Jersey,PASSAIC,489049,251687,60528,146492,237362,0.514645772,0.485354228,0.299544626
New Jersey,SALEM,64285,51171,9257,2498,13114,0.796002178,0.203997822,0.03885821
New Jersey,SOMERSET,297490,220584,21571,25811,76906,0.741483747,0.258516253,0.08676258
New Jersey,SUSSEX,144166,134624,1444,4822,9542,0.933812411,0.066187589,0.033447554
New Jersey,UNION,522541,283345,104926,103011,239196,0.542244532,0.457755468,0.19713477
New Jersey,WARREN,102437,94405,1838,3751,8032,0.921590831,0.078409169,0.036617628
New Mexico,BERNALILLO,556678,268972,13700,233565,287706,0.483173396,0.516826604,0.419569302
New Mexico,CATRON,3543,2687,9,679,856,0.758396839,0.241603161,0.191645498
New Mexico,CHAVES,61382,31970,1088,26904,29412,0.520836727,0.479163273,0.438304389
New Mexico,CIBOLA,25595,6325,231,8555,19270,0.247118578,0.752881422,0.33424497
New Mexico,COLFAX,14189,7081,41,6739,7108,0.499048559,0.500951441,0.47494538
New Mexico,CURRY,45044,26461,2935,13685,18583,0.587447829,0.412552171,0.303814048
New Mexico,DE BACA,2240,1407,1,790,833,0.628125,0.371875,0.352678571
New Mexico,DONA ANA,174682,56688,2261,110665,117994,0.32452113,0.67547887,0.63352263
New Mexico,EDDY,51658,29797,669,20023,21861,0.576812885,0.423187115,0.387606953
New Mexico,GRANT,31002,15048,113,15126,15954,0.485388039,0.514611961,0.487904006
New Mexico,GUADALUPE,4680,724,59,3801,3956,0.154700855,0.845299145,0.812179487
New Mexico,HARDING,810,428,3,364,382,0.528395062,0.471604938,0.449382716
New Mexico,HIDALGO,5932,2532,15,3324,3400,0.426837492,0.573162508,0.560350641
New Mexico,LEA,55511,29977,2340,22010,25534,0.540019095,0.459980905,0.396497991
New Mexico,LINCOLN,19411,13763,47,4975,5648,0.709030962,0.290969038,0.256297975
New Mexico,LOS ALAMOS,18343,15051,63,2155,3292,0.820530993,0.179469007,0.117483509
New Mexico,LUNA,25016,9921,183,14435,15095,0.396586185,0.603413815,0.5770307
New Mexico,MCKINLEY,74798,8902,287,9276,65896,0.119013877,0.880986123,0.124014011
New Mexico,MORA,5180,877,5,4229,4303,0.169305019,0.830694981,0.816409266
New Mexico,OTERO,62298,34728,2285,20033,27570,0.557449677,0.442550323,0.321567306
New Mexico,QUAY,10155,5953,78,3857,4202,0.586213688,0.413786312,0.3798129
New Mexico,RIO ARRIBA,41190,5619,85,30025,35571,0.136416606,0.863583394,0.728939063
New Mexico,ROOSEVELT,18018,11299,276,5998,6719,0.627095127,0.372904873,0.332889333
New Mexico,SANDOVAL,89908,45227,1418,26437,44681,0.503036437,0.496963563,0.294045024
New Mexico,SAN JUAN,113801,52922,429,17057,60879,0.46503985,0.53496015,0.149884447
New Mexico,SAN MIGUEL,30126,5690,185,23487,24436,0.188873398,0.811126602,0.779625573
New Mexico,SANTA FE,129292,58790,667,63405,70502,0.454707174,0.545292826,0.490401572
New Mexico,SIERRA,13270,9356,55,3488,3914,0.705048983,0.294951017,0.262848531
New Mexico,SOCORRO,18078,6796,91,8810,11282,0.375926541,0.624073459,0.48733267
New Mexico,TAOS,29979,10122,81,17370,19857,0.337636345,0.662363655,0.579405584
New Mexico,TORRANCE,16911,9677,255,6283,7234,0.572231092,0.427768908,0.371533322
New Mexico,UNION,4174,2618,0,1465,1556,0.6272161,0.3727839,0.350982271
New Mexico,VALENCIA,66152,26087,699,36371,40065,0.394349377,0.605650623,0.54980953
New York,ALBANY,294565,240913,31514,9079,53652,0.817860235,0.182139765,0.03082172
New York,ALLEGANY,49927,48222,349,454,1705,0.965850141,0.034149859,0.009093276
New York,BRONX,1332650,193651,416338,644705,1138999,0.145312723,0.854687277,0.483776686
New York,BROOME,200536,181339,6256,3986,19197,0.904271552,0.095728448,0.01987673
New York,CATTARAUGUS,83955,78934,839,791,5021,0.940194152,0.059805848,0.009421714
New York,CAYUGA,81963,75762,3166,1611,6201,0.924343911,0.075656089,0.01965521
New York,CHAUTAUQUA,139750,128481,2820,5901,11269,0.919363148,0.080636852,0.042225403
New York,CHEMUNG,91070,82131,5150,1609,8939,0.901844735,0.098155265,0.017667728
New York,CHENANGO,51401,49815,403,548,1586,0.969144569,0.030855431,0.010661271
New York,CLINTON,79894,73729,2694,1964,6165,0.922835257,0.077164743,0.024582572
New York,COLUMBIA,63094,57338,2738,1598,5756,0.90877104,0.09122896,0.025327289
New York,CORTLAND,48599,46748,399,565,1851,0.961912797,0.038087203,0.011625754
New York,DELAWARE,48055,45693,529,983,2362,0.950847987,0.049152013,0.020455728
New York,DUTCHESS,280150,224913,25059,18060,55237,0.802830626,0.197169374,0.064465465
New York,ERIE,950265,767476,121289,31054,182789,0.807644183,0.192355817,0.032679305
New York,ESSEX,38851,36346,1025,851,2505,0.935522895,0.064477105,0.021904198
New York,FRANKLIN,51134,42233,3180,2053,8901,0.825927954,0.174072046,0.040149411
New York,FULTON,55073,52374,937,884,2699,0.950992319,0.049007681,0.016051423
New York,GENESEE,60370,56799,1217,904,3571,0.940848103,0.059151897,0.014974325
New York,GREENE,48195,42640,2518,2075,5555,0.884739081,0.115260919,0.043054259
New York,HAMILTON,5379,5223,24,57,156,0.970998327,0.029001673,0.010596765
New York,HERKIMER,64427,62667,305,580,1760,0.972682261,0.027317739,0.009002437
New York,JEFFERSON,111738,97389,6257,4677,14349,0.871583526,0.128416474,0.041856844
New York,KINGS,2465326,854532,848583,487878,1610794,0.346620285,0.653379715,0.197895937
New York,LEWIS,26944,26363,100,172,581,0.978436758,0.021563242,0.00638361
New York,LIVINGSTON,64328,59748,1836,1459,4580,0.928802388,0.071197612,0.022680637
New York,MADISON,69441,66564,870,734,2877,0.958569145,0.041430855,0.010570124
New York,MONROE,735343,566763,98174,39065,168580,0.770746441,0.229253559,0.053124868
New York,MONTGOMERY,49708,45084,457,3433,4624,0.906976744,0.093023256,0.06906333
New York,NASSAU,1334544,986947,129860,133282,347597,0.739538749,0.260461251,0.099870817
New York,NEW YORK,1537195,703873,234698,417816,833322,0.457894412,0.542105588,0.271804163
New York,NIAGARA,219846,197757,13356,2913,22089,0.899525122,0.100474878,0.013250184
New York,ONEIDA,235469,208600,12937,7545,26869,0.885891561,0.114108439,0.032042434
New York,ONONDAGA,458336,383599,41772,11175,74737,0.836938403,0.163061597,0.024381676
New York,ONTARIO,100224,94179,1904,2149,6045,0.939685105,0.060314895,0.02144197
New York,ORANGE,341367,264760,25567,39738,76607,0.775587564,0.224412436,0.11640844
New York,ORLEANS,44171,38552,3047,1719,5619,0.872789839,0.127210161,0.038916936
New York,OSWEGO,122377,118110,674,1592,4267,0.965132337,0.034867663,0.01300898
New York,OTSEGO,61676,58321,1014,1171,3355,0.945602828,0.054397172,0.018986316
New York,PUTNAM,95745,85973,1437,5976,9772,0.897937229,0.102062771,0.062415792
New York,QUEENS,2229379,732895,422831,556605,1496484,0.328744013,0.671255987,0.249668181
New York,RENSSELAER,152538,137562,6870,3225,14976,0.901821186,0.098178814,0.021142273
New York,RICHMOND,443728,316316,39704,53550,127412,0.712860131,0.287139869,0.120682039
New York,ROCKLAND,286753,205653,30139,29182,81100,0.717178199,0.282821801,0.101767026
New York,ST. LAWRENCE,111931,104777,2531,2008,7154,0.936085624,0.063914376,0.017939624
New York,SARATOGA,200635,190840,2628,2834,9795,0.951180003,0.048819997,0.014125153
New York,SCHENECTADY,146555,126538,9456,4639,20017,0.863416465,0.136583535,0.031653645
New York,SCHOHARIE,31582,30112,377,588,1470,0.953454499,0.046545501,0.0186182
New York,SCHUYLER,19224,18417,265,235,807,0.958021223,0.041978777,0.012224303
New York,SENECA,33342,31338,720,659,2004,0.939895627,0.060104373,0.019764861
New York,STEUBEN,98726,94689,1329,796,4037,0.959109049,0.040890951,0.008062719
New York,SUFFOLK,1419369,1118405,93262,149411,300964,0.787959297,0.212040703,0.105265791
New York,SULLIVAN,73966,59225,5897,6839,14741,0.80070573,0.19929427,0.092461401
New York,TIOGA,51784,50180,270,509,1604,0.969025182,0.030974818,0.009829291
New York,TOMPKINS,96501,80916,3307,2968,15585,0.838499083,0.161500917,0.030756158
New York,ULSTER,177749,152064,9044,10941,25685,0.855498484,0.144501516,0.061553089
New York,WARREN,63303,61276,371,663,2027,0.967979401,0.032020599,0.010473437
New York,WASHINGTON,61042,57378,1703,1232,3664,0.939975754,0.060024246,0.020182825
New York,WAYNE,93765,86770,2961,2263,6995,0.925398603,0.074601397,0.024134805
New York,WESTCHESTER,923459,591776,125227,144124,331683,0.640825418,0.359174582,0.156069733
New York,WYOMING,43424,39330,2309,1278,4094,0.905720339,0.094279661,0.02943073
New York,YATES,24621,23983,130,228,638,0.974087161,0.025912839,0.009260387
North Carolina,ALAMANCE,130800,94768,24356,8835,36032,0.724525994,0.275474006,0.067545872
North Carolina,ALEXANDER,33603,30562,1536,841,3041,0.909502128,0.090497872,0.025027527
North Carolina,ALLEGHANY,10677,9932,118,530,745,0.930223846,0.069776154,0.049639412
North Carolina,ANSON,25275,12429,12245,211,12846,0.491750742,0.508249258,0.00834817
North Carolina,ASHE,24384,23440,155,590,944,0.961286089,0.038713911,0.024196194
North Carolina,AVERY,17167,15957,598,413,1210,0.929515932,0.070484068,0.024057785
North Carolina,BEAUFORT,44958,30051,13021,1455,14907,0.668423862,0.331576138,0.032363539
North Carolina,BERTIE,19773,7124,12277,195,12649,0.360289283,0.639710717,0.009861933
North Carolina,BLADEN,32278,18035,12170,1198,14243,0.558739699,0.441260301,0.037115063
North Carolina,BRUNSWICK,73143,59354,10459,1960,13789,0.811478884,0.188521116,0.026796823
North Carolina,BUNCOMBE,206330,180721,15310,5730,25609,0.875883294,0.124116706,0.027771046
North Carolina,BURKE,89148,75727,5953,3180,13421,0.849452596,0.150547404,0.035671019
North Carolina,CABARRUS,131063,106030,15778,6620,25033,0.809000252,0.190999748,0.05051006
North Carolina,CALDWELL,77415,70307,4201,1927,7108,0.908183169,0.091816831,0.024891817
North Carolina,CAMDEN,6885,5516,1185,49,1369,0.801161946,0.198838054,0.007116921
North Carolina,CARTERET,59383,53041,4121,1035,6342,0.893201758,0.106798242,0.017429231
North Carolina,CASWELL,23501,14239,8557,415,9262,0.605889111,0.394110889,0.017658823
North Carolina,CATAWBA,141685,116326,11751,7886,25359,0.821018456,0.178981544,0.055658679
North Carolina,CHATHAM,49329,35322,8355,4743,14007,0.716049383,0.283950617,0.096150338
North Carolina,CHEROKEE,24298,22875,382,303,1423,0.941435509,0.058564491,0.012470162
North Carolina,CHOWAN,14526,8703,5415,219,5823,0.59913259,0.40086741,0.015076415
North Carolina,CLAY,8775,8536,70,73,239,0.972763533,0.027236467,0.008319088
North Carolina,CLEVELAND,96287,73357,20010,1433,22930,0.761857779,0.238142221,0.014882591
North Carolina,COLUMBUS,54749,34380,16901,1269,20369,0.627956675,0.372043325,0.023178506
North Carolina,CRAVEN,91436,62435,22729,3677,29001,0.682827333,0.317172667,0.04021392
North Carolina,CUMBERLAND,302963,159304,104068,20919,143659,0.525819985,0.474180015,0.069048036
North Carolina,CURRITUCK,18190,16287,1314,261,1903,0.895382078,0.104617922,0.014348543
North Carolina,DARE,29967,28028,793,666,1939,0.935295492,0.064704508,0.022224447
North Carolina,DAVIDSON,147246,126158,13389,4765,21088,0.856783885,0.143216115,0.032360811
North Carolina,DAVIE,34835,30832,2343,1209,4003,0.885086838,0.114913162,0.034706473
North Carolina,DUPLIN,49063,27094,14116,7426,21969,0.552228767,0.447771233,0.151356419
North Carolina,DURHAM,223314,107371,87516,17039,115943,0.480807294,0.519192706,0.076300635
North Carolina,EDGECOMBE,55606,21838,31790,1554,33768,0.392727404,0.607272596,0.027946624
North Carolina,FORSYTH,306067,202338,77041,19577,103729,0.661090546,0.338909454,0.063963119
North Carolina,FRANKLIN,47260,30335,14124,2100,16925,0.641874736,0.358125264,0.04443504
North Carolina,GASTON,190365,154922,25843,5719,35443,0.813815565,0.186184435,0.030042287
North Carolina,GATES,10516,6154,4113,81,4362,0.585203499,0.414796501,0.007702548
North Carolina,GRAHAM,7993,7303,15,60,690,0.913674465,0.086325535,0.007506568
North Carolina,GRANVILLE,48498,28777,16854,1951,19721,0.593364675,0.406635325,0.040228463
North Carolina,GREENE,18974,9508,7792,1511,9466,0.501106778,0.498893222,0.07963529
North Carolina,GUILFORD,421048,264847,122279,15985,156201,0.629018544,0.370981456,0.037964793
North Carolina,HALIFAX,57370,24269,30018,579,33101,0.423025972,0.576974028,0.010092383
North Carolina,HARNETT,91025,62708,20371,5336,28317,0.68890964,0.31109036,0.058621258
North Carolina,HAYWOOD,54033,51870,674,763,2163,0.959968908,0.040031092,0.014121
North Carolina,HENDERSON,89173,80118,2686,4880,9055,0.898455811,0.101544189,0.054725085
North Carolina,HERTFORD,22601,8374,13375,354,14227,0.370514579,0.629485421,0.015663024
North Carolina,HOKE,33646,13988,12536,2415,19658,0.415740355,0.584259645,0.071776734
North Carolina,HYDE,5826,3590,2038,131,2236,0.616203227,0.383796773,0.02248541
North Carolina,IREDELL,122660,99027,16620,4182,23633,0.807329203,0.192670797,0.034094244
North Carolina,JACKSON,33121,28093,547,577,5028,0.848192989,0.151807011,0.017420972
North Carolina,JOHNSTON,121965,91870,18971,9440,30095,0.753248883,0.246751117,0.077399254
North Carolina,JONES,10381,6256,3703,282,4125,0.602639437,0.397360563,0.027165013
North Carolina,LEE,49040,32467,9982,5715,16573,0.662051387,0.337948613,0.11653752
North Carolina,LENOIR,59648,33075,24016,1891,26573,0.554503085,0.445496915,0.031702656
North Carolina,LINCOLN,63780,55290,4067,3656,8490,0.866886171,0.133113829,0.057322045
North Carolina,MCDOWELL,42151,38373,1716,1214,3778,0.910369861,0.089630139,0.028801215
North Carolina,MACON,29811,28628,353,454,1183,0.960316662,0.039683338,0.015229278
North Carolina,MADISON,19635,19004,160,266,631,0.967863509,0.032136491,0.013547237
North Carolina,MARTIN,25593,13264,11542,528,12329,0.518266714,0.481733286,0.020630641
North Carolina,MECKLENBURG,695454,425144,192403,44871,270310,0.611318649,0.388681351,0.064520443
North Carolina,MITCHELL,15687,15210,33,311,477,0.969592656,0.030407344,0.019825333
North Carolina,MONTGOMERY,26822,17514,5805,2797,9308,0.652971441,0.347028559,0.104280069
North Carolina,MOORE,74769,58844,11527,2981,15925,0.787010659,0.212989341,0.039869465
North Carolina,NASH,87420,53326,29505,2939,34094,0.609997712,0.390002288,0.033619309
North Carolina,NEW HANOVER,160307,126453,27001,3276,33854,0.788817706,0.211182294,0.020435789
North Carolina,NORTHAMPTON,22086,8603,13096,161,13483,0.389522775,0.610477225,0.007289686
North Carolina,ONSLOW,150355,104600,27162,10896,45755,0.695686874,0.304313126,0.072468491
North Carolina,ORANGE,118227,89656,16175,5273,28571,0.758337774,0.241662226,0.044600641
North Carolina,PAMLICO,12934,9384,3167,171,3550,0.725529612,0.274470388,0.013220968
North Carolina,PASQUOTANK,34897,19665,13932,429,15232,0.563515488,0.436484512,0.01229332
North Carolina,PENDER,41082,29441,9536,1496,11641,0.716639891,0.283360109,0.036414975
North Carolina,PERQUIMANS,11368,8015,3167,68,3353,0.705049261,0.294950739,0.005981703
North Carolina,PERSON,35623,24277,10018,746,11346,0.681497909,0.318502091,0.020941527
North Carolina,PITT,133798,81613,44819,4216,52185,0.609971748,0.390028252,0.031510187
North Carolina,POLK,18324,16504,1061,551,1820,0.900676708,0.099323292,0.030069854
North Carolina,RANDOLPH,130454,112250,7259,8646,18204,0.860456559,0.139543441,0.066276235
North Carolina,RICHMOND,46564,29522,14160,1319,17042,0.634009106,0.365990894,0.028326604
North Carolina,ROBESON,123339,37999,30827,5994,85340,0.308085845,0.691914155,0.048597767
North Carolina,ROCKINGHAM,91928,70023,17922,2825,21905,0.761715691,0.238284309,0.030730572
North Carolina,ROWAN,130340,101859,20440,5369,28481,0.78148688,0.21851312,0.041192266
North Carolina,RUTHERFORD,62899,53957,7028,1136,8942,0.857835578,0.142164422,0.0180607
North Carolina,SAMPSON,60161,34190,17871,6477,25971,0.568308373,0.431691627,0.107661109
North Carolina,SCOTLAND,35998,18398,13364,423,17600,0.511083949,0.488916051,0.011750653
North Carolina,STANLY,58100,48611,6641,1237,9489,0.836678141,0.163321859,0.021290878
North Carolina,STOKES,44711,41379,2068,836,3332,0.925476952,0.074523048,0.01869786
North Carolina,SURRY,71219,62668,2911,4620,8551,0.879933726,0.120066274,0.06487033
North Carolina,SWAIN,12968,8544,214,191,4424,0.65885256,0.34114744,0.014728563
North Carolina,TRANSYLVANIA,29334,27305,1228,298,2029,0.930831117,0.069168883,0.01015886
North Carolina,TYRRELL,4149,2303,1633,150,1846,0.555073512,0.444926488,0.03615329
North Carolina,UNION,123677,98612,15312,7637,25065,0.797334994,0.202665006,0.061749557
North Carolina,VANCE,42954,19894,20604,1957,23060,0.463146622,0.536853378,0.045560367
North Carolina,WAKE,627846,439160,122648,33985,188686,0.699470889,0.300529111,0.054129516
North Carolina,WARREN,19972,7696,10816,317,12276,0.385339475,0.614660525,0.015872221
North Carolina,WASHINGTON,13723,6555,6702,311,7168,0.477665234,0.522334766,0.022662683
North Carolina,WATAUGA,42695,40744,673,622,1951,0.954303783,0.045696217,0.014568451
North Carolina,WAYNE,113329,67756,37230,5604,45573,0.597869919,0.402130081,0.04944895
North Carolina,WILKES,65632,59977,2719,2262,5655,0.913837762,0.086162238,0.034464895
North Carolina,WILSON,73814,39498,28886,4457,34316,0.535101742,0.464898258,0.060381499
North Carolina,YADKIN,36348,32446,1219,2357,3902,0.892648839,0.107351161,0.064845384
North Carolina,YANCEY,17774,17033,101,478,741,0.958309891,0.041690109,0.026893215
North Dakota,ADAMS,2593,2550,14,7,43,0.983416892,0.016583108,0.002699576
North Dakota,BARNES,11775,11477,53,64,298,0.974692144,0.025307856,0.005435244
North Dakota,BENSON,6964,3533,7,55,3431,0.507323377,0.492676623,0.00789776
North Dakota,BILLINGS,888,874,0,3,14,0.984234234,0.015765766,0.003378378
North Dakota,BOTTINEAU,7149,6935,15,35,214,0.970065743,0.029934257,0.00489579
North Dakota,BOWMAN,3242,3195,1,22,47,0.985502776,0.014497224,0.006785935
North Dakota,BURKE,2242,2220,3,8,22,0.990187333,0.009812667,0.003568243
North Dakota,BURLEIGH,69416,65686,166,468,3730,0.946265991,0.053734009,0.006741962
North Dakota,CASS,123138,116263,978,1518,6875,0.944168331,0.055831669,0.012327632
North Dakota,CAVALIER,4831,4720,6,31,111,0.977023391,0.022976609,0.006416891
North Dakota,DICKEY,5757,5584,6,78,173,0.969949627,0.030050373,0.013548723
North Dakota,DIVIDE,2283,2251,0,14,32,0.985983355,0.014016645,0.006132282
North Dakota,DUNN,3600,3101,1,27,499,0.861388889,0.138611111,0.0075
North Dakota,EDDY,2757,2649,2,17,108,0.960826986,0.039173014,0.006166123
North Dakota,EMMONS,4331,4257,2,50,74,0.982913877,0.017086123,0.011544678
North Dakota,FOSTER,3759,3717,5,7,42,0.988826816,0.011173184,0.001862197
North Dakota,GOLDEN VALLEY,1924,1870,0,20,54,0.971933472,0.028066528,0.01039501
North Dakota,GRAND FORKS,66109,60801,871,1359,5308,0.91970836,0.08029164,0.020556959
North Dakota,GRANT,2841,2746,0,17,95,0.96656107,0.03343893,0.005983809
North Dakota,GRIGGS,2754,2729,0,11,25,0.990922295,0.009077705,0.00399419
North Dakota,HETTINGER,2715,2681,4,6,34,0.98747698,0.01252302,0.002209945
North Dakota,KIDDER,2753,2723,5,16,30,0.989102797,0.010897203,0.005811842
North Dakota,LAMOURE,4701,4648,0,26,53,0.988725803,0.011274197,0.005530738
North Dakota,LOGAN,2308,2275,2,16,33,0.985701906,0.014298094,0.006932409
North Dakota,MCHENRY,5987,5896,5,24,91,0.984800401,0.015199599,0.004008685
North Dakota,MCINTOSH,3390,3329,0,28,61,0.9820059,0.0179941,0.008259587
North Dakota,MCKENZIE,5737,4419,4,58,1318,0.770263204,0.229736796,0.010109813
North Dakota,MCLEAN,9311,8592,2,81,719,0.922779508,0.077220492,0.008699388
North Dakota,MERCER,8644,8280,4,32,364,0.957889866,0.042110134,0.00370199
North Dakota,MORTON,25303,24161,38,164,1142,0.954867012,0.045132988,0.006481445
North Dakota,MOUNTRAIL,6631,4358,6,87,2273,0.657216106,0.342783894,0.013120193
North Dakota,NELSON,3715,3661,3,6,54,0.985464334,0.014535666,0.001615074
North Dakota,OLIVER,2065,2005,1,13,60,0.97094431,0.02905569,0.0062954
North Dakota,PEMBINA,8585,8058,12,264,527,0.938613861,0.061386139,0.03075131
North Dakota,PIERCE,4675,4584,4,28,91,0.980534759,0.019465241,0.005989305
North Dakota,RAMSEY,12066,11112,22,63,954,0.920934858,0.079065142,0.005221283
North Dakota,RANSOM,5890,5749,11,48,141,0.976061121,0.023938879,0.008149406
North Dakota,RENVILLE,2610,2535,6,19,75,0.971264368,0.028735632,0.007279693
North Dakota,RICHLAND,17998,17337,62,123,661,0.963273697,0.036726303,0.006834093
North Dakota,ROLETTE,13674,3416,10,110,10258,0.249817171,0.750182829,0.008044464
North Dakota,SARGENT,4366,4278,2,32,88,0.979844251,0.020155749,0.007329363
North Dakota,SHERIDAN,1710,1692,2,6,18,0.989473684,0.010526316,0.003508772
North Dakota,SIOUX,4044,577,1,65,3467,0.142680514,0.857319486,0.016073195
North Dakota,SLOPE,767,764,0,1,3,0.996088657,0.003911343,0.001303781
North Dakota,STARK,22636,21922,47,236,714,0.968457325,0.031542675,0.01042587
North Dakota,STEELE,2258,2220,1,4,38,0.983170948,0.016829052,0.001771479
North Dakota,STUTSMAN,21908,21241,55,204,667,0.969554501,0.030445499,0.009311667
North Dakota,TOWNER,2876,2797,2,5,79,0.972531293,0.027468707,0.001738526
North Dakota,TRAILL,8477,8170,9,185,307,0.963784358,0.036215642,0.021823758
North Dakota,WALSH,12389,11436,24,700,953,0.923076923,0.076923077,0.056501735
North Dakota,WARD,58795,53786,1262,1125,5009,0.914805681,0.085194319,0.01913428
North Dakota,WELLS,5102,5044,7,15,58,0.988631909,0.011368091,0.002940024
North Dakota,WILLIAMS,19761,18245,18,185,1516,0.923283235,0.076716765,0.009361874
Ohio,ADAMS,27330,26604,47,175,726,0.973435785,0.026564215,0.00640322
Ohio,ALLEN,108473,91356,13130,1545,17117,0.842200363,0.157799637,0.014243176
Ohio,ASHLAND,52523,51021,419,339,1502,0.971403004,0.028596996,0.006454315
Ohio,ASHTABULA,102728,95484,3165,2292,7244,0.929483685,0.070516315,0.022311346
Ohio,ATHENS,62223,57768,1467,639,4455,0.928402681,0.071597319,0.010269514
Ohio,AUGLAIZE,46611,45553,109,310,1058,0.977301495,0.022698505,0.006650791
Ohio,BELMONT,70226,66512,2547,274,3714,0.947113605,0.052886395,0.003901689
Ohio,BROWN,42285,41342,381,185,943,0.977698948,0.022301052,0.004375074
Ohio,BUTLER,332807,301078,17398,4771,31729,0.904662462,0.095337538,0.014335636
Ohio,CARROLL,28836,28193,153,158,643,0.977701484,0.022298516,0.005479262
Ohio,CHAMPAIGN,38890,37079,891,269,1811,0.953432759,0.046567241,0.006916945
Ohio,CLARK,144742,126748,12867,1699,17994,0.875682248,0.124317752,0.011738127
Ohio,CLERMONT,177977,171858,1602,1547,6119,0.965619153,0.034380847,0.008692134
Ohio,CLINTON,40543,38749,881,266,1794,0.955750684,0.044249316,0.006560935
Ohio,COLUMBIANA,112075,107045,2423,1309,5030,0.95511934,0.04488066,0.011679679
Ohio,COSHOCTON,36655,35557,395,216,1098,0.970045014,0.029954986,0.005892784
Ohio,CRAWFORD,46966,45787,275,361,1179,0.974896734,0.025103266,0.007686411
Ohio,CUYAHOGA,1393978,918577,379397,47078,475401,0.658960902,0.341039098,0.033772412
Ohio,DARKE,53309,52046,204,457,1263,0.97630794,0.02369206,0.008572661
Ohio,DEFIANCE,39500,35471,657,2857,4029,0.898,0.102,0.072329114
Ohio,DELAWARE,109989,102943,2743,1109,7046,0.935939048,0.064060952,0.010082826
Ohio,ERIE,79551,69510,6820,1664,10041,0.873779085,0.126220915,0.020917399
Ohio,FAIRFIELD,122759,116201,3245,993,6558,0.946578255,0.053421745,0.00808902
Ohio,FAYETTE,28433,27022,568,352,1411,0.950374565,0.049625435,0.012379981
Ohio,FRANKLIN,1068978,795660,189652,24279,273318,0.744318405,0.255681595,0.022712348
Ohio,FULTON,42084,39011,93,2422,3073,0.926979375,0.073020625,0.057551564
Ohio,GALLIA,31069,29458,834,191,1611,0.948147671,0.051852329,0.006147607
Ohio,GEAUGA,90895,88161,1104,538,2734,0.969921338,0.030078662,0.005918917
Ohio,GREENE,147886,130857,9332,1813,17029,0.884850493,0.115149507,0.012259443
Ohio,GUERNSEY,40792,39108,622,254,1684,0.958717396,0.041282604,0.006226711
Ohio,HAMILTON,845303,611767,197192,9514,233536,0.723725102,0.276274898,0.011255136
Ohio,HANCOCK,71295,66733,756,2187,4562,0.936012343,0.063987657,0.030675363
Ohio,HARDIN,31945,31009,220,248,936,0.97069964,0.02930036,0.007763343
Ohio,HARRISON,15856,15264,346,59,592,0.962663976,0.037336024,0.003720989
Ohio,HENRY,29210,27151,166,1576,2059,0.929510442,0.070489558,0.053954125
Ohio,HIGHLAND,40875,39472,603,216,1403,0.965675841,0.034324159,0.005284404
Ohio,HOCKING,28241,27439,257,124,802,0.971601572,0.028398428,0.004390779
Ohio,HOLMES,38943,38330,122,292,613,0.984259045,0.015740955,0.007498138
Ohio,HURON,59487,56057,557,2117,3430,0.942340343,0.057659657,0.035587607
Ohio,JACKSON,32641,31832,192,197,809,0.97521522,0.02478478,0.006035354
Ohio,JEFFERSON,73894,68049,4192,459,5845,0.920900208,0.079099792,0.0062116
Ohio,KNOX,54500,52989,361,371,1511,0.972275229,0.027724771,0.006807339
Ohio,LAKE,227511,214881,4447,3879,12630,0.944486201,0.055513799,0.017049725
Ohio,LAWRENCE,62319,59915,1297,355,2404,0.961424285,0.038575715,0.005696497
Ohio,LICKING,145491,138498,2966,1107,6993,0.951935171,0.048064829,0.007608718
Ohio,LOGAN,46005,44047,778,332,1958,0.957439409,0.042560591,0.007216607
Ohio,LORAIN,284664,234597,23365,19676,50067,0.824118961,0.175881039,0.069120085
Ohio,LUCAS,455054,343146,76495,20670,111908,0.754077538,0.245922462,0.045423181
Ohio,MADISON,40213,36744,2505,294,3469,0.913734365,0.086265635,0.007311069
Ohio,MAHONING,257555,204969,40270,7640,52586,0.795826134,0.204173866,0.029663567
Ohio,MARION,66217,60580,3779,723,5637,0.914870804,0.085129196,0.010918646
Ohio,MEDINA,151095,145960,1304,1399,5135,0.966014759,0.033985241,0.009259075
Ohio,MEIGS,23072,22461,159,138,611,0.973517684,0.026482316,0.005981276
Ohio,MERCER,40924,40014,39,470,910,0.977763659,0.022236341,0.011484703
Ohio,MIAMI,98868,94262,1923,721,4606,0.953412631,0.046587369,0.007292552
Ohio,MONROE,15180,14944,38,62,236,0.984453228,0.015546772,0.004084321
Ohio,MONTGOMERY,559062,424183,110454,7096,134879,0.758740533,0.241259467,0.012692689
Ohio,MORGAN,14897,13908,504,61,989,0.933610794,0.066389206,0.004094784
Ohio,MORROW,31628,30984,84,183,644,0.979638295,0.020361705,0.005786012
Ohio,MUSKINGUM,84585,79122,3364,436,5463,0.935414081,0.064585919,0.005154578
Ohio,NOBLE,14058,12959,938,60,1099,0.921823873,0.078176127,0.004268032
Ohio,OTTAWA,40985,38767,260,1535,2218,0.94588264,0.05411736,0.037452727
Ohio,PAULDING,20293,19227,188,612,1066,0.947469571,0.052530429,0.030158183
Ohio,PERRY,34078,33473,73,152,605,0.982246611,0.017753389,0.004460356
Ohio,PICKAWAY,52727,48250,3383,333,4477,0.91509094,0.08490906,0.00631555
Ohio,PIKE,27695,26666,240,155,1029,0.962845279,0.037154721,0.005596678
Ohio,PORTAGE,152061,142825,4812,1093,9236,0.939261218,0.060738782,0.007187905
Ohio,PREBLE,42337,41577,135,181,760,0.982048799,0.017951201,0.00427522
Ohio,PUTNAM,34726,32916,45,1521,1810,0.947877671,0.052122329,0.043800035
Ohio,RICHLAND,128852,112910,12082,1200,15942,0.876276658,0.123723342,0.00931301
Ohio,ROSS,73345,66991,4534,429,6354,0.913368328,0.086631672,0.005849069
Ohio,SANDUSKY,61792,55015,1620,4298,6777,0.890325608,0.109674392,0.06955593
Ohio,SCIOTO,79195,74859,2147,477,4336,0.945249069,0.054750931,0.006023108
Ohio,SENECA,58683,54821,1016,1972,3862,0.934188777,0.065811223,0.033604281
Ohio,SHELBY,47910,45769,710,383,2141,0.955312043,0.044687957,0.007994156
Ohio,STARK,378098,339010,27039,3492,39088,0.896619395,0.103380605,0.009235701
Ohio,SUMMIT,542899,450620,71218,4781,92279,0.830025474,0.169974526,0.008806426
Ohio,TRUMBULL,225116,201953,17628,1794,23163,0.897106381,0.102893619,0.007969225
Ohio,TUSCARAWAS,90914,88576,655,650,2338,0.974283389,0.025716611,0.007149614
Ohio,UNION,40909,38795,1139,309,2114,0.94832433,0.05167567,0.00755335
Ohio,VAN WERT,29659,28687,222,462,972,0.967227486,0.032772514,0.015577059
Ohio,VINTON,12806,12518,45,60,288,0.977510542,0.022489458,0.004685304
Ohio,WARREN,158383,148850,4272,1633,9533,0.939810459,0.060189541,0.01031045
Ohio,WASHINGTON,63251,61320,580,324,1931,0.969470838,0.030529162,0.005122449
Ohio,WAYNE,111564,107151,1723,837,4413,0.960444229,0.039555771,0.00750242
Ohio,WILLIAMS,39188,37338,278,1049,1850,0.952791671,0.047208329,0.026768398
Ohio,WOOD,121065,112913,1492,4033,8152,0.932664271,0.067335729,0.033312683
Ohio,WYANDOT,22908,22289,32,334,619,0.972978872,0.027021128,0.014580059
Oklahoma,ADAIR,21038,10035,33,657,11003,0.476994011,0.523005989,0.031229204
Oklahoma,ALFALFA,6105,5394,250,177,711,0.883538084,0.116461916,0.028992629
Oklahoma,ATOKA,13879,10464,814,196,3415,0.753944809,0.246055191,0.014122055
Oklahoma,BEAVER,5857,5072,15,630,785,0.865972341,0.134027659,0.107563599
Oklahoma,BECKHAM,19799,16760,1058,1079,3039,0.846507399,0.153492601,0.054497702
Oklahoma,BLAINE,11976,8822,782,793,3154,0.736639947,0.263360053,0.066215765
Oklahoma,BRYAN,36534,28820,519,967,7714,0.788854218,0.211145782,0.026468495
Oklahoma,CADDO,30150,19314,872,1894,10836,0.640597015,0.359402985,0.062819237
Oklahoma,CANADIAN,87697,74568,1833,3386,13129,0.850291344,0.149708656,0.038610215
Oklahoma,CARTER,45621,35055,3435,1269,10566,0.768396133,0.231603867,0.027816137
Oklahoma,CHEROKEE,42521,23483,504,1760,19038,0.552268291,0.447731709,0.041391313
Oklahoma,CHOCTAW,15342,10409,1671,246,4933,0.678464346,0.321535654,0.016034415
Oklahoma,CIMARRON,3148,2551,17,485,597,0.810355781,0.189644219,0.154066074
Oklahoma,CLEVELAND,208016,169533,7299,8396,38483,0.814999808,0.185000192,0.04036228
Oklahoma,COAL,6031,4491,22,129,1540,0.744652628,0.255347372,0.021389488
Oklahoma,COMANCHE,114996,71304,21381,9675,43692,0.62005635,0.37994365,0.084133361
Oklahoma,COTTON,6614,5475,188,321,1139,0.827789537,0.172210463,0.048533414
Oklahoma,CRAIG,14950,10175,459,179,4775,0.680602007,0.319397993,0.011973244
Oklahoma,CREEK,67367,54843,1702,1283,12524,0.814092954,0.185907046,0.019044933
Oklahoma,CUSTER,26142,20743,739,2361,5399,0.793474103,0.206525897,0.090314437
Oklahoma,DELAWARE,37077,25745,46,649,11332,0.694365779,0.305634221,0.017504113
Oklahoma,DEWEY,4743,4299,6,127,444,0.906388362,0.093611638,0.026776302
Oklahoma,ELLIS,4075,3864,2,106,211,0.948220859,0.051779141,0.02601227
Oklahoma,GARFIELD,57813,50267,1860,2387,7546,0.869475723,0.130524277,0.041288292
Oklahoma,GARVIN,27210,22705,692,924,4505,0.834435869,0.165564131,0.033958104
Oklahoma,GRADY,45516,39168,1379,1316,6348,0.86053256,0.13946744,0.02891291
Oklahoma,GRANT,5144,4851,4,95,293,0.943040435,0.056959565,0.018468118
Oklahoma,GREER,6061,4769,528,451,1292,0.786833856,0.213166144,0.074410163
Oklahoma,HARMON,3283,2161,303,748,1122,0.658239415,0.341760585,0.22784039
Oklahoma,HARPER,3562,3310,1,201,252,0.929253229,0.070746771,0.056428972
Oklahoma,HASKELL,11792,9134,72,177,2658,0.774592944,0.225407056,0.015010176
Oklahoma,HUGHES,14154,10164,632,353,3990,0.71810089,0.28189911,0.024939946
Oklahoma,JACKSON,28439,20329,2245,4446,8110,0.714828229,0.285171771,0.156334611
Oklahoma,JEFFERSON,6818,5709,38,478,1109,0.837342329,0.162657671,0.070108536
Oklahoma,JOHNSTON,10513,7927,174,260,2586,0.754018834,0.245981166,0.024731285
Oklahoma,KAY,48080,39687,850,2045,8393,0.825436772,0.174563228,0.042533278
Oklahoma,KINGFISHER,13926,11992,213,961,1934,0.861123079,0.138876921,0.069007612
Oklahoma,KIOWA,10227,8234,466,689,1993,0.805123692,0.194876308,0.067370685
Oklahoma,LATIMER,10692,7747,99,164,2945,0.724560419,0.275439581,0.015338571
Oklahoma,LE FLORE,48109,37707,1059,1849,10402,0.78378266,0.21621734,0.038433557
Oklahoma,LINCOLN,32080,27498,780,483,4582,0.857169576,0.142830424,0.01505611
Oklahoma,LOGAN,33924,27225,3700,987,6699,0.802529183,0.197470817,0.029094446
Oklahoma,LOVE,8831,7179,191,619,1652,0.812931718,0.187068282,0.070093987
Oklahoma,MCCLAIN,27740,23669,175,1349,4071,0.853244412,0.146755588,0.048630137
Oklahoma,MCCURTAIN,34402,23922,3173,1064,10480,0.695366548,0.304633452,0.030928434
Oklahoma,MCINTOSH,19456,14013,772,248,5443,0.720240543,0.279759457,0.012746711
Oklahoma,MAJOR,7545,7076,14,303,469,0.937839629,0.062160371,0.040159046
Oklahoma,MARSHALL,13184,10087,235,1134,3097,0.765094053,0.234905947,0.08601335
Oklahoma,MAYES,38369,27373,111,718,10996,0.713414475,0.286585525,0.018713024
Oklahoma,MURRAY,12623,9998,236,397,2625,0.792046265,0.207953735,0.031450527
Oklahoma,MUSKOGEE,69451,43606,9076,1857,25845,0.627867129,0.372132871,0.026738276
Oklahoma,NOBLE,11411,9786,179,205,1625,0.85759355,0.14240645,0.017965121
Oklahoma,NOWATA,10569,7596,260,130,2973,0.718705649,0.281294351,0.012300123
Oklahoma,OKFUSKEE,11814,7664,1224,194,4150,0.648721855,0.351278145,0.016421195
Oklahoma,OKLAHOMA,660448,443160,98217,57336,217288,0.670999079,0.329000921,0.086813799
Oklahoma,OKMULGEE,39685,27395,4030,772,12290,0.690311201,0.309688799,0.019453194
Oklahoma,OSAGE,44437,29380,4773,940,15057,0.661160744,0.338839256,0.021153543
Oklahoma,OTTAWA,33194,24193,192,1061,9001,0.728836537,0.271163463,0.031963608
Oklahoma,PAWNEE,16612,13572,113,192,3040,0.816999759,0.183000241,0.01155791
Oklahoma,PAYNE,68190,56793,2455,1463,11397,0.832864056,0.167135944,0.021454759
Oklahoma,PITTSBURG,43953,33528,1753,939,10425,0.762814825,0.237185175,0.021363729
Oklahoma,PONTOTOC,35143,26292,717,808,8851,0.7481433,0.2518567,0.022991776
Oklahoma,POTTAWATOMIE,65521,51625,1881,1544,13896,0.787915325,0.212084675,0.023564964
Oklahoma,PUSHMATAHA,11667,8997,87,191,2670,0.771149396,0.228850604,0.016370961
Oklahoma,ROGER MILLS,3436,3100,10,91,336,0.902211874,0.097788126,0.026484284
Oklahoma,ROGERS,70641,55774,504,1294,14867,0.789541484,0.210458516,0.018317974
Oklahoma,SEMINOLE,24894,17401,1375,552,7493,0.699003776,0.300996224,0.022174018
Oklahoma,SEQUOYAH,38972,26284,715,793,12688,0.674432926,0.325567074,0.020347942
Oklahoma,STEPHENS,43182,37228,936,1709,5954,0.862118475,0.137881525,0.039576675
Oklahoma,TEXAS,20107,13420,114,6003,6687,0.667429253,0.332570747,0.298552743
Oklahoma,TILLMAN,9287,6364,828,1641,2923,0.685258964,0.314741036,0.176698611
Oklahoma,TULSA,563299,408149,61089,33616,155150,0.724569012,0.275430988,0.05967701
Oklahoma,WAGONER,57491,45352,2135,1437,12139,0.788853908,0.211146092,0.024995217
Oklahoma,WASHINGTON,48996,39137,1205,1293,9859,0.798779492,0.201220508,0.026389909
Oklahoma,WASHITA,11508,10406,50,516,1102,0.904240528,0.095759472,0.044838373
Oklahoma,WOODS,9089,8354,212,220,735,0.919133018,0.080866982,0.024205083
Oklahoma,WOODWARD,18486,16692,202,896,1794,0.902953586,0.097046414,0.048469112
Oregon,BAKER,16741,15838,37,392,903,0.94606057,0.05393943,0.023415567
Oregon,BENTON,78153,67816,637,3645,10337,0.867733804,0.132266196,0.046639284
Oregon,CLACKAMAS,338391,301548,2056,16744,36843,0.891122991,0.108877009,0.049481221
Oregon,CLATSOP,35630,32364,156,1597,3266,0.908335672,0.091664328,0.044821779
Oregon,COLUMBIA,43560,40576,97,1093,2984,0.931496786,0.068503214,0.025091827
Oregon,COOS,62779,56616,169,2133,6163,0.90183023,0.09816977,0.03397633
Oregon,CROOK,19182,17532,6,1082,1650,0.913981858,0.086018142,0.056407048
Oregon,CURRY,21137,19206,31,761,1931,0.908643611,0.091356389,0.036003217
Oregon,DESCHUTES,115367,107177,207,4304,8190,0.929009162,0.070990838,0.037307029
Oregon,DOUGLAS,100399,92302,165,3283,8097,0.919351786,0.080648214,0.032699529
Oregon,GILLIAM,1915,1839,3,35,76,0.960313316,0.039686684,0.018276762
Oregon,GRANT,7935,7506,8,163,429,0.945935728,0.054064272,0.020541903
Oregon,HARNEY,7609,6823,9,316,786,0.896701275,0.103298725,0.041529767
Oregon,HOOD RIVER,20411,14426,66,5107,5985,0.706775758,0.293224242,0.250208221
Oregon,JACKSON,181269,160795,674,12126,20474,0.88705184,0.11294816,0.066895057
Oregon,JEFFERSON,19009,12335,43,3372,6674,0.648903151,0.351096849,0.177389658
Oregon,JOSEPHINE,75726,69233,192,3229,6493,0.914256662,0.085743338,0.042640573
Oregon,KLAMATH,63775,53659,362,4961,10116,0.841379851,0.158620149,0.077789102
Oregon,LAKE,7422,6617,8,404,805,0.891538669,0.108461331,0.054432767
Oregon,LANE,322959,286075,2391,14874,36884,0.885793553,0.114206447,0.046055382
Oregon,LINCOLN,44479,39260,113,2119,5219,0.882663729,0.117336271,0.04764046
Oregon,LINN,103069,94012,285,4514,9057,0.912126828,0.087873172,0.043795904
Oregon,MALHEUR,31615,21752,369,8099,9863,0.688027835,0.311972165,0.256175866
Oregon,MARION,284834,217880,2274,48714,66954,0.76493677,0.23506323,0.171025931
Oregon,MORROW,10995,7911,14,2686,3084,0.719508868,0.280491132,0.24429286
Oregon,MULTNOMAH,660486,505492,36592,49607,154994,0.765333406,0.234666594,0.075106815
Oregon,POLK,62380,53394,229,5480,8986,0.855947419,0.144052581,0.087848669
Oregon,SHERMAN,1934,1782,0,94,152,0.921406412,0.078593588,0.04860393
Oregon,TILLAMOOK,24262,22086,42,1244,2176,0.910312423,0.089687577,0.051273597
Oregon,UMATILLA,70548,54670,535,11366,15878,0.774933379,0.225066621,0.161110166
Oregon,UNION,24530,22843,117,600,1687,0.931227069,0.068772931,0.024459845
Oregon,WALLOWA,7226,6918,2,125,308,0.957376142,0.042623858,0.017298644
Oregon,WASCO,23791,19967,65,2214,3824,0.83926695,0.16073305,0.093060401
Oregon,WASHINGTON,445342,346251,4778,49735,99091,0.7774946,0.2225054,0.111678216
Oregon,WHEELER,1547,1431,1,79,116,0.92501616,0.07498384,0.05106658
Oregon,YAMHILL,84992,71684,592,9017,13308,0.843420557,0.156579443,0.106092338
Pennsylvania,ADAMS,91292,85558,1046,3323,5734,0.937190553,0.062809447,0.036399685
Pennsylvania,ALLEGHENY,1281666,1074129,158049,11166,207537,0.838072478,0.161927522,0.008712098
Pennsylvania,ARMSTRONG,72392,70976,578,308,1416,0.980439828,0.019560172,0.004254614
Pennsylvania,BEAVER,181412,167018,10728,1315,14394,0.920655745,0.079344255,0.007248694
Pennsylvania,BEDFORD,49984,49089,167,263,895,0.98209427,0.01790573,0.005261684
Pennsylvania,BERKS,373638,317025,12478,36357,56613,0.848481685,0.151518315,0.097305413
Pennsylvania,BLAIR,129144,125641,1495,662,3503,0.97287524,0.02712476,0.005126061
Pennsylvania,BRADFORD,62761,61219,249,398,1542,0.975430602,0.024569398,0.006341518
Pennsylvania,BUCKS,597635,544733,18970,14005,52902,0.911481088,0.088518912,0.023434036
Pennsylvania,BUTLER,174083,169634,1343,1016,4449,0.974443225,0.025556775,0.005836296
Pennsylvania,CAMBRIA,152598,145330,4224,1352,7268,0.952371591,0.047628409,0.00885988
Pennsylvania,CAMERON,5974,5882,21,34,92,0.984599933,0.015400067,0.005691329
Pennsylvania,CARBON,58802,56952,333,858,1850,0.968538485,0.031461515,0.01459134
Pennsylvania,CENTRE,135758,123055,3469,2243,12703,0.906429087,0.093570913,0.016522047
Pennsylvania,CHESTER,433501,377925,26395,16126,55576,0.871797297,0.128202703,0.037199453
Pennsylvania,CLARION,41765,40867,325,172,898,0.978498743,0.021501257,0.004118281
Pennsylvania,CLEARFIELD,83382,81005,1236,471,2377,0.971492648,0.028507352,0.005648701
Pennsylvania,CLINTON,37914,37125,189,205,789,0.979189745,0.020810255,0.005406974
Pennsylvania,COLUMBIA,64151,62269,481,609,1882,0.970662967,0.029337033,0.009493227
Pennsylvania,CRAWFORD,90366,87263,1428,537,3103,0.965661864,0.034338136,0.0059425
Pennsylvania,CUMBERLAND,213674,199925,4959,2883,13749,0.935654315,0.064345685,0.013492517
Pennsylvania,DAUPHIN,251798,190347,41709,10404,61451,0.755951199,0.244048801,0.041318835
Pennsylvania,DELAWARE,550864,438416,79070,8368,112448,0.795869761,0.204130239,0.015190682
Pennsylvania,ELK,35112,34643,47,142,469,0.986642743,0.013357257,0.004044201
Pennsylvania,ERIE,280843,252258,16876,6126,28585,0.898217153,0.101782847,0.021812899
Pennsylvania,FAYETTE,148644,141265,5191,564,7379,0.950357902,0.049642098,0.0037943
Pennsylvania,FOREST,4946,4719,110,60,227,0.954104327,0.045895673,0.012131015
Pennsylvania,FRANKLIN,129313,122192,2891,2268,7121,0.944932064,0.055067936,0.01753884
Pennsylvania,FULTON,14261,13978,87,52,283,0.980155669,0.019844331,0.003646308
Pennsylvania,GREENE,40672,38365,1579,357,2307,0.943277931,0.056722069,0.008777537
Pennsylvania,HUNTINGDON,45586,42305,2334,524,3281,0.928026148,0.071973852,0.011494757
Pennsylvania,INDIANA,89605,86493,1391,457,3112,0.965269795,0.034730205,0.005100162
Pennsylvania,JEFFERSON,45932,45320,49,188,612,0.986675956,0.013324044,0.004093007
Pennsylvania,JUNIATA,22821,22205,68,369,616,0.973007318,0.026992682,0.016169318
Pennsylvania,LACKAWANNA,213295,204560,2662,2958,8735,0.959047329,0.040952671,0.013868117
Pennsylvania,LANCASTER,470658,420366,11837,26742,50292,0.893145341,0.106854659,0.056818327
Pennsylvania,LAWRENCE,94643,89573,3393,529,5070,0.94643027,0.05356973,0.005589426
Pennsylvania,LEBANON,120327,111034,1298,5969,9293,0.922768788,0.077231212,0.049606489
Pennsylvania,LEHIGH,312090,259811,9798,31881,52279,0.832487423,0.167512577,0.102153225
Pennsylvania,LUZERNE,319250,306528,5202,3713,12722,0.960150352,0.039849648,0.011630384
Pennsylvania,LYCOMING,120044,112306,5141,799,7738,0.935540302,0.064459698,0.006655893
Pennsylvania,MCKEAN,45936,44078,829,485,1858,0.959552421,0.040447579,0.010558168
Pennsylvania,MERCER,120293,111507,6279,803,8786,0.926961669,0.073038331,0.006675368
Pennsylvania,MIFFLIN,46486,45644,216,263,842,0.98188702,0.01811298,0.005657617
Pennsylvania,MONROE,138687,117592,7902,9195,21095,0.8478949,0.1521051,0.066300374
Pennsylvania,MONTGOMERY,750097,640019,55303,15300,110078,0.853248313,0.146751687,0.020397362
Pennsylvania,MONTOUR,18236,17552,182,167,684,0.962491775,0.037508225,0.00915771
Pennsylvania,NORTHAMPTON,267066,235666,6886,17868,31400,0.882426067,0.117573933,0.06690481
Pennsylvania,NORTHUMBERLAND,94556,91314,1397,1041,3242,0.96571344,0.03428656,0.011009349
Pennsylvania,PERRY,43602,42772,182,301,830,0.980964176,0.019035824,0.006903353
Pennsylvania,PHILADELPHIA,1517550,644395,646123,128928,873155,0.424628513,0.575371487,0.084957991
Pennsylvania,PIKE,46302,41569,1430,2315,4733,0.897779794,0.102220206,0.04999784
Pennsylvania,POTTER,18080,17660,52,103,420,0.976769912,0.023230088,0.005696903
Pennsylvania,SCHUYLKILL,150336,144290,3049,1671,6046,0.959783418,0.040216582,0.011115102
Pennsylvania,SNYDER,37546,36559,288,368,987,0.973712246,0.026287754,0.00980131
Pennsylvania,SOMERSET,80023,77736,1268,532,2287,0.971420717,0.028579283,0.006648089
Pennsylvania,SULLIVAN,6556,6239,140,72,317,0.951647346,0.048352654,0.010982306
Pennsylvania,SUSQUEHANNA,42238,41429,117,285,809,0.980846631,0.019153369,0.006747479
Pennsylvania,TIOGA,41373,40452,243,214,921,0.977739105,0.022260895,0.005172455
Pennsylvania,UNION,41624,36455,2640,1622,5169,0.875816836,0.124183164,0.038967903
Pennsylvania,VENANGO,57565,56016,614,298,1549,0.973091288,0.026908712,0.005176757
Pennsylvania,WARREN,43863,43176,89,151,687,0.984337597,0.015662403,0.003442537
Pennsylvania,WASHINGTON,202897,192511,6554,1170,10386,0.948811466,0.051188534,0.005766473
Pennsylvania,WAYNE,47722,45647,731,811,2075,0.956519006,0.043480994,0.016994258
Pennsylvania,WESTMORELAND,369993,355944,7375,1869,14049,0.962029011,0.037970989,0.005051447
Pennsylvania,WYOMING,28080,27473,137,187,607,0.978383191,0.021616809,0.006659544
Pennsylvania,YORK,381751,349456,13515,11296,32295,0.915402972,0.084597028,0.029589968
Rhode Island,BRISTOL,50648,48651,331,572,1997,0.960571,0.039429,0.011293634
Rhode Island,KENT,167090,158086,1451,2827,9004,0.946112873,0.053887127,0.016919026
Rhode Island,NEWPORT,85433,76940,2988,2409,8493,0.900588765,0.099411235,0.028197535
Rhode Island,PROVIDENCE,621602,458622,36078,83232,162980,0.737806506,0.262193494,0.133899183
Rhode Island,WASHINGTON,123546,116134,1074,1780,7412,0.940006152,0.059993848,0.014407589
South Carolina,ABBEVILLE,26167,17797,7879,217,8370,0.680131463,0.319868537,0.008292888
South Carolina,AIKEN,142552,100329,36254,3025,42223,0.70380633,0.29619367,0.021220327
South Carolina,ALLENDALE,11211,3030,7927,181,8181,0.27027027,0.72972973,0.016144858
South Carolina,ANDERSON,165740,134151,27399,1832,31589,0.809406299,0.190593701,0.011053457
South Carolina,BAMBERG,16658,6040,10352,118,10618,0.362588546,0.637411454,0.007083684
South Carolina,BARNWELL,23478,12857,9957,327,10621,0.547619048,0.452380952,0.013927933
South Carolina,BEAUFORT,120937,81477,28654,8208,39460,0.673714413,0.326285587,0.067870048
South Carolina,BERKELEY,142651,95314,37739,3935,47337,0.668162158,0.331837842,0.027584805
South Carolina,CALHOUN,15185,7521,7326,212,7664,0.495291406,0.504708594,0.013961146
South Carolina,CHARLESTON,309969,188542,106337,7434,121427,0.608260826,0.391739174,0.023983043
South Carolina,CHEROKEE,52537,40013,10751,1092,12524,0.761615623,0.238384377,0.020785351
South Carolina,CHESTER,34068,20304,13109,255,13764,0.595984502,0.404015498,0.00748503
South Carolina,CHESTERFIELD,42768,27172,14044,971,15596,0.63533483,0.36466517,0.022703891
South Carolina,CLARENDON,32502,14449,17193,560,18053,0.444557258,0.555442742,0.017229709
South Carolina,COLLETON,38264,21081,16021,551,17183,0.550935605,0.449064395,0.014399958
South Carolina,DARLINGTON,67394,38161,27970,658,29233,0.566237351,0.433762649,0.00976348
South Carolina,DILLON,30722,15309,13879,539,15413,0.498307402,0.501692598,0.017544431
South Carolina,DORCHESTER,96413,67578,24067,1722,28835,0.700922075,0.299077925,0.017860662
South Carolina,EDGEFIELD,24595,13645,10165,503,10950,0.554787558,0.445212442,0.020451311
South Carolina,FAIRFIELD,23454,9195,13810,250,14259,0.392044001,0.607955999,0.010659163
South Carolina,FLORENCE,125761,73216,49224,1383,52545,0.582183666,0.417816334,0.01099705
South Carolina,GEORGETOWN,55797,33011,21393,919,22786,0.59162679,0.40837321,0.01647042
South Carolina,GREENVILLE,379616,286663,69042,14283,92953,0.755139404,0.244860596,0.037624863
South Carolina,GREENWOOD,66271,42489,20893,1902,23782,0.641140167,0.358859833,0.028700336
South Carolina,HAMPTON,21386,8831,11832,547,12555,0.412933695,0.587066305,0.025577481
South Carolina,HORRY,196629,157040,30206,5057,39589,0.798661439,0.201338561,0.025718485
South Carolina,JASPER,20678,8374,10852,1190,12304,0.404971467,0.595028533,0.057549086
South Carolina,KERSHAW,52647,37226,13780,886,15421,0.707086824,0.292913176,0.016829069
South Carolina,LANCASTER,61351,43245,16397,978,18106,0.704878486,0.295121514,0.01594106
South Carolina,LAURENS,69567,49358,18172,1352,20209,0.709503069,0.290496931,0.019434502
South Carolina,LEE,20119,6961,12736,264,13158,0.345991351,0.654008649,0.013121925
South Carolina,LEXINGTON,216014,179731,27132,4146,36283,0.832034035,0.167965965,0.0191932
South Carolina,MCCORMICK,9958,4426,5349,86,5532,0.44446676,0.55553324,0.008636272
South Carolina,MARION,35466,14589,19860,634,20877,0.411351717,0.588648283,0.017876276
South Carolina,MARLBORO,28818,12767,14559,205,16051,0.443021723,0.556978277,0.00711361
South Carolina,NEWBERRY,36108,22270,11893,1533,13838,0.616760829,0.383239171,0.042455965
South Carolina,OCONEE,66215,58259,5533,1562,7956,0.879845956,0.120154044,0.023589821
South Carolina,ORANGEBURG,91582,33721,55507,875,57861,0.368205543,0.631794457,0.009554279
South Carolina,PICKENS,110757,98961,7517,1879,11796,0.893496574,0.106503426,0.016965068
South Carolina,RICHLAND,320677,157843,143773,8713,162834,0.492218026,0.507781974,0.027170642
South Carolina,SALUDA,19181,11936,5707,1401,7245,0.622282467,0.377717533,0.07304103
South Carolina,SPARTANBURG,253791,187752,52506,7081,66039,0.739789827,0.260210173,0.027900911
South Carolina,SUMTER,104646,51664,48617,1918,52982,0.493702578,0.506297422,0.01832846
South Carolina,UNION,29881,20155,9247,199,9726,0.674508885,0.325491115,0.00665975
South Carolina,WILLIAMSBURG,37217,12101,24546,273,25116,0.32514711,0.67485289,0.007335357
South Carolina,YORK,164614,125737,31380,3220,38877,0.763829322,0.236170678,0.019560912
South Dakota,AURORA,3058,2908,9,64,150,0.950948332,0.049051668,0.020928712
South Dakota,BEADLE,17023,16418,118,155,605,0.964459848,0.035540152,0.009105328
South Dakota,BENNETT,3574,1449,10,72,2125,0.405428092,0.594571908,0.020145495
South Dakota,BON HOMME,7260,6920,44,42,340,0.953168044,0.046831956,0.005785124
South Dakota,BROOKINGS,28220,27062,85,247,1158,0.958965273,0.041034727,0.008752658
South Dakota,BROWN,35460,33715,97,237,1745,0.950789622,0.049210378,0.006683587
South Dakota,BRULE,5364,4807,14,26,557,0.896159582,0.103840418,0.004847129
South Dakota,BUFFALO,2032,332,2,18,1700,0.163385827,0.836614173,0.008858268
South Dakota,BUTTE,9094,8557,7,266,537,0.940950077,0.059049923,0.029250055
South Dakota,CAMPBELL,1782,1766,0,4,16,0.991021324,0.008978676,0.002244669
South Dakota,CHARLES MIX,9350,6473,12,177,2877,0.692299465,0.307700535,0.018930481
South Dakota,CLARK,4143,4081,3,20,62,0.985034999,0.014965001,0.00482742
South Dakota,CLAY,13537,12498,128,120,1039,0.923247396,0.076752604,0.008864593
South Dakota,CODINGTON,25897,24948,32,274,949,0.963354829,0.036645171,0.010580376
South Dakota,CORSON,4181,1551,4,89,2630,0.370963884,0.629036116,0.021286773
South Dakota,CUSTER,7275,6794,17,110,481,0.933883162,0.066116838,0.015120275
South Dakota,DAVISON,18741,17988,48,130,753,0.959820714,0.040179286,0.006936663
South Dakota,DAY,6267,5714,8,24,553,0.911760013,0.088239987,0.003829584
South Dakota,DEUEL,4498,4405,4,34,93,0.979324144,0.020675856,0.007558915
South Dakota,DEWEY,5972,1438,2,51,4534,0.240790355,0.759209645,0.008539853
South Dakota,DOUGLAS,3458,3384,2,13,74,0.978600347,0.021399653,0.003759398
South Dakota,EDMUNDS,4367,4317,3,21,50,0.988550492,0.011449508,0.004808793
South Dakota,FALL RIVER,7453,6656,24,130,797,0.893063196,0.106936804,0.017442641
South Dakota,FAULK,2640,2620,2,6,20,0.992424242,0.007575758,0.002272727
South Dakota,GRANT,7847,7729,1,43,118,0.984962406,0.015037594,0.005479801
South Dakota,GREGORY,4792,4432,2,41,360,0.924874791,0.075125209,0.008555927
South Dakota,HAAKON,2196,2105,0,13,91,0.95856102,0.04143898,0.005919854
South Dakota,HAMLIN,5540,5428,7,35,112,0.979783394,0.020216606,0.00631769
South Dakota,HAND,3741,3709,1,11,32,0.991446137,0.008553863,0.00294039
South Dakota,HANSON,3139,3122,0,3,17,0.994584263,0.005415737,0.000955718
South Dakota,HARDING,1353,1307,4,22,46,0.966001478,0.033998522,0.016260163
South Dakota,HUGHES,16481,14564,30,201,1917,0.883684242,0.116315758,0.012195862
South Dakota,HUTCHINSON,8075,7948,5,42,127,0.984272446,0.015727554,0.005201238
South Dakota,HYDE,1671,1519,2,8,152,0.909036505,0.090963495,0.004787552
South Dakota,JACKSON,2930,1465,1,12,1465,0.5,0.5,0.004095563
South Dakota,JERAULD,2295,2265,0,7,30,0.986928105,0.013071895,0.003050109
South Dakota,JONES,1193,1141,0,4,52,0.956412406,0.043587594,0.003352892
South Dakota,KINGSBURY,5815,5703,3,40,112,0.980739467,0.019260533,0.006878762
South Dakota,LAKE,11276,10981,23,89,295,0.973838241,0.026161759,0.00789287
South Dakota,LAWRENCE,21802,20631,45,396,1171,0.946289331,0.053710669,0.018163471
South Dakota,LINCOLN,24131,23470,78,169,661,0.972607849,0.027392151,0.00700344
South Dakota,LYMAN,3895,2512,3,18,1383,0.644929397,0.355070603,0.004621309
South Dakota,MCCOOK,5832,5731,3,45,101,0.982681756,0.017318244,0.007716049
South Dakota,MCPHERSON,2904,2880,0,6,24,0.991735537,0.008264463,0.002066116
South Dakota,MARSHALL,4576,4221,4,35,355,0.922421329,0.077578671,0.007648601
South Dakota,MEADE,24253,22212,346,509,2041,0.915845462,0.084154538,0.020987094
South Dakota,MELLETTE,2083,926,0,35,1157,0.444551128,0.555448872,0.016802688
South Dakota,MINER,2884,2833,15,18,51,0.982316227,0.017683773,0.006241331
South Dakota,MINNEHAHA,148281,136632,2217,3187,11649,0.921439699,0.078560301,0.021492976
South Dakota,MOODY,6595,5576,19,50,1019,0.845489007,0.154510993,0.007581501
South Dakota,PENNINGTON,88565,75797,722,2341,12768,0.855834698,0.144165302,0.026432564
South Dakota,PERKINS,3363,3245,3,25,118,0.964912281,0.035087719,0.007433839
South Dakota,POTTER,2693,2640,0,5,53,0.980319346,0.019680654,0.001856665
South Dakota,ROBERTS,10016,6821,10,63,3195,0.681010383,0.318989617,0.006289936
South Dakota,SANBORN,2675,2621,1,27,54,0.979813084,0.020186916,0.010093458
South Dakota,SHANNON,12466,554,10,177,11912,0.044440879,0.955559121,0.01419862
South Dakota,SPINK,7454,7254,16,29,200,0.973168768,0.026831232,0.003890529
South Dakota,STANLEY,2772,2575,5,12,197,0.928932179,0.071067821,0.004329004
South Dakota,SULLY,1556,1516,0,12,40,0.974293059,0.025706941,0.007712082
South Dakota,TODD,9050,1127,8,138,7923,0.124530387,0.875469613,0.015248619
South Dakota,TRIPP,6430,5605,2,55,825,0.871695179,0.128304821,0.008553655
South Dakota,TURNER,8849,8724,12,36,125,0.98587411,0.01412589,0.004068256
South Dakota,UNION,12584,12081,40,158,503,0.960028608,0.039971392,0.012555626
South Dakota,WALWORTH,5974,5153,2,36,821,0.862571142,0.137428858,0.006026113
South Dakota,YANKTON,21652,20365,248,395,1287,0.940559764,0.059440236,0.018243118
South Dakota,ZIEBACH,2519,664,0,25,1855,0.263596665,0.736403335,0.009924573
Tennessee,ANDERSON,71330,66124,2749,787,5206,0.927015281,0.072984719,0.011033226
Tennessee,BEDFORD,37586,31060,3152,2811,6526,0.826371521,0.173628479,0.074788485
Tennessee,BENTON,16537,15834,348,157,703,0.957489266,0.042510734,0.009493862
Tennessee,BLEDSOE,12367,11583,454,138,784,0.936605482,0.063394518,0.011158729
Tennessee,BLOUNT,105823,99596,3052,1120,6227,0.941156459,0.058843541,0.010583711
Tennessee,BRADLEY,87965,80917,3481,1822,7048,0.919877224,0.080122776,0.020712783
Tennessee,CAMPBELL,39854,38913,119,269,941,0.976388819,0.023611181,0.006749636
Tennessee,CANNON,12826,12331,179,157,495,0.961406518,0.038593482,0.012240761
Tennessee,CARROLL,29475,25643,3030,386,3832,0.869991518,0.130008482,0.013095844
Tennessee,CARTER,56742,54996,558,504,1746,0.969229142,0.030770858,0.008882309
Tennessee,CHEATHAM,35912,34506,519,437,1406,0.960848741,0.039151259,0.012168634
Tennessee,CHESTER,15540,13612,1557,150,1928,0.875933076,0.124066924,0.00965251
Tennessee,CLAIBORNE,29862,29074,224,192,788,0.973611948,0.026388052,0.006429576
Tennessee,CLAY,7976,7664,105,108,312,0.960882648,0.039117352,0.013540622
Tennessee,COCKE,33565,32056,668,354,1509,0.955042455,0.044957545,0.0105467
Tennessee,COFFEE,48014,44324,1689,1051,3690,0.923147415,0.076852585,0.021889449
Tennessee,CROCKETT,14532,11549,2077,793,2983,0.794728874,0.205271126,0.054569227
Tennessee,CUMBERLAND,46802,45603,58,578,1199,0.974381437,0.025618563,0.0123499
Tennessee,DAVIDSON,569891,371150,146939,26091,198741,0.651264891,0.348735109,0.045782439
Tennessee,DECATUR,11731,10954,406,229,777,0.933765237,0.066234763,0.019520927
Tennessee,DEKALB,17423,16338,249,633,1085,0.937725994,0.062274006,0.036331286
Tennessee,DICKSON,43156,40020,1958,484,3136,0.927333395,0.072666605,0.011215127
Tennessee,DYER,37279,31602,4784,434,5677,0.847715872,0.152284128,0.011641943
Tennessee,FAYETTE,28806,17858,10312,298,10948,0.61994029,0.38005971,0.010345067
Tennessee,FENTRESS,16625,16419,18,90,206,0.987609023,0.012390977,0.005413534
Tennessee,FRANKLIN,39270,35877,2145,620,3393,0.913598167,0.086401833,0.015788133
Tennessee,GIBSON,48152,37661,9447,540,10491,0.78212743,0.21787257,0.011214487
Tennessee,GILES,29447,25281,3450,266,4166,0.858525486,0.141474514,0.009033178
Tennessee,GRAINGER,20659,20189,67,226,470,0.977249625,0.022750375,0.010939542
Tennessee,GREENE,62909,60309,1320,641,2600,0.958670461,0.041329539,0.010189321
Tennessee,GRUNDY,14332,14010,19,141,322,0.977532794,0.022467206,0.009838124
Tennessee,HAMBLEN,58128,51461,2364,3299,6667,0.885304844,0.114695156,0.05675406
Tennessee,HAMILTON,307896,232475,61750,5481,75421,0.755043911,0.244956089,0.017801465
Tennessee,HANCOCK,6786,6625,33,25,161,0.976274683,0.023725317,0.003684055
Tennessee,HARDEMAN,28105,15994,11474,273,12111,0.569080235,0.430919765,0.009713574
Tennessee,HARDIN,25578,24099,941,260,1479,0.942176871,0.057823129,0.010164986
Tennessee,HAWKINS,53563,51799,822,417,1764,0.967066819,0.032933181,0.007785225
Tennessee,HAYWOOD,19797,9088,10066,524,10709,0.459059453,0.540940547,0.026468657
Tennessee,HENDERSON,25522,22932,2034,247,2590,0.898518925,0.101481075,0.009677925
Tennessee,HENRY,31115,27596,2777,311,3519,0.886903423,0.113096577,0.009995179
Tennessee,HICKMAN,22295,20761,1007,222,1534,0.931195335,0.068804665,0.00995739
Tennessee,HOUSTON,8088,7611,266,101,477,0.941023739,0.058976261,0.012487636
Tennessee,HUMPHREYS,17929,17030,522,148,899,0.949857772,0.050142228,0.008254783
Tennessee,JACKSON,10984,10763,16,89,221,0.979879825,0.020120175,0.008102695
Tennessee,JEFFERSON,44294,42102,1016,588,2192,0.950512485,0.049487515,0.013274936
Tennessee,JOHNSON,17499,16761,420,150,738,0.957826161,0.042173839,0.008571918
Tennessee,KNOX,382032,333993,32788,4803,48039,0.874253989,0.125746011,0.012572245
Tennessee,LAKE,7954,5268,2464,109,2686,0.662308273,0.337691727,0.013703797
Tennessee,LAUDERDALE,27101,17187,9192,314,9914,0.63418324,0.36581676,0.011586288
Tennessee,LAWRENCE,39926,38431,586,399,1495,0.962555728,0.037444272,0.009993488
Tennessee,LEWIS,11367,10940,164,136,427,0.962435119,0.037564881,0.011964459
Tennessee,LINCOLN,31340,28089,2293,321,3251,0.896266752,0.103733248,0.010242502
Tennessee,LOUDON,39086,37210,440,894,1876,0.952003275,0.047996725,0.02287264
Tennessee,MCMINN,49015,45030,2172,884,3985,0.918698358,0.081301642,0.018035295
Tennessee,MCNAIRY,24653,22576,1532,229,2077,0.915750619,0.084249381,0.00928893
Tennessee,MACON,20386,19784,36,349,602,0.97046993,0.02953007,0.017119592
Tennessee,MADISON,91837,59153,29657,1572,32684,0.644108584,0.355891416,0.017117284
Tennessee,MARION,27776,26089,1144,202,1687,0.939264113,0.060735887,0.007272465
Tennessee,MARSHALL,26767,23595,2076,767,3172,0.881495872,0.118504128,0.028654687
Tennessee,MAURY,69498,56327,9821,2264,13171,0.810483755,0.189516245,0.032576477
Tennessee,MEIGS,11086,10788,137,63,298,0.97311925,0.02688075,0.005682843
Tennessee,MONROE,38961,36677,873,684,2284,0.941377275,0.058622725,0.017556018
Tennessee,MONTGOMERY,134768,95515,25496,6960,39253,0.708736495,0.291263505,0.051644307
Tennessee,MOORE,5740,5488,155,45,252,0.956097561,0.043902439,0.007839721
Tennessee,MORGAN,19757,19016,440,120,741,0.962494306,0.037505694,0.006073797
Tennessee,OBION,32450,28335,3174,616,4115,0.873189522,0.126810478,0.018983051
Tennessee,OVERTON,20118,19752,54,138,366,0.981807337,0.018192663,0.006859529
Tennessee,PERRY,7631,7333,130,61,298,0.960948762,0.039051238,0.00799371
Tennessee,PICKETT,4945,4870,5,41,75,0.984833165,0.015166835,0.008291203
Tennessee,POLK,16050,15689,22,117,361,0.977507788,0.022492212,0.00728972
Tennessee,PUTNAM,62315,58088,1039,1891,4227,0.932167215,0.067832785,0.030345824
Tennessee,RHEA,28400,26880,564,474,1520,0.946478873,0.053521127,0.016690141
Tennessee,ROANE,51910,49199,1405,359,2711,0.947774995,0.052225005,0.006915816
Tennessee,ROBERTSON,54433,47644,4631,1447,6789,0.875277865,0.124722135,0.026583139
Tennessee,RUTHERFORD,182023,153762,17197,5065,28261,0.844739401,0.155260599,0.027826154
Tennessee,SCOTT,21127,20721,19,120,406,0.980782884,0.019217116,0.005679936
Tennessee,SEQUATCHIE,11370,11143,19,93,227,0.98003518,0.01996482,0.00817942
Tennessee,SEVIER,71170,68699,391,884,2471,0.965280315,0.034719685,0.012420964
Tennessee,SHELBY,897472,414888,434201,23364,482584,0.462285174,0.537714826,0.026033124
Tennessee,SMITH,17712,16809,447,200,903,0.949017615,0.050982385,0.01129178
Tennessee,STEWART,12370,11701,155,124,669,0.945917542,0.054082458,0.010024252
Tennessee,SULLIVAN,153048,147036,2868,1090,6012,0.960718206,0.039281794,0.007121949
Tennessee,SUMNER,130449,118221,7488,2291,12228,0.906262217,0.093737783,0.017562419
Tennessee,TIPTON,51271,39603,10158,622,11668,0.772424958,0.227575042,0.012131614
Tennessee,TROUSDALE,7259,6249,824,110,1010,0.860862378,0.139137622,0.015153602
Tennessee,UNICOI,17667,17161,10,342,506,0.971359031,0.028640969,0.019358125
Tennessee,UNION,17808,17426,18,140,382,0.978548967,0.021451033,0.007861635
Tennessee,VAN BUREN,5508,5437,7,18,71,0.987109659,0.012890341,0.003267974
Tennessee,WARREN,38276,34688,1196,1885,3588,0.906259797,0.093740203,0.04924757
Tennessee,WASHINGTON,107198,99578,4058,1482,7620,0.928916584,0.071083416,0.013824885
Tennessee,WAYNE,16842,15383,1143,142,1459,0.913371334,0.086628666,0.008431303
Tennessee,WEAKLEY,34895,31318,2409,402,3577,0.897492477,0.102507523,0.011520275
Tennessee,WHITE,23102,22196,377,239,906,0.960782616,0.039217384,0.010345425
Tennessee,WILLIAMSON,126638,114177,6543,3197,12461,0.901601415,0.098398585,0.025245187
Tennessee,WILSON,88809,80638,5545,1127,8171,0.907993559,0.092006441,0.012690155
Texas,ANDERSON,55109,34762,12897,6705,20347,0.63078626,0.36921374,0.121667967
Texas,ANDREWS,13004,7322,195,5202,5682,0.563057521,0.436942479,0.40003076
Texas,ANGELINA,80130,55615,11656,11496,24515,0.694059653,0.305940347,0.143466866
Texas,ARANSAS,22497,16596,303,4571,5901,0.73769836,0.26230164,0.203182647
Texas,ARCHER,8854,8263,7,431,591,0.933250508,0.066749492,0.048678563
Texas,ARMSTRONG,2148,2008,4,116,140,0.934823091,0.065176909,0.054003724
Texas,ATASCOSA,38628,15284,179,22620,23344,0.395671534,0.604328466,0.585585586
Texas,AUSTIN,23590,16964,2475,3805,6626,0.71911827,0.28088173,0.16129716
Texas,BAILEY,6594,3317,76,3119,3277,0.50303306,0.49696694,0.473005763
Texas,BANDERA,17645,14833,50,2384,2812,0.840634741,0.159365259,0.135109096
Texas,BASTROP,57733,37764,4938,13845,19969,0.654114631,0.345885369,0.239810853
Texas,BAYLOR,4093,3511,135,382,582,0.85780601,0.14219399,0.093330076
Texas,BEE,32359,11352,3145,17450,21007,0.350814302,0.649185698,0.539262647
Texas,BELL,237974,136241,47344,39701,101733,0.572503719,0.427496281,0.166829149
Texas,BEXAR,1392931,496245,95984,757033,896686,0.356259571,0.643740429,0.543482053
Texas,BLANCO,8418,6912,60,1290,1506,0.821097648,0.178902352,0.153243051
Texas,BORDEN,729,624,1,87,105,0.855967078,0.144032922,0.119341564
Texas,BOSQUE,17204,14507,320,2104,2697,0.843234132,0.156765868,0.12229714
Texas,BOWIE,89306,62712,20787,3992,26594,0.702214857,0.297785143,0.044700244
Texas,BRAZORIA,241767,158052,20183,55063,83715,0.653736862,0.346263138,0.22775234
Texas,BRAZOS,152415,100647,16146,27253,51768,0.660348391,0.339651609,0.17880786
Texas,BREWSTER,8866,4710,87,3867,4156,0.531242951,0.468757049,0.436160614
Texas,BRISCOE,1790,1319,40,407,471,0.736871508,0.263128492,0.227374302
Texas,BROOKS,7976,633,5,7304,7343,0.079363089,0.920636911,0.915747242
Texas,BROWN,37674,29772,1473,5793,7902,0.790253225,0.209746775,0.153766523
Texas,BURLESON,16470,11361,2443,2411,5109,0.689799636,0.310200364,0.146387371
Texas,BURNET,34147,28017,500,5044,6130,0.820482034,0.179517966,0.147714294
Texas,CALDWELL,32194,15929,2674,13018,16265,0.494781636,0.505218364,0.404361061
Texas,CALHOUN,20647,10774,521,8448,9873,0.52181915,0.47818085,0.409163559
Texas,CALLAHAN,12905,11822,27,812,1083,0.916079039,0.083920961,0.062921348
Texas,CAMERON,335227,48679,909,282736,286548,0.14521205,0.85478795,0.843416551
Texas,CAMP,11549,7507,2201,1707,4042,0.650012988,0.349987012,0.147805005
Texas,CARSON,6516,5904,38,458,612,0.906077348,0.093922652,0.070288521
Texas,CASS,30438,23542,5915,526,6896,0.773441093,0.226558907,0.01728103
Texas,CASTRO,8285,3765,182,4279,4520,0.454435727,0.545564273,0.516475558
Texas,CHAMBERS,26031,20210,2525,2810,5821,0.776382006,0.223617994,0.107948216
Texas,CHEROKEE,46659,32347,7409,6178,14312,0.693263893,0.306736107,0.132407467
Texas,CHILDRESS,7688,4923,1074,1574,2765,0.640348595,0.359651405,0.204734651
Texas,CLAY,11006,10317,43,404,689,0.937397783,0.062602217,0.036707251
Texas,COCHRAN,3730,1864,168,1646,1866,0.499731903,0.500268097,0.441286863
Texas,COKE,3864,3079,74,653,785,0.79684265,0.20315735,0.168995859
Texas,COLEMAN,9235,7599,199,1289,1636,0.822847861,0.177152139,0.139577694
Texas,COLLIN,491675,374116,23212,50510,117559,0.760901002,0.239098998,0.102730462
Texas,COLLINGSWORTH,3206,2289,169,655,917,0.713973799,0.286026201,0.204304429
Texas,COLORADO,20390,13165,2962,4024,7225,0.645659637,0.354340363,0.197351643
Texas,COMAL,78021,58345,693,17609,19676,0.747811487,0.252188513,0.225695646
Texas,COMANCHE,14026,10846,62,2928,3180,0.773278198,0.226721802,0.208755169
Texas,CONCHO,3966,2265,38,1639,1701,0.571104387,0.428895613,0.413262733
Texas,COOKE,36363,30826,1087,3627,5537,0.847729835,0.152270165,0.099744246
Texas,CORYELL,74978,45381,15976,9424,29597,0.605257542,0.394742458,0.125690202
Texas,COTTLE,1904,1348,176,360,556,0.707983193,0.292016807,0.18907563
Texas,CRANE,3996,2083,116,1753,1913,0.521271271,0.478728729,0.438688689
Texas,CROCKETT,4099,1792,18,2242,2307,0.4371798,0.5628202,0.546962674
Texas,CROSBY,7072,3301,262,3460,3771,0.466770362,0.533229638,0.489253394
Texas,CULBERSON,2975,733,19,2149,2242,0.246386555,0.753613445,0.722352941
Texas,DALLAM,6222,4257,100,1766,1965,0.684185149,0.315814851,0.283831565
Texas,DALLAS,2218899,983317,445716,662729,1235582,0.443155367,0.556844633,0.298674703
Texas,DAWSON,14985,6349,1285,7222,8636,0.423690357,0.576309643,0.481948615
Texas,DEAF SMITH,18561,7491,247,10654,11070,0.403588169,0.596411831,0.573999246
Texas,DELTA,5327,4616,440,165,711,0.866529003,0.133470997,0.030974282
Texas,DENTON,432976,328849,24980,52619,104127,0.75950861,0.24049139,0.121528676
Texas,DEWITT,20013,12168,2158,5452,7845,0.608004797,0.391995203,0.272422925
Texas,DICKENS,2762,1857,223,660,905,0.672338885,0.327661115,0.238957277
Texas,DIMMIT,10248,1350,67,8708,8898,0.131733021,0.868266979,0.849726776
Texas,DONLEY,3828,3372,151,243,456,0.880877743,0.119122257,0.063479624
Texas,DUVAL,13120,1452,57,11544,11668,0.110670732,0.889329268,0.879878049
Texas,EASTLAND,18297,15686,397,1976,2611,0.857299011,0.142700989,0.107995846
Texas,ECTOR,121123,62168,5370,51306,58955,0.513263377,0.486736623,0.423585942
Texas,EDWARDS,2162,1161,3,974,1001,0.537002775,0.462997225,0.450508788
Texas,ELLIS,111360,79401,9514,20508,31959,0.713011853,0.286988147,0.184159483
Texas,EL PASO,679622,115535,18671,531654,564087,0.169998911,0.830001089,0.782278973
Texas,ERATH,33001,27269,257,4959,5732,0.826308294,0.173691706,0.150268174
Texas,FALLS,18576,10364,5064,2941,8212,0.557924203,0.442075797,0.158322567
Texas,FANNIN,31242,26298,2482,1753,4944,0.841751488,0.158248512,0.056110364
Texas,FAYETTE,21804,17271,1508,2786,4533,0.792102367,0.207897633,0.12777472
Texas,FISHER,4344,3250,110,928,1094,0.748158379,0.251841621,0.213627993
Texas,FLOYD,7771,3875,252,3569,3896,0.498648823,0.501351177,0.459271651
Texas,FOARD,1622,1277,52,265,345,0.78729963,0.21270037,0.163378545
Texas,FORT BEND,354452,163788,69579,74871,190664,0.462087955,0.537912045,0.211230294
Texas,FRANKLIN,9458,8129,364,842,1329,0.859484035,0.140515965,0.089025164
Texas,FREESTONE,17867,12823,3359,1465,5044,0.717691834,0.282308166,0.081994739
Texas,FRIO,16252,3344,777,11987,12908,0.205759291,0.794240709,0.737570761
Texas,GAINES,14467,8803,304,5175,5664,0.608488284,0.391511716,0.357710652
Texas,GALVESTON,250158,157851,38179,44939,92307,0.631005205,0.368994795,0.179642466
Texas,GARZA,4872,2760,221,1810,2112,0.566502463,0.433497537,0.371510673
Texas,GILLESPIE,20814,17232,30,3309,3582,0.827904295,0.172095705,0.158979533
Texas,GLASSCOCK,1406,955,6,420,451,0.679231863,0.320768137,0.298719772
Texas,GOLIAD,6928,4115,317,2439,2813,0.593966513,0.406033487,0.352049654
Texas,GONZALES,18628,9539,1493,7381,9089,0.512078591,0.487921409,0.396231479
Texas,GRAY,22744,17800,1309,2959,4944,0.782623989,0.217376011,0.130100246
Texas,GRAYSON,110595,92857,6385,7519,17738,0.839613002,0.160386998,0.067986799
Texas,GREGG,111379,76851,21989,10183,34528,0.689995421,0.310004579,0.091426571
Texas,GRIMES,23552,14772,4667,3787,8780,0.62720788,0.37279212,0.160793139
Texas,GUADALUPE,89023,52858,4310,29561,36165,0.59375667,0.40624333,0.332060254
Texas,HALE,36602,16526,2044,17532,20076,0.451505382,0.548494618,0.478990219
Texas,HALL,3782,2397,297,1040,1385,0.633791645,0.366208355,0.274986779
Texas,HAMILTON,8229,7498,11,610,731,0.911167821,0.088832179,0.074128084
Texas,HANSFORD,5369,3604,1,1690,1765,0.671260942,0.328739058,0.314769976
Texas,HARDEMAN,4724,3731,227,685,993,0.789796782,0.210203218,0.145004234
Texas,HARDIN,48073,42941,3310,1223,5132,0.893245689,0.106754311,0.025440476
Texas,HARRIS,3400578,1432264,619694,1119751,1968314,0.421182517,0.578817483,0.329282551
Texas,HARRISON,62110,43044,14861,3316,19066,0.693028498,0.306971502,0.053389148
Texas,HARTLEY,5537,4270,445,758,1267,0.771175727,0.228824273,0.136897237
Texas,HASKELL,6093,4600,160,1249,1493,0.754964714,0.245035286,0.204989332
Texas,HAYS,97589,62945,3448,28859,34644,0.645000973,0.354999027,0.295719804
Texas,HEMPHILL,3351,2722,52,522,629,0.812294837,0.187705163,0.155774396
Texas,HENDERSON,73277,62124,4811,5071,11153,0.847796717,0.152203283,0.069203161
Texas,HIDALGO,569463,59423,1934,503100,510040,0.104349185,0.895650815,0.883463895
Texas,HILL,32321,25079,2359,4360,7242,0.775935151,0.224064849,0.134896816
Texas,HOCKLEY,22716,13155,822,8459,9561,0.579107237,0.420892763,0.372380701
Texas,HOOD,41100,37193,112,2975,3907,0.904939173,0.095060827,0.072384428
Texas,HOPKINS,31960,25946,2525,2967,6014,0.811827284,0.188172716,0.092834793
Texas,HOUSTON,23185,14775,6442,1739,8410,0.637265473,0.362734527,0.075005391
Texas,HOWARD,33627,19096,1292,12597,14531,0.567877004,0.432122996,0.374609689
Texas,HUDSPETH,3344,770,7,2509,2574,0.230263158,0.769736842,0.750299043
Texas,HUNT,76596,61170,7183,6366,15426,0.798605671,0.201394329,0.08311139
Texas,HUTCHINSON,23857,19104,563,3506,4753,0.800771262,0.199228738,0.146958964
Texas,IRION,1771,1321,4,436,450,0.745906268,0.254093732,0.246188594
Texas,JACK,8763,7468,481,691,1295,0.85221956,0.14778044,0.078854274
Texas,JACKSON,14391,9546,1081,3551,4845,0.663331249,0.336668751,0.246751442
Texas,JASPER,35604,27320,6302,1384,8284,0.767329514,0.232670486,0.038872037
Texas,JEFF DAVIS,2207,1376,16,783,831,0.623470775,0.376529225,0.354780245
Texas,JEFFERSON,252051,130604,84482,26536,121447,0.518164975,0.481835025,0.105280281
Texas,JIM HOGG,5281,474,22,4752,4807,0.089755728,0.910244272,0.899829578
Texas,JIM WELLS,39326,9001,166,29772,30325,0.228881656,0.771118344,0.7570564
Texas,JOHNSON,126811,105460,3058,15375,21351,0.831631325,0.168368675,0.121243425
Texas,JONES,20785,13752,2368,4346,7033,0.661630984,0.338369016,0.209093096
Texas,KARNES,15446,6309,1603,7324,9137,0.408455263,0.591544737,0.474168069
Texas,KAUFMAN,71313,54424,7472,7925,16889,0.76317081,0.23682919,0.111129808
Texas,KENDALL,23743,19104,63,4248,4639,0.804616097,0.195383903,0.178915891
Texas,KENEDY,414,84,0,327,330,0.202898551,0.797101449,0.789855072
Texas,KENT,859,777,2,78,82,0.904540163,0.095459837,0.09080326
Texas,KERR,43653,33802,738,8353,9851,0.774333952,0.225666048,0.191349964
Texas,KIMBLE,4468,3481,3,926,987,0.779095792,0.220904208,0.207251567
Texas,KING,356,315,0,34,41,0.884831461,0.115168539,0.095505618
Texas,KINNEY,3379,1587,44,1707,1792,0.469665582,0.530334418,0.505179047
Texas,KLEBERG,31549,8997,1091,20635,22552,0.285175441,0.714824559,0.654061935
Texas,KNOX,4253,2829,292,1067,1424,0.665177522,0.334822478,0.250881731
Texas,LAMAR,48499,39116,6493,1614,9383,0.806532093,0.193467907,0.033279037
Texas,LAMB,14709,7553,615,6393,7156,0.513495139,0.486504861,0.434631858
Texas,LAMPASAS,17762,14121,511,2677,3641,0.795011823,0.204988177,0.15071501
Texas,LA SALLE,5866,1114,192,4524,4752,0.189907944,0.810092056,0.771224003
Texas,LAVACA,19210,15579,1287,2183,3631,0.810983863,0.189016137,0.11363873
Texas,LEE,15657,10724,1872,2848,4933,0.684933257,0.315066743,0.18189947
Texas,LEON,15335,12366,1583,1213,2969,0.80639061,0.19360939,0.079100098
Texas,LIBERTY,70154,52289,8952,7660,17865,0.745345953,0.254654047,0.109188357
Texas,LIMESTONE,22051,14711,4186,2859,7340,0.667135277,0.332864723,0.129653984
Texas,LIPSCOMB,3057,2344,13,633,713,0.766764802,0.233235198,0.207065751
Texas,LIVE OAK,12309,7199,281,4683,5110,0.584856609,0.415143391,0.380453327
Texas,LLANO,17044,15869,51,875,1175,0.931060784,0.068939216,0.051337714
Texas,LOVING,67,60,0,7,7,0.895522388,0.104477612,0.104477612
Texas,LUBBOCK,242628,151705,18184,66609,90923,0.625257596,0.374742404,0.274531381
Texas,LYNN,6550,3377,166,2923,3173,0.515572519,0.484427481,0.446259542
Texas,MCCULLOCH,8205,5792,123,2219,2413,0.70591103,0.29408897,0.270444851
Texas,MCLENNAN,213517,138008,32065,38233,75509,0.646356028,0.353643972,0.179063025
Texas,MCMULLEN,851,556,10,282,295,0.653349001,0.346650999,0.331374853
Texas,MADISON,12940,7801,2915,2042,5139,0.602859351,0.397140649,0.157805255
Texas,MARION,10941,7818,2599,263,3123,0.714559912,0.285440088,0.024038022
Texas,MARTIN,4746,2696,74,1925,2050,0.568057311,0.431942689,0.40560472
Texas,MASON,3738,2912,5,783,826,0.779026217,0.220973783,0.209470305
Texas,MATAGORDA,37957,19900,4778,11898,18057,0.524277472,0.475722528,0.313459968
Texas,MAVERICK,47297,1610,53,44938,45687,0.034040214,0.965959786,0.950123686
Texas,MEDINA,39304,19919,801,17873,19385,0.506793202,0.493206798,0.454737431
Texas,MENARD,2360,1567,10,748,793,0.663983051,0.336016949,0.316949153
Texas,MIDLAND,116009,72015,7940,33676,43994,0.620770802,0.379229198,0.290287822
Texas,MILAM,24238,16763,2627,4516,7475,0.691599967,0.308400033,0.186319003
Texas,MILLS,5151,4367,61,671,784,0.847796544,0.152203456,0.130265968
Texas,MITCHELL,9698,5341,1229,3009,4357,0.55073211,0.44926789,0.310270159
Texas,MONTAGUE,19117,17717,28,1035,1400,0.926766752,0.073233248,0.054140294
Texas,MONTGOMERY,293768,239150,10076,37150,54618,0.814077776,0.185922224,0.126460336
Texas,MOORE,20121,10038,89,9558,10083,0.498881765,0.501118235,0.475026092
Texas,MORRIS,13048,9217,3137,477,3831,0.706391784,0.293608216,0.036557327
Texas,MOTLEY,1426,1172,50,173,254,0.821879383,0.178120617,0.121318373
Texas,NACOGDOCHES,59203,41620,9815,6660,17583,0.703004915,0.296995085,0.112494299
Texas,NAVARRO,45124,29596,7521,7113,15528,0.655881571,0.344118429,0.157632302
Texas,NEWTON,15072,11157,3100,571,3915,0.740246815,0.259753185,0.03788482
Texas,NOLAN,15802,10480,713,4431,5322,0.663207189,0.336792811,0.280407543
Texas,NUECES,313645,118178,12718,174951,195467,0.376789045,0.623210955,0.557799423
Texas,OCHILTREE,9006,5972,8,2863,3034,0.66311348,0.33688652,0.317899178
Texas,OLDHAM,2185,1852,41,241,333,0.847597254,0.152402746,0.110297483
Texas,ORANGE,84966,72955,7080,3073,12011,0.858637573,0.141362427,0.036167408
Texas,PALO PINTO,27026,22163,617,3667,4863,0.820062162,0.179937838,0.135684156
Texas,PANOLA,22756,17629,4013,798,5127,0.774696783,0.225303217,0.035067674
Texas,PARKER,88495,78980,1559,6211,9515,0.892479801,0.107520199,0.070184756
Texas,PARMER,10016,4876,93,4927,5140,0.486821086,0.513178914,0.491912939
Texas,PECOS,16809,5607,700,10262,11202,0.333571301,0.666428699,0.610506276
Texas,POLK,41133,30723,5357,3861,10410,0.746918533,0.253081467,0.093866239
Texas,POTTER,113546,65470,11047,31921,48076,0.576594508,0.423405492,0.281128353
Texas,PRESIDIO,7304,1079,10,6162,6225,0.147727273,0.852272727,0.843647317
Texas,RAINS,9139,8183,263,505,956,0.895393369,0.104606631,0.055257687
Texas,RANDALL,104312,89426,1513,10718,14886,0.857293504,0.142706496,0.102749444
Texas,REAGAN,3326,1545,94,1646,1781,0.464521948,0.535478052,0.494888755
Texas,REAL,3047,2306,5,688,741,0.756809977,0.243190023,0.225795865
Texas,RED RIVER,14314,10868,2538,669,3446,0.759256672,0.240743328,0.04673746
Texas,REEVES,13137,3131,238,9640,10006,0.238334475,0.761665525,0.733805283
Texas,REFUGIO,7828,3703,521,3490,4125,0.473045478,0.526954522,0.445835462
Texas,ROBERTS,887,850,3,28,37,0.958286359,0.041713641,0.03156708
Texas,ROBERTSON,16000,9580,3830,2359,6420,0.59875,0.40125,0.1474375
Texas,ROCKWALL,43080,35817,1374,4771,7263,0.831406685,0.168593315,0.110747447
Texas,RUNNELS,11495,7793,154,3372,3702,0.677946933,0.322053067,0.293344933
Texas,RUSK,47372,33737,9037,3998,13635,0.712171747,0.287828253,0.084395846
Texas,SABINE,10469,9115,1039,189,1354,0.870665775,0.129334225,0.0180533
Texas,SAN AUGUSTINE,8946,6066,2484,320,2880,0.67806841,0.32193159,0.035770177
Texas,SAN JACINTO,22246,17972,2796,1084,4274,0.807875573,0.192124427,0.048727861
Texas,SAN PATRICIO,67138,30749,1767,33181,36389,0.457996961,0.542003039,0.494220859
Texas,SAN SABA,6186,4622,160,1333,1564,0.747171031,0.252828969,0.215486583
Texas,SCHLEICHER,2935,1595,32,1278,1340,0.543441227,0.456558773,0.435434412
Texas,SCURRY,16361,10672,984,4544,5689,0.652282868,0.347717132,0.277733635
Texas,SHACKELFORD,3302,3014,9,251,288,0.912780133,0.087219867,0.076014537
Texas,SHELBY,25224,17564,4881,2489,7660,0.696320964,0.303679036,0.098675864
Texas,SHERMAN,3186,2263,15,874,923,0.710295041,0.289704959,0.274325173
Texas,SMITH,174706,118598,33129,19521,56108,0.678843314,0.321156686,0.111736288
Texas,SOMERVELL,6809,5763,13,915,1046,0.846379791,0.153620209,0.134380966
Texas,STARR,53597,1082,6,52278,52515,0.020187697,0.979812303,0.975390414
Texas,STEPHENS,9674,7861,277,1418,1813,0.812590449,0.187409551,0.146578458
Texas,STERLING,1393,955,1,432,438,0.685570711,0.314429289,0.310122039
Texas,STONEWALL,1693,1412,48,199,281,0.834022445,0.165977555,0.117542823
Texas,SUTTON,4077,1934,7,2106,2143,0.474368408,0.525631592,0.516556291
Texas,SWISHER,8378,4849,487,2951,3529,0.578777751,0.421222249,0.352232036
Texas,TARRANT,1446219,895253,182713,285290,550966,0.619030036,0.380969964,0.197266113
Texas,TAYLOR,126555,91999,8243,22328,34556,0.726948757,0.273051243,0.17642922
Texas,TERRELL,1081,529,0,525,552,0.489361702,0.510638298,0.485661425
Texas,TERRY,12761,6351,617,5626,6410,0.497688269,0.502311731,0.44087454
Texas,THROCKMORTON,1850,1655,1,173,195,0.894594595,0.105405405,0.093513514
Texas,TITUS,28118,16782,2970,7960,11336,0.596841881,0.403158119,0.283092681
Texas,TOM GREEN,104010,65508,4122,31946,38502,0.629824055,0.370175945,0.307143544
Texas,TRAVIS,812280,457817,73242,229048,354463,0.563619688,0.436380312,0.281981583
Texas,TRINITY,13779,11289,1635,668,2490,0.819290224,0.180709776,0.04847957
Texas,TYLER,20871,17290,2491,742,3581,0.828422213,0.171577787,0.035551722
Texas,UPSHUR,35291,29728,3557,1394,5563,0.842367742,0.157632258,0.039500156
Texas,UPTON,3404,1854,52,1449,1550,0.544653349,0.455346651,0.425675676
Texas,UVALDE,25926,8471,66,17089,17455,0.326737638,0.673262362,0.65914526
Texas,VAL VERDE,44856,9734,609,33849,35122,0.217005529,0.782994471,0.754614767
Texas,VAN ZANDT,48140,42619,1390,3201,5521,0.885313668,0.114686332,0.06649356
Texas,VICTORIA,84088,44490,5137,32959,39598,0.529088574,0.470911426,0.391958425
Texas,WALKER,61758,37090,14672,8712,24668,0.600569967,0.399430033,0.141066744
Texas,WALLER,32663,16289,9496,6344,16374,0.498698834,0.501301166,0.194225882
Texas,WARD,10909,5695,476,4580,5214,0.522046017,0.477953983,0.419836832
Texas,WASHINGTON,30373,21515,5604,2647,8858,0.708359398,0.291640602,0.087149771
Texas,WEBB,193117,9508,294,182070,183609,0.049234402,0.950765598,0.942796336
Texas,WHARTON,41188,21832,6060,12888,19356,0.530057298,0.469942702,0.312906672
Texas,WHEELER,5284,4386,137,664,898,0.83005299,0.16994701,0.125662377
Texas,WICHITA,131664,96490,13243,16097,35174,0.732850286,0.267149714,0.122258172
Texas,WILBARGER,14676,10083,1278,3015,4593,0.687040065,0.312959935,0.205437449
Texas,WILLACY,20082,2350,401,17209,17732,0.117020217,0.882979783,0.85693656
Texas,WILLIAMSON,249967,183847,12444,42990,66120,0.735485084,0.264514916,0.171982702
Texas,WILSON,32408,19728,361,11834,12680,0.608738583,0.391261417,0.365156751
Texas,WINKLER,7173,3825,127,3156,3348,0.533249686,0.466750314,0.439983271
Texas,WISE,48793,41991,584,5248,6802,0.860594757,0.139405243,0.107556412
Texas,WOOD,36752,31848,2243,2102,4904,0.866565085,0.133434915,0.057194166
Texas,YOAKUM,7322,3793,92,3363,3529,0.518027861,0.481972139,0.459300738
Texas,YOUNG,17943,15519,217,1906,2424,0.864905534,0.135094466,0.106225269
Texas,ZAPATA,12182,1771,22,10328,10411,0.145378427,0.854621573,0.847808242
Texas,ZAVALA,11600,924,43,10582,10676,0.079655172,0.920344828,0.912241379
Utah,BEAVER,6005,5491,16,333,514,0.914404663,0.085595337,0.055453789
Utah,BOX ELDER,42745,38717,66,2791,4028,0.905766756,0.094233244,0.065294186
Utah,CACHE,91391,81989,319,5786,9402,0.897123349,0.102876651,0.063310392
Utah,CARBON,20422,17671,52,2097,2751,0.865292332,0.134707668,0.102683381
Utah,DAGGETT,921,853,4,47,68,0.92616721,0.07383279,0.051031488
Utah,DAVIS,238994,214636,2521,12955,24358,0.898081123,0.101918877,0.054206382
Utah,DUCHESNE,14371,12764,18,508,1607,0.88817758,0.11182242,0.035348967
Utah,EMERY,10860,10050,19,568,810,0.925414365,0.074585635,0.052302026
Utah,GARFIELD,4735,4440,8,136,295,0.937697994,0.062302006,0.028722281
Utah,GRAND,8485,7568,18,471,917,0.89192693,0.10807307,0.055509723
Utah,IRON,33779,30829,108,1383,2950,0.912667634,0.087332366,0.040942597
Utah,JUAB,8238,7844,9,217,394,0.952172857,0.047827143,0.026341345
Utah,KANE,6046,5724,2,140,322,0.946741647,0.053258353,0.023155805
Utah,MILLARD,12405,11168,13,891,1237,0.900282144,0.099717856,0.071825877
Utah,MORGAN,7129,6937,2,103,192,0.973067751,0.026932249,0.014448029
Utah,PIUTE,1435,1339,2,64,96,0.933101045,0.066898955,0.044599303
Utah,RICH,1961,1908,0,36,53,0.972972973,0.027027027,0.018357981
Utah,SALT LAKE,898387,727197,8501,106787,171190,0.809447376,0.190552624,0.118865255
Utah,SAN JUAN,14413,5710,18,540,8703,0.396170124,0.603829876,0.037466176
Utah,SANPETE,22763,20590,61,1510,2173,0.904538066,0.095461934,0.06633572
Utah,SEVIER,18842,17752,49,481,1090,0.942150515,0.057849485,0.025528076
Utah,SUMMIT,29736,26608,54,2406,3128,0.894807641,0.105192359,0.080912026
Utah,TOOELE,40735,34497,480,4214,6238,0.846863876,0.153136124,0.103449122
Utah,UINTAH,25224,21662,26,894,3562,0.858785284,0.141214716,0.035442436
Utah,UTAH,368536,328797,1002,25791,39739,0.892170643,0.107829357,0.069982308
Utah,WASATCH,15215,14188,32,775,1027,0.932500822,0.067499178,0.050936576
Utah,WASHINGTON,90354,82293,174,4727,8061,0.910784249,0.089215751,0.052316444
Utah,WAYNE,2509,2409,4,50,100,0.960143483,0.039856517,0.019928258
Utah,WEBER,196533,162634,2559,24858,33899,0.827514972,0.172485028,0.126482575
Vermont,ADDISON,35974,34612,184,397,1362,0.962139323,0.037860677,0.011035748
Vermont,BENNINGTON,36994,35916,149,344,1078,0.970860139,0.029139861,0.009298805
Vermont,CALEDONIA,29702,28812,82,201,890,0.970035688,0.029964312,0.006767221
Vermont,CHITTENDEN,146571,138422,1283,1561,8149,0.944402372,0.055597628,0.010650129
Vermont,ESSEX,6459,6218,11,32,241,0.962687723,0.037312277,0.004954327
Vermont,FRANKLIN,45417,43434,134,270,1983,0.956337935,0.043662065,0.00594491
Vermont,GRAND ISLE,6901,6698,9,29,203,0.970583973,0.029416027,0.00420229
Vermont,LAMOILLE,23233,22481,72,180,752,0.967632247,0.032367753,0.0077476
Vermont,ORANGE,28226,27533,64,165,693,0.975448168,0.024551832,0.005845674
Vermont,ORLEANS,26277,25398,88,190,879,0.966548693,0.033451307,0.007230658
Vermont,RUTLAND,63400,61913,194,442,1487,0.976545741,0.023454259,0.006971609
Vermont,WASHINGTON,58039,55778,261,732,2261,0.961043436,0.038956564,0.012612209
Vermont,WINDHAM,44216,42452,210,493,1764,0.960104939,0.039895061,0.01114981
Vermont,WINDSOR,57418,55764,180,468,1654,0.971193702,0.028806298,0.008150754
Virginia,ACCOMACK,38305,23697,12039,2062,14608,0.618639864,0.381360136,0.053831093
Virginia,ALBEMARLE,79236,66218,7586,2029,13018,0.835705992,0.164294008,0.025607047
Virginia,ALLEGHANY,12926,12428,314,47,498,0.961473,0.038527,0.003636082
Virginia,AMELIA,11400,8007,3183,91,3393,0.702368421,0.297631579,0.007982456
Virginia,AMHERST,31894,24645,6267,306,7249,0.772715871,0.227284129,0.009594281
Virginia,APPOMATTOX,13705,10377,3132,65,3328,0.757168916,0.242831084,0.004742795
Virginia,ARLINGTON,189453,114489,17244,35268,74964,0.604313471,0.395686529,0.186156989
Virginia,AUGUSTA,65615,61970,2354,620,3645,0.944448678,0.055551322,0.009449059
Virginia,BATH,5048,4645,317,18,403,0.920166403,0.079833597,0.003565769
Virginia,BEDFORD,60371,55358,3752,449,5013,0.916963443,0.083036557,0.007437346
Virginia,BLAND,6871,6495,285,32,376,0.945277252,0.054722748,0.004657255
Virginia,BOTETOURT,30496,28833,1067,181,1663,0.945468258,0.054531742,0.005935205
Virginia,BRUNSWICK,18419,7629,10416,231,10790,0.414191867,0.585808133,0.012541397
Virginia,BUCHANAN,26978,26007,706,128,971,0.96400771,0.03599229,0.004744607
Virginia,BUCKINGHAM,15623,9184,6073,126,6439,0.587851245,0.412148755,0.008065032
Virginia,CAMPBELL,51078,42298,7465,423,8780,0.828106034,0.171893966,0.008281452
Virginia,CAROLINE,22121,13710,7562,295,8411,0.619773066,0.380226934,0.013335744
Virginia,CARROLL,29245,28436,129,479,809,0.972337152,0.027662848,0.016378868
Virginia,CHARLES CITY,6926,2454,3795,45,4472,0.354317066,0.645682934,0.006497257
Virginia,CHARLOTTE,12472,8053,4087,206,4419,0.645686337,0.354313663,0.016516998
Virginia,CHESTERFIELD,259903,196076,45797,7617,63827,0.754419918,0.245580082,0.029307088
Virginia,CLARKE,12652,11422,848,185,1230,0.902782169,0.097217831,0.014622194
Virginia,CRAIG,5091,5023,9,17,68,0.986643096,0.013356904,0.003339226
Virginia,CULPEPER,34262,26413,6188,858,7849,0.770912381,0.229087619,0.025042321
Virginia,CUMBERLAND,9017,5386,3349,150,3631,0.597316181,0.402683819,0.016635245
Virginia,DICKENSON,16395,16163,58,70,232,0.985849344,0.014150656,0.004269594
Virginia,DINWIDDIE,24533,15735,8221,237,8798,0.641380997,0.358619003,0.009660457
Virginia,ESSEX,9989,5762,3879,72,4227,0.576834518,0.423165482,0.007207929
Virginia,FAIRFAX,969749,624296,81287,106958,345453,0.643770708,0.356229292,0.11029452
Virginia,FAUQUIER,55139,48064,4801,1114,7075,0.871687916,0.128312084,0.020203486
Virginia,FLOYD,13874,13284,274,187,590,0.957474413,0.042525587,0.013478449
Virginia,FLUVANNA,20047,15794,3664,235,4253,0.787848556,0.212151444,0.011722452
Virginia,FRANKLIN,47286,41749,4393,573,5537,0.882904031,0.117095969,0.012117752
Virginia,FREDERICK,59209,55653,1538,1004,3556,0.939941563,0.060058437,0.016956882
Virginia,GILES,16657,16141,263,105,516,0.969022033,0.030977967,0.006303656
Virginia,GLOUCESTER,34780,29805,3562,560,4975,0.856958022,0.143041978,0.016101208
Virginia,GOOCHLAND,16863,12194,4298,144,4669,0.723121627,0.276878373,0.008539406
Virginia,GRAYSON,17917,16283,1214,277,1634,0.908801697,0.091198303,0.015460177
Virginia,GREENE,15244,13769,982,201,1475,0.903240619,0.096759381,0.013185516
Virginia,GREENSVILLE,11560,4461,6881,108,7099,0.385899654,0.614100346,0.009342561
Virginia,HALIFAX,37355,22313,14164,458,15042,0.597322982,0.402677018,0.012260742
Virginia,HANOVER,86320,75753,8026,847,10567,0.877583411,0.122416589,0.009812326
Virginia,HENRICO,262300,178000,64342,5946,84300,0.678612276,0.321387724,0.0226687
Virginia,HENRY,57930,42087,13080,2002,15843,0.726514759,0.273485241,0.03455895
Virginia,HIGHLAND,2536,2507,1,13,29,0.988564669,0.011435331,0.005126183
Virginia,ISLE OF WIGHT,29728,20992,8045,254,8736,0.70613563,0.29386437,0.008544133
Virginia,JAMES CITY,48102,38954,6858,816,9148,0.809820797,0.190179203,0.016963952
Virginia,KING AND QUEEN,6630,4036,2351,58,2594,0.608748115,0.391251885,0.008748115
Virginia,KING GEORGE,16803,12856,3136,301,3947,0.76510147,0.23489853,0.017913468
Virginia,KING WILLIAM,13146,9654,2974,120,3492,0.734367869,0.265632131,0.009128252
Virginia,LANCASTER,11567,8055,3324,71,3512,0.696377626,0.303622374,0.006138152
Virginia,LEE,23589,23132,103,120,457,0.980626563,0.019373437,0.005087117
Virginia,LOUDOUN,169599,134972,11517,10089,34627,0.795830164,0.204169836,0.059487379
Virginia,LOUISA,25627,19517,5507,182,6110,0.761579584,0.238420416,0.007101885
Virginia,LUNENBURG,13146,7695,5044,235,5451,0.585349156,0.414650844,0.01787616
Virginia,MADISON,12520,10800,1423,96,1720,0.862619808,0.137380192,0.007667732
Virginia,MATHEWS,9207,7995,1036,73,1212,0.86836103,0.13163897,0.00792875
Virginia,MECKLENBURG,32380,19017,12589,393,13363,0.58730698,0.41269302,0.012137122
Virginia,MIDDLESEX,9932,7772,1998,55,2160,0.782521144,0.217478856,0.005537656
Virginia,MONTGOMERY,83629,74519,2996,1321,9110,0.891066496,0.108933504,0.015795956
Virginia,NELSON,14445,11765,2136,305,2680,0.814468674,0.185531326,0.021114573
Virginia,NEW KENT,13462,10727,2165,176,2735,0.796835537,0.203164463,0.013073837
Virginia,NORTHAMPTON,13093,6878,5602,454,6215,0.525318873,0.474681127,0.034675017
Virginia,NORTHUMBERLAND,12259,8804,3234,114,3455,0.718166245,0.281833755,0.00929929
Virginia,NOTTOWAY,15725,8923,6356,248,6802,0.567440382,0.432559618,0.015771065
Virginia,ORANGE,25881,21629,3556,330,4252,0.835709594,0.164290406,0.012750667
Virginia,PAGE,23177,22183,501,251,994,0.957112655,0.042887345,0.010829702
Virginia,PATRICK,19407,17667,1178,363,1740,0.910341629,0.089658371,0.018704591
Virginia,PITTSYLVANIA,61745,45921,14525,759,15824,0.743720139,0.256279861,0.012292493
Virginia,POWHATAN,22377,18117,3781,184,4260,0.809625955,0.190374045,0.008222729
Virginia,PRINCE EDWARD,19720,12180,7014,186,7540,0.617647059,0.382352941,0.009432049
Virginia,PRINCE GEORGE,33047,19532,10593,1625,13515,0.591037008,0.408962992,0.049172391
Virginia,PRINCE WILLIAM,280813,181756,51743,27338,99057,0.647249237,0.352750763,0.097353043
Virginia,PULASKI,35127,32351,1947,336,2776,0.920972471,0.079027529,0.009565292
Virginia,RAPPAHANNOCK,6983,6411,374,91,572,0.918086782,0.081913218,0.013031648
Virginia,RICHMOND,8809,5616,2913,185,3193,0.637529799,0.362470201,0.021001249
Virginia,ROANOKE,85778,79809,2855,888,5969,0.930413393,0.069586607,0.010352305
Virginia,ROCKBRIDGE,20808,19775,610,120,1033,0.950355632,0.049644368,0.005767013
Virginia,ROCKINGHAM,67725,63938,868,2221,3787,0.944082687,0.055917313,0.032794389
Virginia,RUSSELL,30308,28981,923,237,1327,0.956216181,0.043783819,0.007819718
Virginia,SCOTT,23403,22992,137,99,411,0.982438149,0.017561851,0.004230227
Virginia,SHENANDOAH,35075,33046,399,1194,2029,0.94215253,0.05784747,0.03404134
Virginia,SMYTH,33081,31880,607,283,1201,0.963695172,0.036304828,0.00855476
Virginia,SOUTHAMPTON,17482,9754,7462,115,7728,0.557945315,0.442054685,0.006578195
Virginia,SPOTSYLVANIA,90395,73546,11127,2536,16849,0.813606947,0.186393053,0.028054649
Virginia,STAFFORD,92446,74027,11013,3342,18419,0.800759362,0.199240638,0.036150834
Virginia,SURRY,6829,3170,3513,51,3659,0.464196808,0.535803192,0.007468151
Virginia,SUSSEX,12504,4537,7750,102,7967,0.36284389,0.63715611,0.00815739
Virginia,TAZEWELL,44598,42736,1005,228,1862,0.958249249,0.041750751,0.005112337
Virginia,WARREN,31584,28947,1514,494,2637,0.916508359,0.083491641,0.015640831
Virginia,WASHINGTON,51103,49594,674,322,1509,0.970471401,0.029528599,0.006301
Virginia,WESTMORELAND,16718,10720,5139,579,5998,0.641225027,0.358774973,0.034633329
Virginia,WISE,40123,38681,708,292,1442,0.964060514,0.035939486,0.007277621
Virginia,WYTHE,27599,26332,777,157,1267,0.95409254,0.04590746,0.005688612
Virginia,YORK,56297,44218,7445,1509,12079,0.785441498,0.214558502,0.02680427
Virginia,ALEXANDRIA CITY,128283,68889,28463,18882,59394,0.537008021,0.462991979,0.147190197
Virginia,BEDFORD CITY,6299,4703,1407,56,1596,0.746626449,0.253373551,0.0088903
Virginia,BRISTOL CITY,17367,15964,952,169,1403,0.919214602,0.080785398,0.009731099
Virginia,BUENA VISTA CITY,6349,5889,302,64,460,0.927547645,0.072452355,0.010080328
Virginia,CHARLOTTESVILLE CITY,45049,30825,9916,1102,14224,0.684254922,0.315745078,0.024462252
Virginia,CHESAPEAKE CITY,199184,131200,56442,4076,67984,0.658687445,0.341312555,0.020463491
Virginia,CLIFTON FORGE CITY,4289,3543,627,38,746,0.826066682,0.173933318,0.008859874
Virginia,COLONIAL HEIGHTS CITY,16897,14920,1043,274,1977,0.882996982,0.117003018,0.016215896
Virginia,COVINGTON CITY,6303,5271,828,40,1032,0.836268444,0.163731556,0.006346184
Virginia,DANVILLE CITY,48411,25813,21267,612,22598,0.533205263,0.466794737,0.012641755
Virginia,EMPORIA CITY,5665,2342,3174,84,3323,0.413415711,0.586584289,0.014827891
Virginia,FAIRFAX CITY,21498,14333,1035,2932,7165,0.666713183,0.333286817,0.13638478
Virginia,FALLS CHURCH CITY,10377,8255,321,876,2122,0.795509299,0.204490701,0.084417462
Virginia,FRANKLIN CITY,8346,3800,4351,46,4546,0.455307932,0.544692068,0.005511622
Virginia,FREDERICKSBURG CITY,19279,13759,3884,945,5520,0.713678095,0.286321905,0.049017065
Virginia,GALAX CITY,6837,5549,412,757,1288,0.811613281,0.188386719,0.110721076
Virginia,HAMPTON CITY,146437,70963,64795,4153,75474,0.484597472,0.515402528,0.028360319
Virginia,HARRISONBURG CITY,40468,32416,2266,3580,8052,0.801027973,0.198972027,0.08846496
Virginia,HOPEWELL CITY,22354,13655,7414,651,8699,0.610852644,0.389147356,0.029122305
Virginia,LEXINGTON CITY,6867,5837,713,109,1030,0.850007281,0.149992719,0.015873016
Virginia,LYNCHBURG CITY,65269,43108,19288,878,22161,0.660466684,0.339533316,0.013452022
Virginia,MANASSAS CITY,35135,23304,4430,5316,11831,0.663270243,0.336729757,0.15130212
Virginia,MANASSAS PARK CITY,10290,6919,1115,1544,3371,0.672400389,0.327599611,0.150048591
Virginia,MARTINSVILLE CITY,15416,8336,6501,358,7080,0.540736897,0.459263103,0.023222626
Virginia,NEWPORT NEWS CITY,180150,93624,69538,7595,86526,0.51970025,0.48029975,0.042159312
Virginia,NORFOLK CITY,234403,110221,102268,8915,124182,0.470220091,0.529779909,0.03803279
Virginia,NORTON CITY,3904,3548,235,34,356,0.908811475,0.091188525,0.008709016
Virginia,PETERSBURG CITY,33740,6131,26511,463,27609,0.1817131,0.8182869,0.013722584
Virginia,POQUOSON CITY,11566,11048,78,122,518,0.955213557,0.044786443,0.010548158
Virginia,PORTSMOUTH CITY,100565,45403,50569,1748,55162,0.451479143,0.548520857,0.017381793
Virginia,RADFORD CITY,15859,13900,1274,184,1959,0.876473926,0.123526074,0.011602245
Virginia,RICHMOND CITY,197790,74506,112455,5074,123284,0.376692452,0.623307548,0.025653471
Virginia,ROANOKE CITY,94911,65256,25220,1405,29655,0.687549388,0.312450612,0.014803342
Virginia,SALEM CITY,24747,22594,1444,205,2153,0.912999556,0.087000444,0.008283832
Virginia,STAUNTON CITY,23853,19728,3305,265,4125,0.827065778,0.172934222,0.011109714
Virginia,SUFFOLK CITY,63677,33940,27524,809,29737,0.533002497,0.466997503,0.012704744
Virginia,VIRGINIA BEACH CITY,425257,295402,79092,17770,129855,0.694643474,0.305356526,0.041786496
Virginia,WAYNESBORO CITY,19520,16492,1935,643,3028,0.844877049,0.155122951,0.032940574
Virginia,WILLIAMSBURG CITY,11998,9352,1593,302,2646,0.779463244,0.220536756,0.025170862
Virginia,WINCHESTER CITY,23585,18724,2454,1527,4861,0.793894424,0.206105576,0.064744541
Washington,ADAMS,16428,8366,20,7732,8062,0.509252496,0.490747504,0.470659849
Washington,ASOTIN,20551,19426,34,401,1125,0.945258138,0.054741862,0.019512432
Washington,BENTON,142475,116457,1227,17806,26018,0.817385506,0.182614494,0.124976312
Washington,CHELAN,66616,51590,111,12831,15026,0.774438573,0.225561427,0.192611385
Washington,CLALLAM,64525,56413,517,2203,8112,0.874281286,0.125718714,0.034141806
Washington,CLARK,345238,299134,5628,16248,46104,0.866457342,0.133542658,0.047063185
Washington,COLUMBIA,4064,3685,9,258,379,0.906742126,0.093257874,0.063484252
Washington,COWLITZ,92948,83571,448,4231,9377,0.899115635,0.100884365,0.045520076
Washington,DOUGLAS,32603,25179,62,6433,7424,0.772290893,0.227709107,0.197313131
Washington,FERRY,7260,5439,15,205,1821,0.749173554,0.250826446,0.028236915
Washington,FRANKLIN,49347,23470,1120,23032,25877,0.475611486,0.524388514,0.466735566
Washington,GARFIELD,2397,2304,0,47,93,0.961201502,0.038798498,0.019607843
Washington,GRANT,74698,48883,653,22476,25815,0.654408418,0.345591582,0.30089159
Washington,GRAYS HARBOR,67194,58112,205,3258,9082,0.864839123,0.135160877,0.048486472
Washington,ISLAND,71558,60929,1634,2843,10629,0.851463149,0.148536851,0.039730009
Washington,JEFFERSON,25953,23628,103,535,2325,0.910414981,0.089585019,0.020614187
Washington,KING,1737034,1275127,91798,95242,461907,0.734082925,0.265917075,0.054830245
Washington,KITSAP,231969,190751,6495,9609,41218,0.822312464,0.177687536,0.041423639
Washington,KITTITAS,33362,29825,227,1668,3537,0.893981176,0.106018824,0.049997003
Washington,KLICKITAT,19161,16329,26,1496,2832,0.852199781,0.147800219,0.078075257
Washington,LEWIS,68600,62174,239,3684,6426,0.906326531,0.093673469,0.053702624
Washington,LINCOLN,10184,9632,22,191,552,0.945797329,0.054202671,0.01875491
Washington,MASON,49405,42636,562,2361,6769,0.862989576,0.137010424,0.047788685
Washington,OKANOGAN,39564,28362,79,5688,11202,0.716863816,0.283136184,0.143767061
Washington,PACIFIC,20984,18462,36,1052,2522,0.879813191,0.120186809,0.050133435
Washington,PEND OREILLE,11732,10821,17,241,911,0.922349131,0.077650869,0.020542107
Washington,PIERCE,700820,532934,47399,38621,167886,0.76044348,0.23955652,0.055108302
Washington,SAN JUAN,14077,13187,34,338,890,0.936776302,0.063223698,0.024010798
Washington,SKAGIT,102979,85496,422,11536,17483,0.830227522,0.169772478,0.11202284
Washington,SKAMANIA,9872,8922,30,398,950,0.903768233,0.096231767,0.040316045
Washington,SNOHOMISH,606024,505198,9803,28590,100826,0.833627051,0.166372949,0.047176349
Washington,SPOKANE,417939,375427,6437,11561,42512,0.898281807,0.101718193,0.027661932
Washington,STEVENS,40066,35718,107,739,4348,0.89147906,0.10852094,0.018444566
Washington,THURSTON,207355,172963,4714,9392,34392,0.834139519,0.165860481,0.045294302
Washington,WAHKIAKUM,3824,3546,9,98,278,0.927301255,0.072698745,0.025627615
Washington,WALLA WALLA,55180,43502,869,8654,11678,0.78836535,0.21163465,0.156832186
Washington,WHATCOM,166814,143842,1065,8687,22972,0.862289736,0.137710264,0.052075965
Washington,WHITMAN,40740,35317,613,1219,5423,0.86688758,0.13311242,0.029921453
Washington,YAKIMA,222581,125733,1842,79905,96848,0.564886491,0.435113509,0.358992906
West Virginia,BARBOUR,15557,15095,77,73,462,0.970302758,0.029697242,0.004692421
West Virginia,BERKELEY,75905,69733,3523,1156,6172,0.918687833,0.081312167,0.015229563
West Virginia,BOONE,25535,25064,164,117,471,0.981554729,0.018445271,0.004581946
West Virginia,BRAXTON,14702,14353,101,65,349,0.976261733,0.023738267,0.004421167
West Virginia,BROOKE,25447,24841,215,99,606,0.976185798,0.023814202,0.003890439
West Virginia,CABELL,96784,89944,4118,654,6840,0.929327162,0.070672838,0.006757315
West Virginia,CALHOUN,7582,7473,6,42,109,0.985623846,0.014376154,0.005539436
West Virginia,CLAY,10330,10108,7,42,222,0.978509197,0.021490803,0.004065828
West Virginia,DODDRIDGE,7403,7252,18,42,151,0.979602864,0.020397136,0.005673376
West Virginia,FAYETTE,47579,43874,2647,325,3705,0.922129511,0.077870489,0.006830745
West Virginia,GILMER,7160,6936,64,50,224,0.968715084,0.031284916,0.00698324
West Virginia,GRANT,11299,11058,76,62,241,0.978670679,0.021329321,0.005487211
West Virginia,GREENBRIER,34453,32632,1041,236,1821,0.947145386,0.052854614,0.006849911
West Virginia,HAMPSHIRE,20203,19733,164,112,470,0.976736128,0.023263872,0.005543731
West Virginia,HANCOCK,32667,31307,747,243,1360,0.958367772,0.041632228,0.0074387
West Virginia,HARDY,12669,12225,230,84,444,0.964953824,0.035046176,0.006630358
West Virginia,HARRISON,68652,65756,1102,660,2896,0.957816233,0.042183767,0.009613704
West Virginia,JACKSON,28000,27595,23,81,405,0.985535714,0.014464286,0.002892857
West Virginia,JEFFERSON,42190,37958,2539,734,4232,0.89969187,0.10030813,0.017397488
West Virginia,KANAWHA,200073,180258,13870,1172,19815,0.900961149,0.099038851,0.005857862
West Virginia,LEWIS,16919,16604,22,85,315,0.981381878,0.018618122,0.005023938
West Virginia,LINCOLN,22108,21787,13,121,321,0.985480369,0.014519631,0.005473132
West Virginia,LOGAN,37710,36157,970,202,1553,0.95881729,0.04118271,0.005356669
West Virginia,MCDOWELL,27329,23695,3234,132,3634,0.8670277,0.1329723,0.004830034
West Virginia,MARION,56598,53508,1816,394,3090,0.945404431,0.054595569,0.006961377
West Virginia,MARSHALL,35519,34762,152,228,757,0.978687463,0.021312537,0.0064191
West Virginia,MASON,25957,25441,129,121,516,0.980120969,0.019879031,0.004661556
West Virginia,MERCER,62980,58073,3657,285,4907,0.922086377,0.077913623,0.004525246
West Virginia,MINERAL,27078,25924,689,158,1154,0.957382377,0.042617623,0.005834995
West Virginia,MINGO,28253,27134,654,135,1119,0.960393587,0.039606413,0.004778254
West Virginia,MONONGALIA,81866,74965,2740,826,6901,0.915703711,0.084296289,0.010089659
West Virginia,MONROE,14583,13448,868,72,1135,0.92216965,0.07783035,0.004937256
West Virginia,MORGAN,14943,14596,89,124,347,0.976778425,0.023221575,0.0082982
West Virginia,NICHOLAS,26562,26170,10,127,392,0.985242075,0.014757925,0.004781266
West Virginia,OHIO,47427,44633,1679,238,2794,0.94108841,0.05891159,0.005018239
West Virginia,PENDLETON,8196,7854,167,73,342,0.958272328,0.041727672,0.008906784
West Virginia,PLEASANTS,7514,7363,36,28,151,0.979904179,0.020095821,0.003726377
West Virginia,POCAHONTAS,9131,8948,71,39,183,0.979958384,0.020041616,0.004271164
West Virginia,PRESTON,29334,28845,82,168,489,0.983329924,0.016670076,0.005727143
West Virginia,PUTNAM,51589,50361,287,262,1228,0.976196476,0.023803524,0.005078602
West Virginia,RALEIGH,79220,70421,6719,727,8799,0.888929563,0.111070437,0.009176976
West Virginia,RANDOLPH,28262,27479,296,191,783,0.972294954,0.027705046,0.006758191
West Virginia,RITCHIE,10343,10168,14,49,175,0.983080344,0.016919656,0.004737504
West Virginia,ROANE,15446,15144,34,104,302,0.980448012,0.019551988,0.006733135
West Virginia,SUMMERS,12999,12494,280,71,505,0.961150858,0.038849142,0.005461959
West Virginia,TAYLOR,16089,15712,131,95,377,0.976567841,0.023432159,0.005904655
West Virginia,TUCKER,7321,7224,4,18,97,0.986750444,0.013249556,0.002458681
West Virginia,TYLER,9592,9492,2,41,100,0.989574646,0.010425354,0.004274395
West Virginia,UPSHUR,23404,22876,143,137,528,0.977439754,0.022560246,0.0058537
West Virginia,WAYNE,42903,42210,53,202,693,0.983847283,0.016152717,0.004708295
West Virginia,WEBSTER,9719,9605,1,36,114,0.988270398,0.011729602,0.003704085
West Virginia,WETZEL,17693,17439,15,74,254,0.98564404,0.01435596,0.004182445
West Virginia,WIRT,5873,5771,17,18,102,0.982632385,0.017367615,0.003064873
West Virginia,WOOD,87986,85247,858,514,2739,0.968870048,0.031129952,0.005841838
West Virginia,WYOMING,25708,25221,161,135,487,0.98105648,0.01894352,0.005251284
Wisconsin,ADAMS,18643,18021,50,268,622,0.966636271,0.033363729,0.014375369
Wisconsin,ASHLAND,16866,14622,35,188,2244,0.866951263,0.133048737,0.011146686
Wisconsin,BARRON,44963,43667,55,430,1296,0.971176301,0.028823699,0.009563419
Wisconsin,BAYFIELD,15013,13247,20,91,1766,0.882368614,0.117631386,0.006061413
Wisconsin,BROWN,226778,203243,2562,8698,23535,0.896220092,0.103779908,0.03835469
Wisconsin,BUFFALO,13804,13555,15,85,249,0.98196175,0.01803825,0.006157635
Wisconsin,BURNETT,15674,14563,54,120,1111,0.929118285,0.070881715,0.007655991
Wisconsin,CALUMET,40631,39062,109,435,1569,0.961384165,0.038615835,0.010706111
Wisconsin,CHIPPEWA,55195,53831,85,289,1364,0.975287617,0.024712383,0.005235982
Wisconsin,CLARK,33557,32716,39,404,841,0.974938165,0.025061835,0.012039217
Wisconsin,COLUMBIA,52468,50476,432,827,1992,0.962034002,0.037965998,0.015761988
Wisconsin,CRAWFORD,17243,16693,230,129,550,0.968102998,0.031897002,0.007481297
Wisconsin,DANE,426526,372597,16829,14387,53929,0.873562221,0.126437779,0.033730652
Wisconsin,DODGE,85897,80563,2095,2188,5334,0.937902371,0.062097629,0.025472368
Wisconsin,DOOR,27961,27228,49,267,733,0.973784915,0.026215085,0.009549015
Wisconsin,DOUGLAS,43287,41081,245,315,2206,0.949037817,0.050962183,0.007277012
Wisconsin,DUNN,39858,38122,135,335,1736,0.956445381,0.043554619,0.008404837
Wisconsin,EAU CLAIRE,93142,87936,471,879,5206,0.944106848,0.055893152,0.009437203
Wisconsin,FLORENCE,5088,4981,8,23,107,0.978970126,0.021029874,0.00452044
Wisconsin,FOND DU LAC,97296,92528,857,1987,4768,0.950994902,0.049005098,0.020422217
Wisconsin,FOREST,10024,8570,118,108,1454,0.854948125,0.145051875,0.010774142
Wisconsin,GRANT,49597,48542,257,280,1055,0.978728552,0.021271448,0.005645503
Wisconsin,GREEN,33647,32858,83,327,789,0.976550658,0.023449342,0.009718548
Wisconsin,GREEN LAKE,19105,18474,29,393,631,0.966971997,0.033028003,0.020570531
Wisconsin,IOWA,22780,22428,36,75,352,0.984547849,0.015452151,0.003292362
Wisconsin,IRON,6861,6714,4,45,147,0.978574552,0.021425448,0.006558811
Wisconsin,JACKSON,19100,16990,428,357,2110,0.889528796,0.110471204,0.018691099
Wisconsin,JEFFERSON,74021,69765,184,3031,4256,0.942502803,0.057497197,0.040947839
Wisconsin,JUNEAU,24316,23318,76,347,998,0.958957065,0.041042935,0.014270439
Wisconsin,KENOSHA,149577,127287,7446,10757,22290,0.850979763,0.149020237,0.071916137
Wisconsin,KEWAUNEE,20187,19822,27,153,365,0.981919057,0.018080943,0.007579135
Wisconsin,LA CROSSE,107120,100332,975,990,6788,0.936631815,0.063368185,0.009241972
Wisconsin,LAFAYETTE,16137,15921,17,92,216,0.986614612,0.013385388,0.005701184
Wisconsin,LANGLADE,20740,20193,28,171,547,0.973625844,0.026374156,0.008244937
Wisconsin,LINCOLN,29641,28857,119,243,784,0.97355015,0.02644985,0.008198104
Wisconsin,MANITOWOC,82887,78756,227,1343,4131,0.950161063,0.049838937,0.016202782
Wisconsin,MARATHON,125834,117517,337,979,8317,0.933904986,0.066095014,0.007780091
Wisconsin,MARINETTE,43384,42354,87,325,1030,0.976258528,0.023741472,0.007491241
Wisconsin,MARQUETTE,15832,14560,507,421,1272,0.919656392,0.080343608,0.026591713
Wisconsin,MENOMINEE,4562,526,3,122,4036,0.115300307,0.884699693,0.026742657
Wisconsin,MILWAUKEE,940164,583481,228471,82406,356683,0.62061619,0.37938381,0.087650665
Wisconsin,MONROE,40899,39135,181,740,1764,0.956869361,0.043130639,0.018093352
Wisconsin,OCONTO,35634,34707,48,240,927,0.973985519,0.026014481,0.006735141
Wisconsin,ONEIDA,36776,35794,114,244,982,0.973297803,0.026702197,0.006634762
Wisconsin,OUTAGAMIE,160971,149644,846,3207,11327,0.929633288,0.070366712,0.019922843
Wisconsin,OZAUKEE,82317,78894,759,1073,3423,0.958416852,0.041583148,0.013034975
Wisconsin,PEPIN,7213,7122,6,25,91,0.98738389,0.01261611,0.003465964
Wisconsin,PIERCE,36804,35896,91,301,908,0.975328769,0.024671231,0.008178459
Wisconsin,POLK,41319,40131,56,329,1188,0.971248094,0.028751906,0.007962439
Wisconsin,PORTAGE,67182,63752,203,967,3430,0.948944658,0.051055342,0.014393736
Wisconsin,PRICE,15822,15462,16,116,360,0.977246871,0.022753129,0.007331564
Wisconsin,RACINE,188831,150238,19441,14990,38593,0.795621482,0.204378518,0.079383152
Wisconsin,RICHLAND,17924,17546,26,167,378,0.978910957,0.021089043,0.009317117
Wisconsin,ROCK,152307,135884,6943,5953,16423,0.892171732,0.107828268,0.039085531
Wisconsin,RUSK,15347,14941,78,116,406,0.973545318,0.026454682,0.00755848
Wisconsin,ST. CROIX,63155,61525,176,483,1630,0.974190484,0.025809516,0.007647851
Wisconsin,SAUK,55225,53241,138,938,1984,0.964074242,0.035925758,0.016985061
Wisconsin,SAWYER,16196,13182,50,145,3014,0.813904668,0.186095332,0.008952828
Wisconsin,SHAWANO,40664,37102,90,407,3562,0.912404092,0.087595908,0.010008853
Wisconsin,SHEBOYGAN,112646,102628,1189,3789,10018,0.911066527,0.088933473,0.033636347
Wisconsin,TAYLOR,19680,19342,17,127,338,0.982825203,0.017174797,0.006453252
Wisconsin,TREMPEALEAU,27010,26546,33,240,464,0.982821177,0.017178823,0.008885598
Wisconsin,VERNON,28056,27617,18,186,439,0.984352723,0.015647277,0.006629598
Wisconsin,VILAS,21033,18765,42,181,2268,0.892169448,0.107830552,0.008605525
Wisconsin,WALWORTH,93759,85428,747,6136,8331,0.91114453,0.08885547,0.065444384
Wisconsin,WASHBURN,16036,15504,25,143,532,0.966824645,0.033175355,0.008917436
Wisconsin,WASHINGTON,117493,113870,447,1529,3623,0.96916412,0.03083588,0.013013541
Wisconsin,WAUKESHA,360767,339905,2570,9503,20862,0.942173203,0.057826797,0.026341101
Wisconsin,WAUPACA,51731,50295,82,714,1436,0.972241016,0.027758984,0.013802169
Wisconsin,WAUSHARA,23154,21939,53,848,1215,0.947525266,0.052474734,0.036624341
Wisconsin,WINNEBAGO,156763,147160,1725,3065,9603,0.938741923,0.061258077,0.019551808
Wisconsin,WOOD,75555,72438,201,709,3117,0.958745285,0.041254715,0.009383893
Wyoming,ALBANY,32014,28003,322,2397,4011,0.874711064,0.125288936,0.074873493
Wyoming,BIG HORN,11461,10527,9,707,934,0.918506239,0.081493761,0.061687462
Wyoming,CAMPBELL,33698,31701,47,1191,1997,0.940738323,0.059261677,0.035343344
Wyoming,CARBON,15639,12892,103,2163,2747,0.824349383,0.175650617,0.138308076
Wyoming,CONVERSE,12052,11072,18,660,980,0.918685695,0.081314305,0.054762695
Wyoming,CROOK,5887,5729,3,54,158,0.973161203,0.026838797,0.009172754
Wyoming,FREMONT,35804,26693,43,1566,9111,0.745531226,0.254468774,0.04373813
Wyoming,GOSHEN,12538,11172,25,1107,1366,0.891051204,0.108948796,0.088291594
Wyoming,HOT SPRINGS,4882,4614,17,116,268,0.945104465,0.054895535,0.023760754
Wyoming,JOHNSON,7075,6771,5,148,304,0.957031802,0.042968198,0.020918728
Wyoming,LARAMIE,81607,67901,2015,8897,13706,0.832048721,0.167951279,0.10902251
Wyoming,LINCOLN,14573,14002,14,315,571,0.960817951,0.039182049,0.021615316
Wyoming,NATRONA,66533,61023,473,3257,5510,0.917183954,0.082816046,0.048953151
Wyoming,NIOBRARA,2407,2337,3,36,70,0.970918155,0.029081845,0.014956377
Wyoming,PARK,25786,24356,19,959,1430,0.944543551,0.055456449,0.037190724
Wyoming,PLATTE,8807,8181,3,465,626,0.928920177,0.071079823,0.05279891
Wyoming,SHERIDAN,26560,25122,44,646,1438,0.945858434,0.054141566,0.024322289
Wyoming,SUBLETTE,5920,5709,12,112,211,0.964358108,0.035641892,0.018918919
Wyoming,SWEETWATER,37613,32675,270,3545,4938,0.868715604,0.131284396,0.094249329
Wyoming,TETON,18251,16668,25,1185,1583,0.913265027,0.086734973,0.064927949
Wyoming,UINTA,19742,18210,18,1055,1532,0.922398946,0.077601054,0.053439368
Wyoming,WASHAKIE,8289,7143,8,951,1146,0.861744481,0.138255519,0.114730366
Wyoming,WESTON,6644,6298,8,137,346,0.947922938,0.052077062,0.020620108