state,county,total_pop,white,black,latino,non_white,pct_white,pct_nonwhite,pct_latino
Alabama,AUTAUGA,54571,42154,9595,1310,12417,0.772461564,0.227538436,0.024005424
Alabama,BALDWIN,182265,152200,16966,7992,30065,0.83504787,0.16495213,0.043848243
Alabama,BARBOUR,27457,12837,12820,1387,14620,0.467531049,0.532468951,0.050515351
Alabama,BIBB,22915,17191,5024,406,5724,0.750207288,0.249792712,0.017717652
Alabama,BLOUNT,57322,50952,724,4626,6370,0.888873382,0.111126618,0.080701999
Alabama,BULLOCK,10914,2392,7637,777,8522,0.219168041,0.780831959,0.071192963
Alabama,BUTLER,20947,11324,9047,191,9623,0.540602473,0.459397527,0.009118251
Alabama,CALHOUN,118572,87285,24177,3893,31287,0.736135007,0.263864993,0.032832372
Alabama,CHAMBERS,34215,19893,13206,536,14322,0.581411662,0.418588338,0.015665644
Alabama,CHEROKEE,25989,23929,1206,320,2060,0.920735696,0.079264304,0.012312902
Alabama,CHILTON,43643,35395,4171,3420,8248,0.811012075,0.188987925,0.078363082
Alabama,CHOCTAW,13859,7700,5990,73,6159,0.555595642,0.444404358,0.005267335
Alabama,CLARKE,25833,13943,11280,271,11890,0.539735997,0.460264003,0.010490458
Alabama,CLAY,13932,11186,2048,399,2746,0.802899799,0.197100201,0.028639104
Alabama,CLEBURNE,14972,13956,494,307,1016,0.932139995,0.067860005,0.020504943
Alabama,COFFEE,49948,36134,8257,3180,13814,0.72343237,0.27656763,0.063666213
Alabama,COLBERT,54428,43334,8702,1093,11094,0.796171088,0.203828912,0.020081576
Alabama,CONECUH,13228,6764,6122,161,6464,0.511339583,0.488660417,0.012171152
Alabama,COOSA,11539,7604,3556,230,3935,0.658982581,0.341017419,0.019932403
Alabama,COVINGTON,37765,31751,4685,483,6014,0.840752019,0.159247981,0.01278962
Alabama,CRENSHAW,13906,10020,3241,204,3886,0.72055228,0.27944772,0.014669927
Alabama,CULLMAN,80406,74568,821,3454,5838,0.927393478,0.072606522,0.042956993
Alabama,DALE,50251,35705,9546,2821,14546,0.710533124,0.289466876,0.056138186
Alabama,DALLAS,43820,12676,30314,309,31144,0.289274304,0.710725696,0.007051575
Alabama,DEKALB,71109,57997,1029,9690,13112,0.815607026,0.184392974,0.136269671
Alabama,ELMORE,79303,59449,15814,2129,19854,0.749643771,0.250356229,0.026846399
Alabama,ESCAMBIA,38319,23508,12162,718,14811,0.613481563,0.386518437,0.018737441
Alabama,ETOWAH,104430,82789,15716,3447,21641,0.792770277,0.207229723,0.033007756
Alabama,FAYETTE,17241,14832,1958,204,2409,0.860274926,0.139725074,0.01183226
Alabama,FRANKLIN,31704,25249,1211,4710,6455,0.796397931,0.203602069,0.148561696
Alabama,GENEVA,26790,22692,2523,920,4098,0.847032475,0.152967525,0.034341172
Alabama,GREENE,9045,1562,7349,69,7483,0.172692095,0.827307905,0.007628524
Alabama,HALE,15760,6213,9265,140,9547,0.394225888,0.605774112,0.008883249
Alabama,HENRY,17302,11731,4915,389,5571,0.678014102,0.321985898,0.02248295
Alabama,HOUSTON,101547,69731,26038,2995,31816,0.686686953,0.313313047,0.029493732
Alabama,JACKSON,53227,47937,1771,1339,5290,0.90061435,0.09938565,0.025156406
Alabama,JEFFERSON,658466,340213,275511,25488,318253,0.516675121,0.483324879,0.038708149
Alabama,LAMAR,14564,12542,1635,180,2022,0.861164515,0.138835485,0.012359242
Alabama,LAUDERDALE,92709,79228,9190,2082,13481,0.854588012,0.145411988,0.022457367
Alabama,LAWRENCE,34339,26420,3917,574,7919,0.769387577,0.230612423,0.016715688
Alabama,LEE,140247,97900,31674,4571,42347,0.698054147,0.301945853,0.032592498
Alabama,LIMESTONE,82782,65112,10350,4591,17670,0.7865478,0.2134522,0.055458916
Alabama,LOWNDES,11299,2841,8283,87,8458,0.25143818,0.74856182,0.007699796
Alabama,MACON,21452,3267,17631,232,18185,0.152293492,0.847706508,0.010814842
Alabama,MADISON,334811,221445,79517,15404,113366,0.661403,0.338597,0.046008046
Alabama,MARENGO,21027,9607,10838,352,11420,0.456888762,0.543111238,0.016740381
Alabama,MARION,30776,28509,1178,632,2267,0.926338705,0.073661295,0.020535482
Alabama,MARSHALL,93019,78060,1389,11238,14959,0.839183393,0.160816607,0.120814027
Alabama,MOBILE,412992,243904,142272,9936,169088,0.590578026,0.409421974,0.024058577
Alabama,MONROE,23068,12621,9581,220,10447,0.547121554,0.452878446,0.009537021
Alabama,MONTGOMERY,229363,88099,124928,8314,141264,0.384102929,0.615897071,0.036248218
Alabama,MORGAN,119490,92585,14059,9156,26905,0.774834714,0.225165286,0.076625659
Alabama,PERRY,10591,3142,7244,114,7449,0.296666981,0.703333019,0.010763856
Alabama,PICKENS,19746,11027,8169,313,8719,0.558442216,0.441557784,0.015851312
Alabama,PIKE,32899,18887,11990,730,14012,0.574090398,0.425909602,0.022189124
Alabama,RANDOLPH,22913,17280,4604,649,5633,0.754157029,0.245842971,0.028324532
Alabama,RUSSELL,52947,27591,21926,1946,25356,0.521106012,0.478893988,0.036753735
Alabama,ST. CLAIR,83593,72947,7098,1716,10646,0.872644839,0.127355161,0.020528035
Alabama,SHELBY,195085,156371,20606,11567,38714,0.801553169,0.198446831,0.059292103
Alabama,SUMTER,13763,3304,10283,86,10459,0.24006394,0.75993606,0.006248638
Alabama,TALLADEGA,82291,53079,25953,1671,29212,0.645015858,0.354984142,0.020305987
Alabama,TALLAPOOSA,41616,28838,11050,1042,12778,0.692954633,0.307045367,0.025038447
Alabama,TUSCALOOSA,194656,126611,57401,5949,68045,0.650434613,0.349565387,0.030561606
Alabama,WALKER,67023,60587,3885,1307,6436,0.903973263,0.096026737,0.019500768
Alabama,WASHINGTON,17581,11455,4360,151,6126,0.651555657,0.348444343,0.008588817
Alabama,WILCOX,11670,3110,8420,72,8560,0.266495287,0.733504713,0.006169666
Alabama,WINSTON,24484,23237,115,639,1247,0.94906878,0.05093122,0.026098677
Alaska,ALEUTIANS EAST BOROUGH,3141,425,212,385,2716,0.135307227,0.864692773,0.122572429
Alaska,ALEUTIANS WEST CENSUS AREA,5561,1745,318,726,3816,0.313792483,0.686207517,0.130552059
Alaska,ANCHORAGE MUNICIPALITY,291826,182814,15308,22061,109012,0.626448637,0.373551363,0.075596417
Alaska,BETHEL CENSUS AREA,17013,1854,65,181,15159,0.108975489,0.891024511,0.010638923
Alaska,BRISTOL BAY BOROUGH,997,476,0,24,521,0.477432297,0.522567703,0.024072217
Alaska,DENALI BOROUGH,1826,1614,10,42,212,0.883899233,0.116100767,0.023001095
Alaska,DILLINGHAM CENSUS AREA,4847,855,11,101,3992,0.176397772,0.823602228,0.020837632
Alaska,FAIRBANKS NORTH STAR BOROUGH,97581,72259,4154,5651,25322,0.740502762,0.259497238,0.057910864
Alaska,HAINES BOROUGH,2508,2062,9,47,446,0.822169059,0.177830941,0.018740032
Alaska,HOONAH-ANGOON CENSUS AREA,2150,993,8,77,1157,0.461860465,0.538139535,0.035813953
Alaska,JUNEAU CITY AND BOROUGH,31275,21065,259,1588,10210,0.673541167,0.326458833,0.05077538
Alaska,KENAI PENINSULA BOROUGH,55400,45879,248,1641,9521,0.828140794,0.171859206,0.029620939
Alaska,KETCHIKAN GATEWAY BOROUGH,13477,8918,76,538,4559,0.661719967,0.338280033,0.039919863
Alaska,KODIAK ISLAND BOROUGH,13592,7137,85,996,6455,0.525088287,0.474911713,0.073278399
Alaska,LAKE AND PENINSULA BOROUGH,1631,362,9,43,1269,0.221949724,0.778050276,0.026364194
Alaska,MATANUSKA-SUSITNA BOROUGH,88995,73676,817,3301,15319,0.827866734,0.172133266,0.037091971
Alaska,NOME CENSUS AREA,9492,1511,27,115,7981,0.159186684,0.840813316,0.012115466
Alaska,NORTH SLOPE BOROUGH,9430,3059,91,249,6371,0.324390244,0.675609756,0.02640509
Alaska,NORTHWEST ARCTIC BOROUGH,7523,830,35,58,6693,0.110328326,0.889671674,0.00770969
Alaska,PETERSBURG CENSUS AREA,3815,2649,15,130,1166,0.694364351,0.305635649,0.034076016
Alaska,PRINCE OF WALES-HYDER CENSUS AREA,5559,2756,17,127,2803,0.495772621,0.504227379,0.022845836
Alaska,SITKA CITY AND BOROUGH,8881,5641,43,437,3240,0.635176219,0.364823781,0.04920617
Alaska,SKAGWAY MUNICIPALITY,968,872,0,21,96,0.900826446,0.099173554,0.021694215
Alaska,SOUTHEAST FAIRBANKS CENSUS AREA,7029,5535,71,234,1494,0.787451985,0.212548015,0.033290653
Alaska,VALDEZ-CORDOVA CENSUS AREA,9636,6949,45,349,2687,0.721149855,0.278850145,0.036218348
Alaska,WADE HAMPTON CENSUS AREA,7459,199,1,7,7260,0.02667918,0.97332082,0.000938464
Alaska,WRANGELL CITY AND BOROUGH,2369,1699,4,37,670,0.717180245,0.282819755,0.015618404
Alaska,YAKUTAT CITY AND BOROUGH,662,268,2,17,394,0.404833837,0.595166163,0.025679758
Alaska,YUKON-KOYUKUK CENSUS AREA,5588,1218,9,66,4370,0.217967072,0.782032928,0.011811024
Arizona,APACHE,71518,14568,157,4113,56950,0.203696971,0.796303029,0.057509997
Arizona,COCHISE,131346,76805,4936,42543,54541,0.584753247,0.415246753,0.323900233
Arizona,COCONINO,134421,74231,1495,18166,60190,0.552227703,0.447772297,0.135142574
Arizona,GILA,53597,35298,195,9588,18299,0.658581637,0.341418363,0.17889061
Arizona,GRAHAM,37220,19483,633,11320,17737,0.523455132,0.476544868,0.30413756
Arizona,GREENLEE,8437,4054,79,4040,4383,0.480502548,0.519497452,0.478843191
Arizona,LA PAZ,20489,12854,115,4806,7635,0.627361023,0.372638977,0.234564888
Arizona,MARICOPA,3817117,2240055,177490,1128741,1577062,0.586844731,0.413155269,0.295705109
Arizona,MOHAVE,200186,159378,1715,29569,40808,0.796149581,0.203850419,0.147707632
Arizona,NAVAJO,107449,47181,842,11571,60268,0.439101341,0.560898659,0.107688299
Arizona,PIMA,980263,541700,31075,338802,438563,0.5526068,0.4473932,0.345623572
Arizona,PINAL,375770,220486,16007,106977,155284,0.586757857,0.413242143,0.284687442
Arizona,SANTA CRUZ,47420,7564,89,39273,39856,0.159510755,0.840489245,0.828194854
Arizona,YAVAPAI,211033,172968,1104,28728,38065,0.819625367,0.180374633,0.136130368
Arizona,YUMA,195751,69022,3169,116912,126729,0.352601008,0.647398992,0.597248545
Arkansas,ARKANSAS,19019,13511,4634,513,5508,0.710394868,0.289605132,0.026973027
Arkansas,ASHLEY,21853,14901,5619,1069,6952,0.681874342,0.318125658,0.048917769
Arkansas,BAXTER,41513,39837,59,688,1676,0.959627105,0.040372895,0.016573122
Arkansas,BENTON,221339,169605,2647,34283,51734,0.766268032,0.233731968,0.154889107
Arkansas,BOONE,36903,35139,64,674,1764,0.952199008,0.047800992,0.018264098
Arkansas,BRADLEY,11508,6676,3167,1516,4832,0.580118179,0.419881821,0.131734446
Arkansas,CALHOUN,5368,3939,1190,152,1429,0.733792846,0.266207154,0.028315946
Arkansas,CARROLL,27446,23062,74,3489,4384,0.840268163,0.159731837,0.127122349
Arkansas,CHICOT,11800,4761,6347,542,7039,0.403474576,0.596525424,0.045932203
Arkansas,CLARK,22995,16177,5366,926,6818,0.703500761,0.296499239,0.040269624
Arkansas,CLAY,16083,15577,56,217,506,0.968538208,0.031461792,0.013492508
Arkansas,CLEBURNE,25970,24894,67,517,1076,0.958567578,0.041432422,0.019907586
Arkansas,CLEVELAND,8689,7394,1053,145,1295,0.850960985,0.149039015,0.016687766
Arkansas,COLUMBIA,24552,14545,9006,533,10007,0.592416096,0.407583904,0.021709026
Arkansas,CONWAY,21273,17533,2376,757,3740,0.824190288,0.175809712,0.035585014
Arkansas,CRAIGHEAD,96443,76760,12564,4277,19683,0.795910538,0.204089462,0.044347438
Arkansas,CRAWFORD,61948,53770,696,3760,8178,0.867986053,0.132013947,0.060696068
Arkansas,CRITTENDEN,50902,23028,25953,1014,27874,0.452398727,0.547601273,0.019920632
Arkansas,CROSS,17870,13343,3966,266,4527,0.746670397,0.253329603,0.014885283
Arkansas,DALLAS,8116,4393,3396,188,3723,0.541276491,0.458723509,0.02316412
Arkansas,DESHA,13008,6083,6176,578,6925,0.467635301,0.532364699,0.044434194
Arkansas,DREW,18509,12587,5139,454,5922,0.680047544,0.319952456,0.024528608
Arkansas,FAULKNER,113237,93326,11495,4435,19911,0.824165246,0.175834754,0.039165644
Arkansas,FRANKLIN,18125,16997,124,371,1128,0.937765517,0.062234483,0.020468966
Arkansas,FULTON,12245,11805,39,97,440,0.964066966,0.035933034,0.007921601
Arkansas,GARLAND,96024,80621,7552,4622,15403,0.839592185,0.160407815,0.0481338
Arkansas,GRANT,17853,16801,385,392,1052,0.941074329,0.058925671,0.021957094
Arkansas,GREENE,42090,40166,232,901,1924,0.95428843,0.04571157,0.02140651
Arkansas,HEMPSTEAD,22609,12770,6623,2713,9839,0.56481932,0.43518068,0.119996462
Arkansas,HOT SPRING,32923,27703,3544,919,5220,0.841448228,0.158551772,0.027913617
Arkansas,HOWARD,13789,9292,2813,1349,4497,0.673870476,0.326129524,0.097831605
Arkansas,INDEPENDENCE,36647,32914,709,2139,3733,0.898136273,0.101863727,0.05836767
Arkansas,IZARD,13696,13006,175,208,690,0.949620327,0.050379673,0.015186916
Arkansas,JACKSON,17997,14180,2988,436,3817,0.787909096,0.212090904,0.02422626
Arkansas,JEFFERSON,77435,32050,42485,1219,45385,0.413895525,0.586104475,0.015742235
Arkansas,JOHNSON,25540,21328,336,3094,4212,0.835082224,0.164917776,0.121143305
Arkansas,LAFAYETTE,7645,4583,2837,131,3062,0.599476782,0.400523218,0.017135383
Arkansas,LAWRENCE,17415,16848,134,158,567,0.96744186,0.03255814,0.009072639
Arkansas,LEE,10424,4320,5740,168,6104,0.414428243,0.585571757,0.016116654
Arkansas,LINCOLN,14134,9296,4211,452,4838,0.657704825,0.342295175,0.031979624
Arkansas,LITTLE RIVER,13171,9831,2508,357,3340,0.746412573,0.253587427,0.027105003
Arkansas,LOGAN,22353,20608,285,510,1745,0.921934416,0.078065584,0.022815729
Arkansas,LONOKE,68356,60108,4059,2246,8248,0.879337586,0.120662414,0.032857394
Arkansas,MADISON,15717,14451,27,759,1266,0.919450277,0.080549723,0.048291659
Arkansas,MARION,16653,15963,28,287,690,0.958566024,0.041433976,0.017234132
Arkansas,MILLER,43462,30691,10589,1038,12771,0.706157103,0.293842897,0.023882932
Arkansas,MISSISSIPPI,46480,28106,15761,1695,18374,0.604690189,0.395309811,0.036467298
Arkansas,MONROE,8149,4549,3314,132,3600,0.558228003,0.441771997,0.016198307
Arkansas,MONTGOMERY,9487,8806,17,361,681,0.928217561,0.071782439,0.038052071
Arkansas,NEVADA,8997,5861,2758,220,3136,0.651439369,0.348560631,0.024452595
Arkansas,NEWTON,8330,7894,5,141,436,0.947659064,0.052340936,0.016926771
Arkansas,OUACHITA,26120,14706,10434,408,11414,0.563016845,0.436983155,0.015620214
Arkansas,PERRY,10445,9779,196,247,666,0.936237434,0.063762566,0.023647678
Arkansas,PHILLIPS,21757,7535,13652,287,14222,0.346325321,0.653674679,0.013191157
Arkansas,PIKE,11291,9963,327,727,1328,0.8823842,0.1176158,0.064387565
Arkansas,POINSETT,24583,21881,1764,543,2702,0.890086645,0.109913355,0.022088435
Arkansas,POLK,20662,18549,54,1190,2113,0.897734972,0.102265028,0.05759365
Arkansas,POPE,61754,53667,1748,4168,8087,0.86904492,0.13095508,0.067493604
Arkansas,PRAIRIE,8715,7470,1061,81,1245,0.857142857,0.142857143,0.00929432
Arkansas,PULASKI,382748,211697,133242,22168,171051,0.553097599,0.446902401,0.057918003
Arkansas,RANDOLPH,17969,17226,128,283,743,0.95865101,0.04134899,0.015749346
Arkansas,ST. FRANCIS,28258,11973,14565,1149,16285,0.423703022,0.576296978,0.040661052
Arkansas,SALINE,107118,95298,4945,4087,11820,0.8896544,0.1103456,0.038154185
Arkansas,SCOTT,11233,9587,51,782,1646,0.853467462,0.146532538,0.069616309
Arkansas,SEARCY,8195,7800,3,121,395,0.951799878,0.048200122,0.014765101
Arkansas,SEBASTIAN,125744,91585,7848,15445,34159,0.728344891,0.271655109,0.122828922
Arkansas,SEVIER,17058,10416,717,5220,6642,0.610622582,0.389377418,0.306014773
Arkansas,SHARP,17264,16399,91,290,865,0.949895737,0.050104263,0.016797961
Arkansas,STONE,12394,11912,11,157,482,0.961110215,0.038889785,0.01266742
Arkansas,UNION,41639,25722,13674,1460,15917,0.617738178,0.382261822,0.035063282
Arkansas,VAN BUREN,17295,16282,65,475,1013,0.941428158,0.058571842,0.027464585
Arkansas,WASHINGTON,203065,150546,5828,31458,52519,0.741368527,0.258631473,0.154915914
Arkansas,WHITE,77076,69026,3033,2879,8050,0.895557631,0.104442369,0.037352743
Arkansas,WOODRUFF,7260,5041,1989,87,2219,0.694352617,0.305647383,0.011983471
Arkansas,YELL,22185,17020,288,4230,5165,0.767185035,0.232814965,0.190669371
California,ALAMEDA,1510271,514559,184126,339889,995712,0.340706403,0.659293597,0.225051663
California,ALPINE,1175,852,0,84,323,0.725106383,0.274893617,0.071489362
California,AMADOR,38091,30325,938,4756,7766,0.796119818,0.203880182,0.124858891
California,BUTTE,220000,165416,3133,31116,54584,0.751890909,0.248109091,0.141436364
California,CALAVERAS,45578,38074,355,4703,7504,0.835359165,0.164640835,0.103185748
California,COLUSA,21419,8524,168,11804,12895,0.397964424,0.602035576,0.551099491
California,CONTRA COSTA,1049025,500923,93604,255560,548102,0.477512929,0.522487071,0.243616692
California,DEL NORTE,28610,18513,967,5093,10097,0.64708144,0.35291856,0.17801468
California,EL DORADO,181058,144689,1296,21875,36369,0.799130665,0.200869335,0.120817639
California,FRESNO,930450,304522,45005,468070,625928,0.327284647,0.672715353,0.50305766
California,GLENN,28122,15717,192,10539,12405,0.558886281,0.441113719,0.374759974
California,HUMBOLDT,134623,103958,1393,13211,30665,0.772215743,0.227784257,0.098133306
California,IMPERIAL,174528,23927,5114,140271,150601,0.13709548,0.86290452,0.803716309
California,INYO,18546,12296,102,3597,6250,0.663000108,0.336999892,0.193950178
California,KERN,839631,323794,45377,413033,515837,0.385638453,0.614361547,0.491922047
California,KINGS,152982,53879,10314,77866,99103,0.352191761,0.647808239,0.508987986
California,LAKE,64665,47938,1186,11088,16727,0.741328385,0.258671615,0.171468337
California,LASSEN,34895,23270,2790,6117,11625,0.666857716,0.333142284,0.175297321
California,LOS ANGELES,9818605,2728321,815086,4687889,7090284,0.277872569,0.722127431,0.477449597
California,MADERA,150865,57380,5009,80992,93485,0.380340039,0.619659961,0.536850827
California,MARIN,252409,183830,6621,39069,68579,0.728302081,0.271697919,0.154784497
California,MARIPOSA,18251,15192,129,1676,3059,0.832392746,0.167607254,0.091830585
California,MENDOCINO,87841,60249,544,19505,27592,0.685887,0.314113,0.222048929
California,MERCED,255793,81599,8785,140485,174194,0.319004038,0.680995962,0.549213622
California,MODOC,9686,7649,77,1342,2037,0.789696469,0.210303531,0.138550485
California,MONO,14202,9687,42,3762,4515,0.68208703,0.31791297,0.264892269
California,MONTEREY,415057,136435,11300,230003,278622,0.328713887,0.671286113,0.554147984
California,NAPA,136484,76967,2440,44010,59517,0.563926907,0.436073093,0.322455379
California,NEVADA,98764,85477,341,8439,13287,0.865467174,0.134532826,0.085446114
California,ORANGE,3010232,1328499,44000,1012973,1681733,0.441327778,0.558672222,0.336509943
California,PLACER,348432,265294,4427,44710,83138,0.761393902,0.238606098,0.128317721
California,PLUMAS,20007,17015,181,1605,2992,0.850452342,0.149547658,0.080221922
California,RIVERSIDE,2189641,869068,130823,995257,1320573,0.396899766,0.603100234,0.454529761
California,SACRAMENTO,1418788,687166,139949,306196,731622,0.484333107,0.515666893,0.215815189
California,SAN BENITO,55269,21154,355,31186,34115,0.382746205,0.617253795,0.564258445
California,SAN BERNARDINO,2035210,677598,170700,1001145,1357612,0.332937633,0.667062367,0.491912383
California,SAN DIEGO,3095313,1500047,146600,991348,1595266,0.484618841,0.515381159,0.320273911
California,SAN FRANCISCO,805235,337451,46781,121774,467784,0.419071451,0.580928549,0.151227902
California,SAN JOAQUIN,685306,245919,48540,266341,439387,0.358845538,0.641154462,0.388645364
California,SAN LUIS OBISPO,269637,191696,5128,55973,77941,0.710941006,0.289058994,0.207586496
California,SAN MATEO,718451,303609,18763,182502,414842,0.422588318,0.577411682,0.254021499
California,SANTA BARBARA,423895,203122,7242,181687,220773,0.479179986,0.520820014,0.428613218
California,SANTA CLARA,1781642,626909,42331,479210,1154733,0.351871476,0.648128524,0.268970983
California,SANTA CRUZ,262382,156397,2304,84092,105985,0.596066041,0.403933959,0.320494546
California,SHASTA,177223,146044,1438,14878,31179,0.824069111,0.175930889,0.083950729
California,SIERRA,3240,2855,5,269,385,0.88117284,0.11882716,0.083024691
California,SISKIYOU,44900,35683,552,4615,9217,0.794721604,0.205278396,0.102783964
California,SOLANO,413344,168628,58743,99356,244716,0.40796044,0.59203956,0.240371216
California,SONOMA,483878,320027,6769,120430,163851,0.661379521,0.338620479,0.24888505
California,STANISLAUS,514453,240423,13065,215658,274030,0.467337152,0.532662848,0.419198644
California,SUTTER,94737,47782,1713,27251,46955,0.504364715,0.495635285,0.287648965
California,TEHAMA,63463,45603,349,13906,17860,0.718576178,0.281423822,0.219119802
California,TRINITY,13786,11518,45,959,2268,0.835485275,0.164514725,0.069563325
California,TULARE,442179,143935,5497,268065,298244,0.325512971,0.674487029,0.606236388
California,TUOLUMNE,55365,45325,1114,5918,10040,0.818657997,0.181342003,0.106890635
California,VENTURA,823318,400868,13082,331567,422450,0.486893278,0.513106722,0.402720456
California,YOLO,200849,100240,4752,60953,100609,0.499081399,0.500918601,0.303476741
California,YUBA,72155,42416,2122,18051,29739,0.58784561,0.41215439,0.250169773
Colorado,ADAMS,441603,234970,12207,167878,206633,0.532084248,0.467915752,0.380155932
Colorado,ALAMOSA,15445,7667,138,7110,7778,0.496406604,0.503593396,0.460343153
Colorado,ARAPAHOE,572003,361747,55657,105522,210256,0.632421508,0.367578492,0.184478053
Colorado,ARCHULETA,12084,9446,33,2148,2638,0.781694803,0.218305197,0.17775571
Colorado,BACA,3788,3323,20,348,465,0.877243928,0.122756072,0.09186906
Colorado,BENT,6499,3832,491,1985,2667,0.589629174,0.410370826,0.305431605
Colorado,BOULDER,294567,233741,2265,39276,60826,0.79350708,0.20649292,0.133334691
Colorado,BROOMFIELD,55889,44358,530,6216,11531,0.793680331,0.206319669,0.111220455
Colorado,CHAFFEE,17809,15417,267,1678,2392,0.865685889,0.134314111,0.094222023
Colorado,CHEYENNE,1836,1617,7,178,219,0.880718954,0.119281046,0.096949891
Colorado,CLEAR CREEK,9088,8371,50,429,717,0.921104754,0.078895246,0.047205106
Colorado,CONEJOS,8256,3451,12,4620,4805,0.417999031,0.582000969,0.559593023
Colorado,COSTILLA,3524,1086,6,2327,2438,0.308172531,0.691827469,0.660329171
Colorado,CROWLEY,5823,3369,555,1686,2454,0.578567749,0.421432251,0.289541473
Colorado,CUSTER,4255,3914,41,200,341,0.919858989,0.080141011,0.047003525
Colorado,DELTA,30952,25685,137,4345,5267,0.82983329,0.17016671,0.140378651
Colorado,DENVER,600158,313012,58388,190965,287146,0.521549325,0.478450675,0.31819121
Colorado,DOLORES,2064,1877,3,82,187,0.909399225,0.090600775,0.039728682
Colorado,DOUGLAS,285465,243297,3245,21392,42168,0.852283117,0.147716883,0.074937383
Colorado,EAGLE,52197,35105,243,15689,17092,0.672548231,0.327451769,0.30057283
Colorado,ELBERT,23086,21005,159,1234,2081,0.909858789,0.090141211,0.053452309
Colorado,EL PASO,622263,447947,35792,93665,174316,0.719867644,0.280132356,0.150523171
Colorado,FREMONT,46824,37647,1805,5770,9177,0.804010764,0.195989236,0.123227405
Colorado,GARFIELD,56389,38784,236,15978,17605,0.687793719,0.312206281,0.283353136
Colorado,GILPIN,5441,4947,28,267,494,0.909207866,0.090792134,0.049071862
Colorado,GRAND,14843,13313,51,1116,1530,0.896921108,0.103078892,0.075186957
Colorado,GUNNISON,15324,13658,45,1255,1666,0.89128165,0.10871835,0.081897677
Colorado,HINSDALE,843,786,3,24,57,0.932384342,0.067615658,0.028469751
Colorado,HUERFANO,6711,4151,22,2368,2560,0.618536731,0.381463269,0.352853524
Colorado,JACKSON,1394,1219,0,150,175,0.87446198,0.12553802,0.107604017
Colorado,JEFFERSON,534543,427160,5001,76445,107383,0.799112513,0.200887487,0.14301001
Colorado,KIOWA,1398,1304,3,78,94,0.932761087,0.067238913,0.055793991
Colorado,KIT CARSON,8270,6320,217,1574,1950,0.764207981,0.235792019,0.190326481
Colorado,LAKE,7310,4252,22,2858,3058,0.581668947,0.418331053,0.390971272
Colorado,LA PLATA,51334,41245,176,6056,10089,0.803463591,0.196536409,0.117972494
Colorado,LARIMER,299630,253047,2259,31628,46583,0.844531589,0.155468411,0.105556853
Colorado,LAS ANIMAS,15507,8399,195,6446,7108,0.541626362,0.458373638,0.41568324
Colorado,LINCOLN,5467,4345,280,683,1122,0.794768612,0.205231388,0.124931407
Colorado,LOGAN,22709,17754,881,3551,4955,0.781804571,0.218195429,0.156369721
Colorado,MESA,146723,121944,776,19552,24779,0.831117139,0.168882861,0.133257908
Colorado,MINERAL,712,678,2,21,34,0.952247191,0.047752809,0.029494382
Colorado,MOFFAT,13795,11412,32,1985,2383,0.827256252,0.172743748,0.143892715
Colorado,MONTEZUMA,25535,19168,47,2818,6367,0.750655962,0.249344038,0.110358332
Colorado,MONTROSE,41276,31989,118,8127,9287,0.775002423,0.224997577,0.196894079
Colorado,MORGAN,28159,17370,755,9506,10789,0.616854292,0.383145708,0.337583011
Colorado,OTERO,18831,10639,93,7596,8192,0.564972651,0.435027349,0.40337741
Colorado,OURAY,4436,4143,6,196,293,0.933949504,0.066050496,0.04418395
Colorado,PARK,16206,14842,69,783,1364,0.915833642,0.084166358,0.048315439
Colorado,PHILLIPS,4442,3526,14,830,916,0.793786583,0.206213417,0.186852769
Colorado,PITKIN,17148,15067,82,1561,2081,0.87864474,0.12135526,0.091031024
Colorado,PROWERS,12551,7873,54,4417,4678,0.627280695,0.372719305,0.351924149
Colorado,PUEBLO,159063,86054,2646,65811,73009,0.541005765,0.458994235,0.413741725
Colorado,RIO BLANCO,6666,5756,49,665,910,0.863486349,0.136513651,0.099759976
Colorado,RIO GRANDE,11982,6600,25,5086,5382,0.550826239,0.449173761,0.424470038
Colorado,ROUTT,23509,21310,91,1600,2199,0.906461355,0.093538645,0.068059041
Colorado,SAGUACHE,6108,3446,11,2452,2662,0.564178127,0.435821873,0.401440733
Colorado,SAN JUAN,699,595,0,84,104,0.851216023,0.148783977,0.120171674
Colorado,SAN MIGUEL,7359,6514,19,630,845,0.885174616,0.114825384,0.085609458
Colorado,SEDGWICK,2379,2036,7,289,343,0.855821774,0.144178226,0.121479613
Colorado,SUMMIT,27994,23158,208,3989,4836,0.827248696,0.172751304,0.14249482
Colorado,TELLER,23350,21148,104,1294,2202,0.905695931,0.094304069,0.055417559
Colorado,WASHINGTON,4814,4306,30,407,508,0.89447445,0.10552555,0.084545077
Colorado,WELD,252825,170827,2054,71680,81998,0.675672896,0.324327104,0.283516266
Colorado,YUMA,10043,7824,16,2088,2219,0.779050085,0.220949915,0.207906004
Connecticut,FAIRFIELD,916829,606716,92705,155025,310113,0.661754809,0.338245191,0.169088238
Connecticut,HARTFORD,894014,591283,110005,136783,302731,0.661380023,0.338619977,0.152998723
Connecticut,LITCHFIELD,189927,173403,2206,8535,16524,0.912998152,0.087001848,0.044938318
Connecticut,MIDDLESEX,165676,143144,7256,7834,22532,0.863999614,0.136000386,0.047285062
Connecticut,NEW HAVEN,862477,582384,101763,129743,280093,0.675245833,0.324754167,0.150430678
Connecticut,NEW LONDON,274055,214605,14488,23214,59450,0.783072741,0.216927259,0.084705625
Connecticut,TOLLAND,152691,133589,4701,6602,19102,0.874897669,0.125102331,0.04323765
Connecticut,WINDHAM,118428,101138,1995,11351,17290,0.854004121,0.145995879,0.095847266
Delaware,KENT,162310,105891,37812,9346,56419,0.652399729,0.347600271,0.057581172
Delaware,NEW CASTLE,538479,331836,124426,46921,206643,0.616246873,0.383753127,0.087136174
Delaware,SUSSEX,197145,149025,24544,16954,48120,0.755915697,0.244084303,0.085997616
District of Columbia,DISTRICT OF COLUMBIA,601723,209464,301053,54749,392259,0.348107019,0.651892981,0.090987049
Florida,ALACHUA,247336,157466,49420,20752,89870,0.636648122,0.363351878,0.08390206
Florida,BAKER,27115,22353,3651,520,4762,0.824377651,0.175622349,0.019177577
Florida,BAY,168852,133790,17844,8107,35062,0.792350698,0.207649302,0.048012461
Florida,BRADFORD,28520,21066,5777,1020,7454,0.738639551,0.261360449,0.035764376
Florida,BREVARD,543376,421466,52677,43943,121910,0.775643385,0.224356615,0.080870337
Florida,BROWARD,1748066,760817,449677,438247,987249,0.435233567,0.564766433,0.250703921
Florida,CALHOUN,14625,11357,1991,755,3268,0.776547009,0.223452991,0.051623932
Florida,CHARLOTTE,159978,137628,8622,9213,22350,0.86029329,0.13970671,0.057589169
Florida,CITRUS,141236,126549,3767,6584,14687,0.896010932,0.103989068,0.04661701
Florida,CLAY,190865,147257,18085,14609,43608,0.771524376,0.228475624,0.076541011
Florida,COLLIER,321520,211156,19898,83177,110364,0.656742971,0.343257029,0.258699303
Florida,COLUMBIA,67531,50475,11663,3276,17056,0.747434512,0.252565488,0.048511054
Florida,DESOTO,34862,19549,4338,10425,15313,0.560753829,0.439246171,0.2990362
Florida,DIXIE,16422,14220,1364,512,2202,0.865911582,0.134088418,0.031177688
Florida,DUVAL,864263,488826,250063,65398,375437,0.565598666,0.434401334,0.075669096
Florida,ESCAMBIA,297619,196901,67443,14061,100718,0.661587466,0.338412534,0.047244968
Florida,FLAGLER,95696,72860,10470,8251,22836,0.761369336,0.238630664,0.08622095
Florida,FRANKLIN,11549,9188,1574,529,2361,0.795566716,0.204433284,0.045804832
Florida,GADSDEN,46389,15335,25881,4419,31054,0.330574059,0.669425941,0.095259652
Florida,GILCHRIST,16939,14882,884,845,2057,0.87856426,0.12143574,0.049884881
Florida,GLADES,12884,7947,1538,2720,4937,0.616811549,0.383188451,0.211114561
Florida,GULF,15863,11881,2937,678,3982,0.748975604,0.251024396,0.04274097
Florida,HAMILTON,14799,8124,5038,1306,6675,0.548956011,0.451043989,0.088249206
Florida,HARDEE,27731,13315,1877,11895,14416,0.48014857,0.51985143,0.428942339
Florida,HENDRY,39140,13650,5057,19243,25490,0.348748084,0.651251916,0.491645376
Florida,HERNANDO,172778,141847,8165,17796,30931,0.820978365,0.179021635,0.102999224
Florida,HIGHLANDS,98786,69804,8750,17157,28982,0.706618347,0.293381653,0.173678456
Florida,HILLSBOROUGH,1229226,660565,191260,306635,568661,0.537382873,0.462617127,0.249453721
Florida,HOLMES,19927,17722,1140,444,2205,0.889346113,0.110653887,0.022281327
Florida,INDIAN RIVER,138028,106780,12074,15465,31248,0.773611151,0.226388849,0.112042484
Florida,JACKSON,49746,33111,13106,2143,16635,0.665601254,0.334398746,0.043078841
Florida,JEFFERSON,14761,8668,5293,546,6093,0.587223088,0.412776912,0.036989364
Florida,LAFAYETTE,8870,6266,1396,1076,2604,0.706426156,0.293573844,0.121307779
Florida,LAKE,297052,221365,27796,36009,75687,0.745206227,0.254793773,0.1212212
Florida,LEE,618754,439048,47751,113308,179706,0.709567938,0.290432062,0.183122857
Florida,LEON,275487,163483,82386,15361,112004,0.593432721,0.406567279,0.055759437
Florida,LEVY,40801,32958,3756,3047,7843,0.807774319,0.192225681,0.074679542
Florida,LIBERTY,8365,6159,1472,518,2206,0.736282128,0.263717872,0.061924686
Florida,MADISON,19224,10582,7423,899,8642,0.550457761,0.449542239,0.046764461
Florida,MANATEE,322833,236950,27228,47955,85883,0.733970815,0.266029185,0.148544294
Florida,MARION,331298,245136,39337,36137,86162,0.739925988,0.260074012,0.109077024
Florida,MARTIN,146318,117532,7493,17881,28786,0.803264123,0.196735877,0.122206427
Florida,MIAMI-DADE,2496435,383551,425650,1623859,2112884,0.15363949,0.84636051,0.650471172
Florida,MONROE,73090,52089,3851,15071,21001,0.712669312,0.287330688,0.206197838
Florida,NASSAU,73314,64410,4581,2380,8904,0.878549799,0.121450201,0.032463104
Florida,OKALOOSA,180822,139500,16333,12296,41322,0.771476922,0.228523078,0.068000575
Florida,OKEECHOBEE,39996,26258,3117,9561,13738,0.656515652,0.343484348,0.239048905
Florida,ORANGE,1145956,526754,223200,308244,619202,0.459663373,0.540336627,0.268984149
Florida,OSCEOLA,268685,108292,24503,122146,160393,0.403044457,0.596955543,0.454606696
Florida,PALM BEACH,1320134,793571,221209,250823,526563,0.601129128,0.398870872,0.189998137
Florida,PASCO,464697,372239,19010,54536,92458,0.801035944,0.198964056,0.117358193
Florida,PINELLAS,916542,704786,91922,73241,211756,0.768962033,0.231037967,0.079910141
Florida,POLK,602095,388769,85336,106532,213326,0.645693786,0.354306214,0.176935533
Florida,PUTNAM,74364,53981,11842,6706,20383,0.725902318,0.274097682,0.090178043
Florida,ST. JOHNS,190039,162194,10388,9972,27845,0.853477444,0.146522556,0.05247344
Florida,ST. LUCIE,277789,170032,51373,45995,107757,0.612090472,0.387909528,0.165575311
Florida,SANTA ROSA,151372,128726,7940,6507,22646,0.850395053,0.149604947,0.042986814
Florida,SARASOTA,379448,321978,17036,30033,57470,0.848543147,0.151456853,0.079149185
Florida,SEMINOLE,422718,280452,44196,72457,142266,0.663449392,0.336550608,0.171407416
Florida,SUMTER,93420,77338,8736,5582,16082,0.827852708,0.172147292,0.059751659
Florida,SUWANNEE,41551,32300,4696,3596,9251,0.777357946,0.222642054,0.086544247
Florida,TAYLOR,22570,16483,4629,777,6087,0.730305716,0.269694284,0.03442623
Florida,UNION,15535,11123,3391,743,4412,0.715996138,0.284003862,0.047827486
Florida,VOLUSIA,494593,372982,49548,55217,121611,0.754119043,0.245880957,0.111641289
Florida,WAKULLA,30776,24472,4406,1016,6304,0.795165064,0.204834936,0.033012737
Florida,WALTON,55043,46857,3147,2921,8186,0.851279908,0.148720092,0.053067602
Florida,WASHINGTON,24896,19551,3698,733,5345,0.785306877,0.214693123,0.029442481
Georgia,APPLING,18236,12854,3360,1704,5382,0.704869489,0.295130511,0.093441544
Georgia,ATKINSON,8375,4776,1428,2039,3599,0.570268657,0.429731343,0.243462687
Georgia,BACON,11096,8431,1696,791,2665,0.75982336,0.24017664,0.07128695
Georgia,BAKER,3451,1642,1600,145,1809,0.475804115,0.524195885,0.042016807
Georgia,BALDWIN,45720,24704,18866,919,21016,0.540332458,0.459667542,0.020100612
Georgia,BANKS,18395,16526,416,1041,1869,0.898396303,0.101603697,0.056591465
Georgia,BARROW,69367,51736,7769,6037,17631,0.74583015,0.25416985,0.087029856
Georgia,BARTOW,100157,79803,10024,7690,20354,0.796779057,0.203220943,0.076779456
Georgia,BEN HILL,17634,10164,6087,1026,7470,0.576386526,0.423613474,0.058183055
Georgia,BERRIEN,19286,16050,2040,885,3236,0.832209893,0.167790107,0.045888209
Georgia,BIBB,155547,65494,80744,4389,90053,0.421056015,0.578943985,0.028216552
Georgia,BLECKLEY,13063,9000,3533,301,4063,0.688968843,0.311031157,0.02304218
Georgia,BRANTLEY,18411,17198,531,343,1213,0.934115474,0.065884526,0.018630167
Georgia,BROOKS,16243,9425,5695,853,6818,0.580249954,0.419750046,0.05251493
Georgia,BRYAN,30233,23446,4210,1336,6787,0.775510204,0.224489796,0.044190123
Georgia,BULLOCH,70217,46251,19252,2439,23966,0.658686643,0.341313357,0.034735178
Georgia,BURKE,23316,10844,11469,617,12472,0.465088351,0.534911649,0.026462515
Georgia,BUTTS,23655,16200,6431,597,7455,0.684844642,0.315155358,0.025237793
Georgia,CALHOUN,6694,2250,4092,262,4444,0.3361219,0.6638781,0.039139528
Georgia,CAMDEN,50513,35977,9621,2590,14536,0.712232495,0.287767505,0.051273929
Georgia,CANDLER,10998,6949,2669,1227,4049,0.631842153,0.368157847,0.111565739
Georgia,CARROLL,110527,80531,19862,6800,29996,0.728609299,0.271390701,0.061523429
Georgia,CATOOSA,63942,59149,1356,1469,4793,0.925041444,0.074958556,0.022973945
Georgia,CHARLTON,12171,8116,3443,310,4055,0.666830992,0.333169008,0.02547038
Georgia,CHATHAM,265128,133492,105274,14370,131636,0.503500196,0.496499804,0.054200235
Georgia,CHATTAHOOCHEE,11267,7089,2047,1398,4178,0.629182569,0.370817431,0.124079169
Georgia,CHATTOOGA,26015,21589,2886,1043,4426,0.829867384,0.170132616,0.040092254
Georgia,CHEROKEE,214346,174243,11633,20566,40103,0.812905303,0.187094697,0.095947673
Georgia,CLARKE,116714,66674,30695,12192,50040,0.57125966,0.42874034,0.104460476
Georgia,CLAY,3183,1188,1920,26,1995,0.373232799,0.626767201,0.008168395
Georgia,CLAYTON,259424,36610,169020,35447,222814,0.141120328,0.858879672,0.13663732
Georgia,CLINCH,6798,4536,1876,236,2262,0.667255075,0.332744925,0.034716093
Georgia,COBB,688078,387438,168053,84330,300640,0.563072791,0.436927209,0.12255878
Georgia,COFFEE,42356,25907,11227,4352,16449,0.611648881,0.388351119,0.102748135
Georgia,COLQUITT,45498,26759,10143,7763,18739,0.588135742,0.411864258,0.170622885
Georgia,COLUMBIA,124053,91517,18084,6175,32536,0.737725005,0.262274995,0.049777111
Georgia,COOK,17212,11171,4684,1024,6041,0.649023937,0.350976063,0.059493377
Georgia,COWETA,127317,92604,21744,8493,34713,0.727349843,0.272650157,0.06670751
Georgia,CRAWFORD,12630,9282,2806,301,3348,0.734916865,0.265083135,0.023832146
Georgia,CRISP,23439,12216,10033,748,11223,0.521182644,0.478817356,0.031912624
Georgia,DADE,16633,15796,142,292,837,0.94967835,0.05032165,0.017555462
Georgia,DAWSON,22330,20847,97,920,1483,0.933587103,0.066412897,0.041200179
Georgia,DECATUR,27842,14615,11366,1404,13227,0.52492637,0.47507363,0.050427412
Georgia,DEKALB,691893,203395,370963,67824,488498,0.293968865,0.706031135,0.098026718
Georgia,DODGE,21796,14273,6451,732,7523,0.654844926,0.345155074,0.033584144
Georgia,DOOLY,14918,6461,7381,862,8457,0.433100952,0.566899048,0.057782545
Georgia,DOUGHERTY,94565,27315,63198,2073,67250,0.28884894,0.71115106,0.02192143
Georgia,DOUGLAS,132403,64911,51387,11125,67492,0.490253242,0.509746758,0.084023776
Georgia,EARLY,11008,5250,5441,171,5758,0.476925872,0.523074128,0.015534157
Georgia,ECHOLS,4034,2555,163,1183,1479,0.633366386,0.366633614,0.293257313
Georgia,EFFINGHAM,52250,42311,6982,1501,9939,0.809779904,0.190220096,0.028727273
Georgia,ELBERT,20166,12956,5906,967,7210,0.64246752,0.35753248,0.047951998
Georgia,EMANUEL,22598,13733,7541,921,8865,0.607708647,0.392291353,0.040755819
Georgia,EVANS,11000,6228,3165,1441,4772,0.566181818,0.433818182,0.131
Georgia,FANNIN,23682,22761,75,431,921,0.961109704,0.038890296,0.018199476
Georgia,FAYETTE,106567,72202,21117,6760,34365,0.677526814,0.322473186,0.063434271
Georgia,FLOYD,96317,70959,13494,8987,25358,0.736723528,0.263276472,0.093306478
Georgia,FORSYTH,175511,140943,4287,16550,34568,0.803043684,0.196956316,0.094296084
Georgia,FRANKLIN,22084,18913,1821,866,3171,0.856411882,0.143588118,0.039213911
Georgia,FULTON,920581,376014,400457,72566,544567,0.408452923,0.591547077,0.078826306
Georgia,GILMER,28292,25078,98,2677,3214,0.886398982,0.113601018,0.094620387
Georgia,GLASCOCK,3082,2750,251,33,332,0.892277742,0.107722258,0.010707333
Georgia,GLYNN,79626,51602,20525,5126,28024,0.648054656,0.351945344,0.064375958
Georgia,GORDON,55186,44107,1945,7738,11079,0.799242562,0.200757438,0.140216722
Georgia,GRADY,25011,14879,7129,2500,10132,0.594898245,0.405101755,0.099956019
Georgia,GREENE,15994,8771,6078,893,7223,0.548393147,0.451606853,0.055833438
Georgia,GWINNETT,805321,354316,184122,162035,451005,0.439968658,0.560031342,0.201205482
Georgia,HABERSHAM,43041,34621,1412,5333,8420,0.804372575,0.195627425,0.123905114
Georgia,HALL,179684,114300,12757,46906,65384,0.636116738,0.363883262,0.261047172
Georgia,HANCOCK,9429,2212,6959,139,7217,0.234595397,0.765404603,0.014741754
Georgia,HARALSON,28780,26516,1342,318,2264,0.92133426,0.07866574,0.01104934
Georgia,HARRIS,32024,24848,5457,872,7176,0.775918061,0.224081939,0.027229578
Georgia,HART,25213,19213,4691,786,6000,0.762027525,0.237972475,0.031174394
Georgia,HEARD,11834,10190,1152,223,1644,0.861078249,0.138921751,0.018844009
Georgia,HENRY,203922,107083,74056,11813,96839,0.525117447,0.474882553,0.057929012
Georgia,HOUSTON,139900,84703,39535,8515,55197,0.605453896,0.394546104,0.060864904
Georgia,IRWIN,9538,6719,2459,228,2819,0.704445376,0.295554624,0.023904382
Georgia,JACKSON,60485,50695,4050,3736,9790,0.838141688,0.161858312,0.06176738
Georgia,JASPER,13900,10095,3030,510,3805,0.726258993,0.273741007,0.036690647
Georgia,JEFF DAVIS,15068,11056,2212,1577,4012,0.733740377,0.266259623,0.10465888
Georgia,JEFFERSON,16930,7015,9187,517,9915,0.414353219,0.585646781,0.030537507
Georgia,JENKINS,8340,4508,3353,334,3832,0.540527578,0.459472422,0.040047962
Georgia,JOHNSON,9980,6219,3461,186,3761,0.623146293,0.376853707,0.018637275
Georgia,JONES,28669,20830,6977,315,7839,0.726568768,0.273431232,0.010987478
Georgia,LAMAR,18317,11943,5621,341,6374,0.652017252,0.347982748,0.018616586
Georgia,LANIER,10078,6899,2367,461,3179,0.684560429,0.315439571,0.045743203
Georgia,LAURENS,48434,28920,17268,1143,19514,0.59710121,0.40289879,0.023599125
Georgia,LEE,28298,21453,5239,560,6845,0.758110114,0.241889886,0.019789384
Georgia,LIBERTY,63453,27085,26018,6159,36368,0.42685137,0.57314863,0.097063969
Georgia,LINCOLN,7996,5201,2562,98,2795,0.650450225,0.349549775,0.012256128
Georgia,LONG,14464,8491,3541,1778,5973,0.587043695,0.412956305,0.122925885
Georgia,LOWNDES,109233,61234,38815,5238,47999,0.560581509,0.439418491,0.047952542
Georgia,LUMPKIN,29966,27519,310,1344,2447,0.918340786,0.081659214,0.044850831
Georgia,MCDUFFIE,21875,12310,8661,475,9565,0.562742857,0.437257143,0.021714286
Georgia,MCINTOSH,14333,8716,5132,227,5617,0.608107165,0.391892835,0.015837578
Georgia,MACON,14740,4961,8902,527,9779,0.336567164,0.663432836,0.035753053
Georgia,MADISON,28120,24106,2320,1139,4014,0.857254623,0.142745377,0.040504979
Georgia,MARION,8742,5100,2837,570,3642,0.583390528,0.416609472,0.065202471
Georgia,MERIWETHER,21992,12606,8583,347,9386,0.573208439,0.426791561,0.015778465
Georgia,MILLER,6125,4237,1697,93,1888,0.691755102,0.308244898,0.015183673
Georgia,MITCHELL,23498,10894,11185,1028,12604,0.463613925,0.536386075,0.043748404
Georgia,MONROE,26424,19101,6249,535,7323,0.722865577,0.277134423,0.020246745
Georgia,MONTGOMERY,9123,6144,2372,480,2979,0.673462677,0.326537323,0.052614272
Georgia,MORGAN,17868,12814,4199,494,5054,0.717147974,0.282852026,0.027647191
Georgia,MURRAY,39628,33666,212,5154,5962,0.849550823,0.150449177,0.130059554
Georgia,MUSCOGEE,189885,82890,85119,12110,106995,0.436527372,0.563472628,0.063775443
Georgia,NEWTON,99958,51995,40371,4635,47963,0.520168471,0.479831529,0.046369475
Georgia,OCONEE,32808,28306,1610,1436,4502,0.862777371,0.137222629,0.043769812
Georgia,OGLETHORPE,14899,11429,2557,546,3470,0.767098463,0.232901537,0.036646755
Georgia,PAULDING,142324,106739,23810,7264,35585,0.749971895,0.250028105,0.051038476
Georgia,PEACH,27695,12499,12647,1890,15196,0.451308901,0.548691099,0.068243365
Georgia,PICKENS,29431,27802,297,819,1629,0.944650199,0.055349801,0.027827801
Georgia,PIERCE,18758,15860,1646,887,2898,0.845505917,0.154494083,0.047286491
Georgia,PIKE,17869,15506,1825,193,2363,0.867759807,0.132240193,0.010800828
Georgia,POLK,41475,30492,5150,4885,10983,0.735189873,0.264810127,0.117781796
Georgia,PULASKI,12010,7494,3808,465,4516,0.623980017,0.376019983,0.038717735
Georgia,PUTNAM,21218,14024,5497,1347,7194,0.660948251,0.339051749,0.063483834
Georgia,QUITMAN,2513,1265,1198,34,1248,0.503382411,0.496617589,0.013529646
Georgia,RABUN,16276,14468,144,1301,1808,0.888916196,0.111083804,0.079933645
Georgia,RANDOLPH,7719,2781,4747,119,4938,0.360279829,0.639720171,0.015416505
Georgia,RICHMOND,200549,76236,107365,8207,124313,0.380136525,0.619863475,0.040922667
Georgia,ROCKDALE,85215,34826,38996,8063,50389,0.408683917,0.591316083,0.094619492
Georgia,SCHLEY,5010,3612,1167,161,1398,0.720958084,0.279041916,0.032135729
Georgia,SCREVEN,14593,7898,6283,180,6695,0.541218392,0.458781608,0.012334681
Georgia,SEMINOLE,8729,5516,2887,204,3213,0.6319166,0.3680834,0.023370375
Georgia,SPALDING,64073,38986,20937,2451,25087,0.608462223,0.391537777,0.038253242
Georgia,STEPHENS,26175,22006,2821,633,4169,0.840725883,0.159274117,0.024183381
Georgia,STEWART,6058,1655,2833,1454,4403,0.273192473,0.726807527,0.240013206
Georgia,SUMTER,32819,13413,16894,1717,19406,0.408696182,0.591303818,0.052317255
Georgia,TALBOT,6865,2639,4039,91,4226,0.384413693,0.615586307,0.013255645
Georgia,TALIAFERRO,1717,625,1024,35,1092,0.364006989,0.635993011,0.020384391
Georgia,TATTNALL,25520,15196,7424,2502,10324,0.595454545,0.404545455,0.098040752
Georgia,TAYLOR,8906,5123,3485,164,3783,0.575230182,0.424769818,0.018414552
Georgia,TELFAIR,16500,8429,5830,2026,8071,0.510848485,0.489151515,0.122787879
Georgia,TERRELL,9315,3366,5683,157,5949,0.361352657,0.638647343,0.016854536
Georgia,THOMAS,44720,26081,16416,1275,18639,0.583206619,0.416793381,0.028510733
Georgia,TIFT,40118,23555,11549,4037,16563,0.587142928,0.412857072,0.100628147
Georgia,TOOMBS,27223,16887,6716,3055,10336,0.620321052,0.379678948,0.112221283
Georgia,TOWNS,10471,10102,39,206,369,0.964759813,0.035240187,0.019673384
Georgia,TREUTLEN,6885,4466,2239,103,2419,0.6486565,0.3513435,0.014960058
Georgia,TROUP,67044,40408,22319,2170,26636,0.602708669,0.397291331,0.032366804
Georgia,TURNER,8930,4820,3697,282,4110,0.539753639,0.460246361,0.031578947
Georgia,TWIGGS,9023,5059,3703,124,3964,0.560678267,0.439321733,0.013742658
Georgia,UNION,21356,20345,95,519,1011,0.952659674,0.047340326,0.024302304
Georgia,UPSON,27153,18522,7544,588,8631,0.682134571,0.317865429,0.021655066
Georgia,WALKER,68756,63343,2809,1113,5413,0.921272325,0.078727675,0.016187678
Georgia,WALTON,83768,65677,12993,2683,18091,0.784034476,0.215965524,0.032028937
Georgia,WARE,36312,23583,10662,1207,12729,0.649454726,0.350545274,0.0332397
Georgia,WARREN,5834,2133,3584,54,3701,0.365615358,0.634384642,0.009256085
Georgia,WASHINGTON,21187,9339,11124,407,11848,0.440789163,0.559210837,0.019209893
Georgia,WAYNE,30099,21749,5928,1719,8350,0.722582146,0.277417854,0.057111532
Georgia,WEBSTER,2799,1492,1177,98,1307,0.533047517,0.466952483,0.035012504
Georgia,WHEELER,7421,4405,2582,356,3016,0.59358577,0.40641423,0.047971971
Georgia,WHITE,27144,25453,454,647,1691,0.937702623,0.062297377,0.023835838
Georgia,WHITFIELD,102599,63818,3631,32471,38781,0.62201386,0.37798614,0.316484566
Georgia,WILCOX,9255,5544,3233,338,3711,0.599027553,0.400972447,0.0365208
Georgia,WILKES,10593,5495,4516,361,5098,0.51873879,0.48126121,0.034079109
Georgia,WILKINSON,9563,5529,3664,214,4034,0.578165848,0.421834152,0.022377915
Georgia,WORTH,21679,15044,5951,335,6635,0.693943448,0.306056552,0.015452742
Hawaii,HAWAII,185079,57831,899,21383,127248,0.312466568,0.687533432,0.115534447
Hawaii,HONOLULU,953207,181684,17929,77433,771523,0.190602881,0.809397119,0.081234192
Hawaii,KALAWAO,90,24,0,1,66,0.266666667,0.733333333,0.011111111
Hawaii,KAUAI,67091,20611,258,6315,46480,0.307209611,0.692790389,0.094125889
Hawaii,MAUI,154834,49193,818,15710,105641,0.317714455,0.682285545,0.101463503
Idaho,ADA,392365,339332,4180,27905,53033,0.864837587,0.135162413,0.071120003
Idaho,ADAMS,3976,3768,4,94,208,0.947686117,0.052313883,0.023641851
Idaho,BANNOCK,82839,71566,591,5587,11273,0.863916754,0.136083246,0.067444078
Idaho,BEAR LAKE,5986,5671,6,216,315,0.947377213,0.052622787,0.036084196
Idaho,BENEWAH,9285,7919,25,235,1366,0.852880991,0.147119009,0.025309639
Idaho,BINGHAM,45607,34176,78,7864,11431,0.749358651,0.250641349,0.172429671
Idaho,BLAINE,21376,16669,23,4272,4707,0.779799775,0.220200225,0.199850299
Idaho,BOISE,7028,6552,13,249,476,0.932270916,0.067729084,0.03542971
Idaho,BONNER,40877,38606,51,911,2271,0.944443085,0.055556915,0.022286371
Idaho,BONNEVILLE,104234,88873,533,11912,15361,0.85262966,0.14737034,0.114281329
Idaho,BOUNDARY,10972,10110,29,402,862,0.921436384,0.078563616,0.036638717
Idaho,BUTTE,2891,2713,5,119,178,0.938429609,0.061570391,0.041162228
Idaho,CAMAS,1117,1008,2,75,109,0.902417189,0.097582811,0.067144136
Idaho,CANYON,188923,136553,877,45069,52370,0.722797118,0.277202882,0.238557508
Idaho,CARIBOU,6963,6481,4,336,482,0.930776964,0.069223036,0.048255062
Idaho,CASSIA,22952,16742,38,5724,6210,0.729435343,0.270564657,0.249390031
Idaho,CLARK,982,558,2,398,424,0.568228106,0.431771894,0.405295316
Idaho,CLEARWATER,8761,8063,16,268,698,0.92032873,0.07967127,0.030590115
Idaho,CUSTER,4368,4108,5,176,260,0.94047619,0.05952381,0.04029304
Idaho,ELMORE,27038,20305,696,4118,6733,0.750980102,0.249019898,0.152304165
Idaho,FRANKLIN,12786,11743,28,838,1043,0.918426404,0.081573596,0.065540435
Idaho,FREMONT,13242,11273,24,1694,1969,0.851306449,0.148693551,0.127926295
Idaho,GEM,16719,14898,20,1336,1821,0.891082003,0.108917997,0.079909085
Idaho,GOODING,15464,10758,13,4344,4706,0.69568029,0.30431971,0.280910502
Idaho,IDAHO,16267,15028,38,421,1239,0.923833528,0.076166472,0.025880617
Idaho,JEFFERSON,26140,22925,40,2641,3215,0.877008416,0.122991584,0.1010329
Idaho,JEROME,22374,14958,39,6929,7416,0.668543846,0.331456154,0.309689819
Idaho,KOOTENAI,138494,127454,381,5268,11040,0.920285355,0.079714645,0.038037749
Idaho,LATAH,37244,33746,288,1326,3498,0.906078831,0.093921169,0.03560305
Idaho,LEMHI,7936,7543,16,181,393,0.950478831,0.049521169,0.02280746
Idaho,LEWIS,3821,3398,14,128,423,0.889295996,0.110704004,0.033499084
Idaho,LINCOLN,5208,3607,18,1476,1601,0.692588326,0.307411674,0.283410138
Idaho,MADISON,37536,34218,178,2218,3318,0.911604859,0.088395141,0.05908994
Idaho,MINIDOKA,20069,13095,44,6493,6974,0.652498879,0.347501121,0.323533808
Idaho,NEZ PERCE,39265,34835,112,1109,4430,0.887176875,0.112823125,0.028243983
Idaho,ONEIDA,4286,4073,9,126,213,0.950303313,0.049696687,0.02939804
Idaho,OWYHEE,11526,7867,18,2979,3659,0.682543814,0.317456186,0.258459136
Idaho,PAYETTE,22623,18388,41,3363,4235,0.812801132,0.187198868,0.148654025
Idaho,POWER,7817,5164,18,2328,2653,0.660611488,0.339388512,0.29781246
Idaho,SHOSHONE,12765,11929,20,380,836,0.934508421,0.065491579,0.029768899
Idaho,TETON,10170,8286,12,1721,1884,0.814749263,0.185250737,0.169223206
Idaho,TWIN FALLS,77230,63841,307,10570,13389,0.826634727,0.173365273,0.136863913
Idaho,VALLEY,9862,9277,9,386,585,0.940681403,0.059318597,0.039140134
Idaho,WASHINGTON,10198,8166,10,1716,2032,0.800745244,0.199254756,0.168268288
Illinois,ADAMS,67103,62414,2288,776,4689,0.930122349,0.069877651,0.011564312
Illinois,ALEXANDER,8238,4983,2908,155,3255,0.604879825,0.395120175,0.018815246
Illinois,BOND,17768,15797,1061,547,1971,0.889070239,0.110929761,0.030785682
Illinois,BOONE,54165,40757,976,10967,13408,0.752460076,0.247539924,0.202473922
Illinois,BROWN,6937,5191,1275,402,1746,0.748306184,0.251693816,0.057950123
Illinois,BUREAU,34978,31473,191,2695,3505,0.899794156,0.100205844,0.07704843
Illinois,CALHOUN,5089,5001,6,40,88,0.982707801,0.017292199,0.00786009
Illinois,CARROLL,15387,14596,122,437,791,0.948592968,0.051407032,0.028400598
Illinois,CASS,13642,10830,379,2291,2812,0.793871866,0.206128134,0.167937253
Illinois,CHAMPAIGN,201081,142470,24553,10607,58611,0.708520447,0.291479553,0.052749887
Illinois,CHRISTIAN,34800,33331,492,471,1469,0.957787356,0.042212644,0.013534483
Illinois,CLARK,16335,15925,48,172,410,0.97490052,0.02509948,0.010529538
Illinois,CLAY,13815,13429,43,151,386,0.972059356,0.027940644,0.010930148
Illinois,CLINTON,37762,34766,1323,1058,2996,0.920660982,0.079339018,0.028017584
Illinois,COLES,53873,49330,2022,1155,4543,0.915672044,0.084327956,0.021439311
Illinois,COOK,5194675,2278358,1265778,1244762,2916317,0.438594907,0.561405093,0.239622691
Illinois,CRAWFORD,19817,18216,923,362,1601,0.919210779,0.080789221,0.018267144
Illinois,CUMBERLAND,11048,10815,35,75,233,0.97891021,0.02108979,0.006788559
Illinois,DEKALB,105160,83825,6579,10647,21335,0.797118676,0.202881324,0.101245721
Illinois,DE WITT,16561,15855,82,354,706,0.957369724,0.042630276,0.021375521
Illinois,DOUGLAS,19980,18427,53,1210,1553,0.922272272,0.077727728,0.060560561
Illinois,DUPAGE,916924,646130,41024,121506,270794,0.70467127,0.29532873,0.132514799
Illinois,EDGAR,18576,18142,63,187,434,0.97663652,0.02336348,0.010066753
Illinois,EDWARDS,6721,6555,30,59,166,0.975301294,0.024698706,0.008778456
Illinois,EFFINGHAM,34242,33155,76,597,1087,0.968255359,0.031744641,0.017434729
Illinois,FAYETTE,22140,20585,969,304,1555,0.929765131,0.070234869,0.013730804
Illinois,FORD,14081,13520,78,294,561,0.96015908,0.03984092,0.020879199
Illinois,FRANKLIN,39561,38353,118,475,1208,0.969464877,0.030535123,0.012006774
Illinois,FULTON,37069,34397,1268,896,2672,0.927918207,0.072081793,0.02417114
Illinois,GALLATIN,5589,5427,12,66,162,0.971014493,0.028985507,0.01180891
Illinois,GREENE,13886,13517,119,115,369,0.973426473,0.026573527,0.008281723
Illinois,GRUNDY,50063,44526,577,4096,5537,0.889399357,0.110600643,0.081816911
Illinois,HAMILTON,8457,8234,31,105,223,0.973631311,0.026368689,0.01241575
Illinois,HANCOCK,19104,18611,51,185,493,0.974193886,0.025806114,0.009683836
Illinois,HARDIN,4320,4171,13,56,149,0.965509259,0.034490741,0.012962963
Illinois,HENDERSON,7331,7133,15,79,198,0.972991406,0.027008594,0.010776156
Illinois,HENRY,50486,46493,762,2402,3993,0.920908767,0.079091233,0.047577546
Illinois,IROQUOIS,29718,27467,233,1584,2251,0.92425466,0.07574534,0.05330103
Illinois,JACKSON,60218,45746,8488,2403,14472,0.759673187,0.240326813,0.039905012
Illinois,JASPER,9698,9517,10,79,181,0.981336358,0.018663642,0.008146009
Illinois,JEFFERSON,38827,33919,3194,799,4908,0.873593118,0.126406882,0.020578463
Illinois,JERSEY,22985,22281,89,222,704,0.969371329,0.030628671,0.009658473
Illinois,JO DAVIESS,22678,21681,100,609,997,0.956036688,0.043963312,0.02685422
Illinois,JOHNSON,12582,11056,1004,376,1526,0.878715625,0.121284375,0.029883961
Illinois,KANE,515269,304051,27819,158390,211218,0.590082074,0.409917926,0.307392838
Illinois,KANKAKEE,113449,83218,16998,10167,30231,0.733527841,0.266472159,0.089617361
Illinois,KENDALL,114736,85156,6343,17898,29580,0.742190768,0.257809232,0.155992888
Illinois,KNOX,52919,45132,3741,2558,7787,0.852850583,0.147149417,0.048338026
Illinois,LAKE,703462,458701,46989,139987,244761,0.652062229,0.347937771,0.198997245
Illinois,LASALLE,113924,100545,2104,9135,13379,0.882562059,0.117437941,0.080185036
Illinois,LAWRENCE,16833,14491,1583,553,2342,0.860868532,0.139131468,0.032852136
Illinois,LEE,36031,31824,1709,1802,4207,0.883239433,0.116760567,0.050012489
Illinois,LIVINGSTON,38950,34903,1887,1532,4047,0.896097561,0.103902439,0.039332478
Illinois,LOGAN,30305,26586,2243,893,3719,0.877280977,0.122719023,0.029467085
Illinois,MCDONOUGH,32612,28979,1594,867,3633,0.888599289,0.111400711,0.026585306
Illinois,MCHENRY,308760,258584,3045,35249,50176,0.837491903,0.162508097,0.114163104
Illinois,MCLEAN,169572,138835,12246,7434,30737,0.818737763,0.181262237,0.043839785
Illinois,MACON,110768,86822,17916,2072,23946,0.783818431,0.216181569,0.018705763
Illinois,MACOUPIN,47765,46315,359,418,1450,0.969643044,0.030356956,0.008751178
Illinois,MADISON,269282,233515,21066,7313,35767,0.867176417,0.132823583,0.027157404
Illinois,MARION,39437,36456,1536,542,2981,0.924411086,0.075588914,0.013743439
Illinois,MARSHALL,12640,12128,44,314,512,0.959493671,0.040506329,0.024841772
Illinois,MASON,14666,14296,53,117,370,0.974771581,0.025228419,0.007977635
Illinois,MASSAC,15429,13860,891,290,1569,0.89830838,0.10169162,0.018795774
Illinois,MENARD,12705,12320,74,121,385,0.96969697,0.03030303,0.00952381
Illinois,MERCER,16434,15912,46,307,522,0.968236583,0.031763417,0.018680784
Illinois,MONROE,32957,31991,64,450,966,0.97068908,0.02931092,0.013654155
Illinois,MONTGOMERY,30104,28334,949,459,1770,0.941203827,0.058796173,0.015247143
Illinois,MORGAN,35547,31937,2104,712,3610,0.898444313,0.101555687,0.02002982
Illinois,MOULTRIE,14846,14524,40,129,322,0.978310656,0.021689344,0.008689209
Illinois,OGLE,53497,47425,468,4741,6072,0.886498308,0.113501692,0.088621792
Illinois,PEORIA,186494,135620,32720,7102,50874,0.727208382,0.272791618,0.038081654
Illinois,PERRY,22350,19463,1856,599,2887,0.87082774,0.12917226,0.026800895
Illinois,PIATT,16729,16276,56,167,453,0.972921274,0.027078726,0.009982665
Illinois,PIKE,16430,15802,274,172,628,0.961777237,0.038222763,0.010468655
Illinois,POPE,4470,4055,269,64,415,0.907158837,0.092841163,0.014317673
Illinois,PULASKI,6161,3937,1976,97,2224,0.63901964,0.36098036,0.015744197
Illinois,PUTNAM,6006,5654,31,252,352,0.941391941,0.058608059,0.041958042
Illinois,RANDOLPH,33476,28933,3245,867,4543,0.864290835,0.135709165,0.025899152
Illinois,RICHLAND,16233,15673,78,205,560,0.965502372,0.034497628,0.012628596
Illinois,ROCK ISLAND,147546,111764,12911,17118,35782,0.757485801,0.242514199,0.116018055
Illinois,ST. CLAIR,270056,169858,81860,8785,100198,0.62897325,0.37102675,0.03253029
Illinois,SALINE,24913,23011,974,340,1902,0.923654317,0.076345683,0.013647493
Illinois,SANGAMON,197465,162987,23146,3480,34478,0.825396906,0.174603094,0.017623376
Illinois,SCHUYLER,7544,7163,240,90,381,0.949496288,0.050503712,0.011930011
Illinois,SCOTT,5355,5246,5,43,109,0.979645191,0.020354809,0.008029879
Illinois,SHELBY,22363,21922,48,180,441,0.980279927,0.019720073,0.00804901
Illinois,STARK,5994,5826,28,59,168,0.971971972,0.028028028,0.009843177
Illinois,STEPHENSON,47711,40612,4226,1406,7099,0.851208317,0.148791683,0.029469095
Illinois,TAZEWELL,135394,128625,1351,2514,6769,0.95000517,0.04999483,0.018568031
Illinois,UNION,17808,16454,151,863,1354,0.923966757,0.076033243,0.048461366
Illinois,VERMILION,81625,65590,10394,3441,16035,0.803552833,0.196447167,0.042156202
Illinois,WABASH,11947,11498,73,158,449,0.962417343,0.037582657,0.013225077
Illinois,WARREN,17707,15582,287,1490,2125,0.879990964,0.120009036,0.084147512
Illinois,WASHINGTON,14716,14260,94,197,456,0.969013319,0.030986681,0.01338679
Illinois,WAYNE,16760,16340,40,176,420,0.974940334,0.025059666,0.010501193
Illinois,WHITE,14665,14308,37,158,357,0.975656325,0.024343675,0.010773952
Illinois,WHITESIDE,58498,50263,705,6455,8235,0.859225956,0.140774044,0.110345653
Illinois,WILL,677560,455577,74419,105817,221983,0.67237883,0.32762117,0.156173623
Illinois,WILLIAMSON,66357,60719,2514,1301,5638,0.915035339,0.084964661,0.01960607
Illinois,WINNEBAGO,295266,214196,35358,32177,81070,0.725434015,0.274565985,0.108976313
Illinois,WOODFORD,38664,37294,186,527,1370,0.964566522,0.035433478,0.01363025
Indiana,ADAMS,34387,32521,102,1412,1866,0.945735307,0.054264693,0.041062029
Indiana,ALLEN,355329,271789,40998,23093,83540,0.764893943,0.235106057,0.064990474
Indiana,BARTHOLOMEW,76794,66817,1360,4762,9977,0.870080996,0.129919004,0.062010053
Indiana,BENTON,8854,8298,36,431,556,0.937203524,0.062796476,0.048678563
Indiana,BLACKFORD,12766,12403,48,117,363,0.971565095,0.028434905,0.009164969
Indiana,BOONE,56640,53151,484,1270,3489,0.938400424,0.061599576,0.022422316
Indiana,BROWN,15242,14761,53,178,481,0.968442462,0.031557538,0.011678257
Indiana,CARROLL,20155,19188,42,711,967,0.952021831,0.047978169,0.035276606
Indiana,CASS,38966,32624,519,4897,6342,0.837242724,0.162757276,0.125673664
Indiana,CLARK,110232,93887,7541,5350,16345,0.851721823,0.148278177,0.048534001
Indiana,CLAY,26890,26146,85,307,744,0.972331722,0.027668278,0.011416884
Indiana,CLINTON,33224,28349,138,4395,4875,0.853268721,0.146731279,0.132283891
Indiana,CRAWFORD,10713,10390,21,126,323,0.969849715,0.030150285,0.011761411
Indiana,DAVIESS,31648,29696,165,1314,1952,0.938321537,0.061678463,0.041519211
Indiana,DEARBORN,50047,48486,291,502,1561,0.968809319,0.031190681,0.010030571
Indiana,DECATUR,25740,24796,76,426,944,0.963325563,0.036674437,0.016550117
Indiana,DEKALB,42223,40406,141,1031,1817,0.956966582,0.043033418,0.024417971
Indiana,DELAWARE,117671,103721,8051,2088,13950,0.881449125,0.118550875,0.017744389
Indiana,DUBOIS,41889,38791,109,2521,3098,0.926042636,0.073957364,0.060182864
Indiana,ELKHART,197559,152555,10989,27886,45004,0.772199697,0.227800303,0.14115277
Indiana,FAYETTE,24277,23392,318,223,885,0.963545743,0.036454257,0.009185649
Indiana,FLOYD,74578,66505,3822,1972,8073,0.891750919,0.108249081,0.026442114
Indiana,FOUNTAIN,17240,16598,26,373,642,0.962761021,0.037238979,0.021635731
Indiana,FRANKLIN,23087,22600,34,210,487,0.978905878,0.021094122,0.009096028
Indiana,FULTON,20836,19438,144,882,1398,0.932904588,0.067095412,0.042330582
Indiana,GIBSON,33503,31752,589,441,1751,0.947736024,0.052263976,0.013163
Indiana,GRANT,70061,60633,4805,2517,9428,0.865431553,0.134568447,0.035925836
Indiana,GREENE,33165,32343,49,322,822,0.975214835,0.024785165,0.009709031
Indiana,HAMILTON,274569,237317,9395,9426,37252,0.864325543,0.135674457,0.034330168
Indiana,HANCOCK,70002,65859,1420,1216,4143,0.940815977,0.059184023,0.017370932
Indiana,HARRISON,39364,37984,167,581,1380,0.964942587,0.035057413,0.014759679
Indiana,HENDRICKS,145448,128664,6988,4379,16784,0.884604807,0.115395193,0.03010698
Indiana,HENRY,49462,46933,1064,691,2529,0.948869839,0.051130161,0.013970321
Indiana,HOWARD,82752,72091,5585,2203,10661,0.871169277,0.128830723,0.026621713
Indiana,HUNTINGTON,37124,35692,155,631,1432,0.96142657,0.03857343,0.016997091
Indiana,JACKSON,42376,38826,265,2410,3550,0.916226166,0.083773834,0.056871814
Indiana,JASPER,33478,30988,208,1823,2490,0.925622797,0.074377203,0.054453671
Indiana,JAY,21253,20356,58,577,897,0.957794194,0.042205806,0.027149108
Indiana,JEFFERSON,32428,30463,530,755,1965,0.939404219,0.060595781,0.023282349
Indiana,JENNINGS,28525,27361,206,571,1164,0.95919369,0.04080631,0.020017528
Indiana,JOHNSON,139654,128903,1536,4270,10751,0.923016885,0.076983115,0.030575565
Indiana,KNOX,38440,36154,994,590,2286,0.940530697,0.059469303,0.015348595
Indiana,KOSCIUSKO,77358,69531,542,5634,7827,0.898821066,0.101178934,0.072830218
Indiana,LAGRANGE,37128,35290,109,1317,1838,0.950495583,0.049504417,0.035471881
Indiana,LAKE,496005,274162,125506,82663,221843,0.552740396,0.447259604,0.166657594
Indiana,LAPORTE,111467,90695,11835,6093,20772,0.813648883,0.186351117,0.054661918
Indiana,LAWRENCE,46134,44562,181,545,1572,0.965925348,0.034074652,0.011813413
Indiana,MADISON,131636,113577,10887,4189,18059,0.862811085,0.137188915,0.031822602
Indiana,MARION,903393,537905,238454,84466,365488,0.595427461,0.404572539,0.093498621
Indiana,MARSHALL,47051,42098,196,3971,4953,0.894731249,0.105268751,0.084397781
Indiana,MARTIN,10334,10125,10,70,209,0.979775498,0.020224502,0.006773757
Indiana,MIAMI,36903,33307,1649,906,3596,0.902555348,0.097444652,0.02455085
Indiana,MONROE,137974,118837,4363,4029,19137,0.861299955,0.138700045,0.029201154
Indiana,MONTGOMERY,38124,35374,307,1739,2750,0.92786696,0.07213304,0.045614311
Indiana,MORGAN,68894,66782,175,820,2112,0.96934421,0.03065579,0.011902343
Indiana,NEWTON,14244,13296,53,717,948,0.933445661,0.066554339,0.050336984
Indiana,NOBLE,47536,42104,170,4567,5432,0.885728711,0.114271289,0.096074554
Indiana,OHIO,6128,5967,21,69,161,0.973727154,0.026272846,0.011259791
Indiana,ORANGE,19840,19144,168,194,696,0.964919355,0.035080645,0.009778226
Indiana,OWEN,21575,20983,65,198,592,0.972560834,0.027439166,0.009177289
Indiana,PARKE,17339,16545,391,215,794,0.954207278,0.045792722,0.012399792
Indiana,PERRY,19338,18428,469,192,910,0.952942393,0.047057607,0.009928638
Indiana,PIKE,12845,12544,38,120,301,0.976566757,0.023433243,0.009342156
Indiana,PORTER,164343,141243,4649,13933,23100,0.859440317,0.140559683,0.084780003
Indiana,POSEY,25910,25046,230,248,864,0.966653802,0.033346198,0.009571594
Indiana,PULASKI,13402,12823,87,325,579,0.956797493,0.043202507,0.024250112
Indiana,PUTNAM,37963,35128,1485,587,2835,0.925322024,0.074677976,0.015462424
Indiana,RANDOLPH,26171,24895,114,790,1276,0.951243743,0.048756257,0.030186084
Indiana,RIPLEY,28818,27879,67,445,939,0.967416198,0.032583802,0.015441738
Indiana,RUSH,17392,16839,129,190,553,0.968203772,0.031796228,0.010924563
Indiana,ST. JOSEPH,266931,201701,33407,19395,65230,0.755629732,0.244370268,0.072659227
Indiana,SCOTT,24181,23471,52,354,710,0.970638104,0.029361896,0.014639593
Indiana,SHELBY,44436,41622,428,1647,2814,0.936672968,0.063327032,0.037064542
Indiana,SPENCER,20952,20101,96,517,851,0.959383352,0.040616648,0.024675449
Indiana,STARKE,23363,22212,63,766,1151,0.950734067,0.049265933,0.032786885
Indiana,STEUBEN,34185,32513,155,982,1672,0.951089659,0.048910341,0.028726049
Indiana,SULLIVAN,21475,19930,946,294,1545,0.928055879,0.071944121,0.013690338
Indiana,SWITZERLAND,10613,10318,31,147,295,0.972203901,0.027796099,0.013850938
Indiana,TIPPECANOE,172780,138855,6731,12947,33925,0.803652043,0.196347957,0.074933441
Indiana,TIPTON,15936,15355,28,346,581,0.963541667,0.036458333,0.021711847
Indiana,UNION,7516,7280,33,82,236,0.968600319,0.031399681,0.010910059
Indiana,VANDERBURGH,179703,153080,16228,3873,26623,0.851849997,0.148150003,0.021552228
Indiana,VERMILLION,16212,15862,21,130,350,0.978411054,0.021588946,0.008018752
Indiana,VIGO,107848,93550,7371,2469,14298,0.867424523,0.132575477,0.022893331
Indiana,WABASH,32888,31369,155,697,1519,0.953812941,0.046187059,0.02119314
Indiana,WARREN,8508,8321,10,70,187,0.978020686,0.021979314,0.008227551
Indiana,WARRICK,59689,56095,780,946,3594,0.939787901,0.060212099,0.015848816
Indiana,WASHINGTON,28262,27539,63,304,723,0.974417946,0.025582054,0.010756493
Indiana,WAYNE,68917,61322,3349,1804,7595,0.889794971,0.110205029,0.026176415
Indiana,WELLS,27636,26604,89,564,1032,0.962657403,0.037342597,0.020408163
Indiana,WHITE,24643,22470,51,1746,2173,0.911820801,0.088179199,0.070851763
Indiana,WHITLEY,33292,32147,96,515,1145,0.965607353,0.034392647,0.015469182
Iowa,ADAIR,7682,7507,11,101,175,0.977219474,0.022780526,0.013147618
Iowa,ADAMS,4029,3922,8,37,107,0.973442542,0.026557458,0.00918342
Iowa,ALLAMAKEE,14330,13325,109,757,1005,0.929867411,0.070132589,0.052826239
Iowa,APPANOOSE,12887,12470,55,181,417,0.96764181,0.03235819,0.014045162
Iowa,AUDUBON,6119,6007,9,37,112,0.981696356,0.018303644,0.00604674
Iowa,BENTON,26076,25387,93,275,689,0.973577236,0.026422764,0.010546096
Iowa,BLACK HAWK,131090,109968,11493,4907,21122,0.838874056,0.161125944,0.037432298
Iowa,BOONE,26306,25194,202,505,1112,0.957728275,0.042271725,0.019197141
Iowa,BREMER,24276,23459,186,239,817,0.966345362,0.033654638,0.009845115
Iowa,BUCHANAN,20958,20344,59,243,614,0.970703311,0.029296689,0.011594618
Iowa,BUENA VISTA,20260,13756,497,4608,6504,0.678973346,0.321026654,0.227443238
Iowa,BUTLER,14867,14552,25,133,315,0.978812134,0.021187866,0.008945988
Iowa,CALHOUN,9670,9470,19,90,200,0.979317477,0.020682523,0.009307135
Iowa,CARROLL,20816,20119,82,333,697,0.966516141,0.033483859,0.01599731
Iowa,CASS,13956,13502,33,253,454,0.967469189,0.032530811,0.018128404
Iowa,CEDAR,18499,17897,52,284,602,0.9674577,0.0325423,0.015352181
Iowa,CERRO GORDO,44151,40876,555,1694,3275,0.925822745,0.074177255,0.038368327
Iowa,CHEROKEE,12072,11553,64,274,519,0.957007952,0.042992048,0.02269715
Iowa,CHICKASAW,12439,12048,29,269,391,0.968566605,0.031433395,0.021625533
Iowa,CLARKE,9286,8208,38,927,1078,0.883911264,0.116088736,0.099827698
Iowa,CLAY,16667,15843,68,477,824,0.950560989,0.049439011,0.028619428
Iowa,CLAYTON,18129,17563,60,306,566,0.968779304,0.031220696,0.016879034
Iowa,CLINTON,49116,45454,1258,1243,3662,0.925441811,0.074558189,0.025307435
Iowa,CRAWFORD,17096,12541,195,4131,4555,0.733563407,0.266436593,0.24163547
Iowa,DALLAS,66135,58630,890,4059,7505,0.886519997,0.113480003,0.061374461
Iowa,DAVIS,8753,8556,7,85,197,0.977493431,0.022506569,0.009710956
Iowa,DECATUR,8457,7946,149,181,511,0.939576682,0.060423318,0.021402389
Iowa,DELAWARE,17764,17408,45,139,356,0.979959469,0.020040531,0.007824814
Iowa,DES MOINES,40325,36059,2005,1042,4266,0.894209547,0.105790453,0.02584005
Iowa,DICKINSON,16667,16255,29,178,412,0.975280494,0.024719506,0.010679786
Iowa,DUBUQUE,93653,86981,2436,1807,6672,0.928758289,0.071241711,0.01929463
Iowa,EMMET,10302,9319,61,763,983,0.904581635,0.095418365,0.074063289
Iowa,FAYETTE,20880,19987,196,380,893,0.957231801,0.042768199,0.018199234
Iowa,FLOYD,16303,15443,200,331,860,0.947248973,0.052751027,0.020303012
Iowa,FRANKLIN,10680,9334,19,1209,1346,0.873970037,0.126029963,0.113202247
Iowa,FREMONT,7441,7123,32,187,318,0.957263809,0.042736191,0.025131031
Iowa,GREENE,9336,9017,22,171,319,0.965831191,0.034168809,0.018316195
Iowa,GRUNDY,12453,12190,26,122,263,0.978880591,0.021119409,0.009796836
Iowa,GUTHRIE,10954,10595,16,202,359,0.967226584,0.032773416,0.018440752
Iowa,HAMILTON,15673,14344,40,782,1329,0.915204492,0.084795508,0.049894723
Iowa,HANCOCK,11341,10744,50,398,597,0.947359139,0.052640861,0.035093907
Iowa,HARDIN,17534,16430,208,651,1104,0.937036615,0.062963385,0.037127866
Iowa,HARRISON,14928,14532,25,183,396,0.973472669,0.026527331,0.012258842
Iowa,HENRY,20145,18141,435,764,2004,0.900521221,0.099478779,0.037925043
Iowa,HOWARD,9566,9314,25,118,252,0.973656701,0.026343299,0.012335354
Iowa,HUMBOLDT,9815,9288,39,357,527,0.946306673,0.053693327,0.036372899
Iowa,IDA,7089,6907,17,100,182,0.974326421,0.025673579,0.014106362
Iowa,IOWA,16355,15818,53,307,537,0.967166004,0.032833996,0.018771018
Iowa,JACKSON,19848,19223,58,220,625,0.968510681,0.031489319,0.01108424
Iowa,JASPER,36842,35284,464,537,1558,0.957711308,0.042288692,0.014575756
Iowa,JEFFERSON,16843,14539,199,410,2304,0.863207267,0.136792733,0.024342457
Iowa,JOHNSON,130882,108767,6163,6200,22115,0.831031005,0.168968995,0.047370914
Iowa,JONES,20638,19716,405,270,922,0.955325128,0.044674872,0.013082663
Iowa,KEOKUK,10511,10286,50,90,225,0.978593854,0.021406146,0.008562458
Iowa,KOSSUTH,15543,15121,43,215,422,0.972849514,0.027150486,0.013832593
Iowa,LEE,35862,32833,1094,1092,3029,0.915537338,0.084462662,0.030450059
Iowa,LINN,211226,188592,8160,5534,22634,0.892844631,0.107155369,0.026199426
Iowa,LOUISA,11387,9309,52,1797,2078,0.817511197,0.182488803,0.157811539
Iowa,LUCAS,8898,8720,15,89,178,0.979995505,0.020004495,0.010002248
Iowa,LYON,11581,11267,9,212,314,0.972886625,0.027113375,0.018305846
Iowa,MADISON,15679,15233,45,197,446,0.971554308,0.028445692,0.012564577
Iowa,MAHASKA,22381,21242,251,360,1139,0.949108619,0.050891381,0.016085072
Iowa,MARION,33309,31834,211,531,1475,0.955717674,0.044282326,0.015941637
Iowa,MARSHALL,40648,31807,629,7017,8841,0.782498524,0.217501476,0.17262842
Iowa,MILLS,15059,14390,57,359,669,0.955574739,0.044425261,0.023839564
Iowa,MITCHELL,10776,10564,20,110,212,0.980326652,0.019673348,0.010207869
Iowa,MONONA,9243,8904,33,107,339,0.963323596,0.036676404,0.011576328
Iowa,MONROE,7970,7677,22,169,293,0.963237139,0.036762861,0.021204517
Iowa,MONTGOMERY,10740,10265,25,305,475,0.955772812,0.044227188,0.02839851
Iowa,MUSCATINE,42745,34518,545,6803,8227,0.807533045,0.192466955,0.159153117
Iowa,O'BRIEN,14398,13605,56,545,793,0.944922906,0.055077094,0.03785248
Iowa,OSCEOLA,6462,5937,15,430,525,0.918755803,0.081244197,0.066542866
Iowa,PAGE,15932,14767,344,438,1165,0.926876726,0.073123274,0.02749184
Iowa,PALO ALTO,9421,9108,44,152,313,0.966776351,0.033223649,0.016134168
Iowa,PLYMOUTH,24986,23782,73,742,1204,0.951813015,0.048186985,0.02969663
Iowa,POCAHONTAS,7310,7043,26,166,267,0.963474692,0.036525308,0.022708618
Iowa,POLK,430640,347710,25344,32647,82930,0.807426156,0.192573844,0.075810422
Iowa,POTTAWATTAMIE,93158,83609,1216,6151,9549,0.897496726,0.102503274,0.066027609
Iowa,POWESHIEK,18914,17705,213,456,1209,0.936079095,0.063920905,0.024109126
Iowa,RINGGOLD,5131,4966,17,91,165,0.967842526,0.032157474,0.017735334
Iowa,SAC,10350,10031,31,195,319,0.969178744,0.030821256,0.01884058
Iowa,SCOTT,165224,136884,11413,9197,28340,0.828475282,0.171524718,0.055663826
Iowa,SHELBY,12167,11763,31,219,404,0.96679543,0.03320457,0.017999507
Iowa,SIOUX,33704,30090,104,3001,3614,0.892772371,0.107227629,0.089039877
Iowa,STORY,89542,77812,2125,2695,11730,0.869000022,0.130999978,0.030097608
Iowa,TAMA,17767,14874,59,1320,2893,0.837170034,0.162829966,0.074295041
Iowa,TAYLOR,6317,5872,12,364,445,0.929555169,0.070444831,0.057622289
Iowa,UNION,12534,12029,88,225,505,0.95970959,0.04029041,0.017951173
Iowa,VAN BUREN,7570,7373,15,88,197,0.973976222,0.026023778,0.011624835
Iowa,WAPELLO,35625,31157,447,3234,4468,0.874582456,0.125417544,0.090778947
Iowa,WARREN,46225,44266,213,899,1959,0.957620335,0.042379665,0.01944835
Iowa,WASHINGTON,21704,20114,140,1138,1590,0.926741614,0.073258386,0.052432731
Iowa,WAYNE,6403,6244,17,69,159,0.97516789,0.02483211,0.010776199
Iowa,WEBSTER,38013,34210,1435,1446,3803,0.899955278,0.100044722,0.038039618
Iowa,WINNEBAGO,10866,10247,78,360,619,0.943033315,0.056966685,0.033130867
Iowa,WINNESHIEK,21056,20153,130,418,903,0.957114362,0.042885638,0.019851824
Iowa,WOODBURY,102172,79282,2384,13993,22890,0.775966018,0.224033982,0.13695533
Iowa,WORTH,7598,7335,21,147,263,0.965385628,0.034614372,0.019347197
Iowa,WRIGHT,13229,11738,40,1274,1491,0.887293068,0.112706932,0.096303575
Kansas,ALLEN,13371,12285,243,392,1086,0.918779448,0.081220552,0.029317179
Kansas,ANDERSON,8102,7774,40,123,328,0.959516169,0.040483831,0.015181437
Kansas,ATCHISON,16924,15152,844,383,1772,0.89529662,0.10470338,0.022630584
Kansas,BARBER,4861,4608,20,119,253,0.947953096,0.052046904,0.02448056
Kansas,BARTON,27674,23092,367,3683,4582,0.834429428,0.165570572,0.133085206
Kansas,BOURBON,15173,13953,409,309,1220,0.919594016,0.080405984,0.020365122
Kansas,BROWN,9984,8391,116,306,1593,0.840444712,0.159555288,0.030649038
Kansas,BUTLER,65880,59920,1054,2602,5960,0.909532483,0.090467517,0.039496053
Kansas,CHASE,2790,2597,34,100,193,0.930824373,0.069175627,0.035842294
Kansas,CHAUTAUQUA,3669,3291,13,87,378,0.896974652,0.103025348,0.023712183
Kansas,CHEROKEE,21603,19280,116,424,2323,0.892468639,0.107531361,0.019626904
Kansas,CHEYENNE,2726,2543,2,142,183,0.932868672,0.067131328,0.052090976
Kansas,CLARK,2215,1967,0,163,248,0.888036117,0.111963883,0.073589165
Kansas,CLAY,8535,8184,34,162,351,0.95887522,0.04112478,0.018980668
Kansas,CLOUD,9533,9035,49,283,498,0.947760411,0.052239589,0.029686353
Kansas,COFFEY,8601,8176,47,176,425,0.950587141,0.049412859,0.020462737
Kansas,COMANCHE,1891,1783,6,73,108,0.942887361,0.057112639,0.038603913
Kansas,COWLEY,36311,29832,971,3292,6479,0.821569221,0.178430779,0.090661232
Kansas,CRAWFORD,39134,34842,757,1762,4292,0.890325548,0.109674452,0.045024787
Kansas,DECATUR,2961,2869,17,30,92,0.968929416,0.031070584,0.010131712
Kansas,DICKINSON,19754,18312,139,769,1442,0.927002126,0.072997874,0.038928825
Kansas,DONIPHAN,7945,7282,242,165,663,0.91655129,0.08344871,0.020767778
Kansas,DOUGLAS,110826,90532,4204,5651,20294,0.816884125,0.183115875,0.05098984
Kansas,EDWARDS,3037,2446,5,534,591,0.805400066,0.194599934,0.175831413
Kansas,ELK,2882,2694,0,79,188,0.934767523,0.065232477,0.02741152
Kansas,ELLIS,28452,26103,232,1299,2349,0.917439899,0.082560101,0.045655841
Kansas,ELLSWORTH,6497,5733,299,322,764,0.882407265,0.117592735,0.049561336
Kansas,FINNEY,36776,17049,707,17182,19727,0.463590385,0.536409615,0.467206874
Kansas,FORD,33848,14897,605,17321,18951,0.44011463,0.55988537,0.511728906
Kansas,FRANKLIN,25992,23880,320,937,2112,0.918744229,0.081255771,0.036049554
Kansas,GEARY,34362,20587,6015,4252,13775,0.599121122,0.400878878,0.123741342
Kansas,GOVE,2695,2618,7,42,77,0.971428571,0.028571429,0.015584416
Kansas,GRAHAM,2597,2357,96,59,240,0.907585676,0.092414324,0.022718521
Kansas,GRANT,7829,4240,31,3439,3589,0.541576191,0.458423809,0.439264274
Kansas,GRAY,6006,5050,22,855,956,0.840825841,0.159174159,0.142357642
Kansas,GREELEY,1247,1056,3,171,191,0.846832398,0.153167602,0.13712911
Kansas,GREENWOOD,6689,6257,23,220,432,0.935416355,0.064583645,0.032889819
Kansas,HAMILTON,2690,1801,8,827,889,0.669516729,0.330483271,0.307434944
Kansas,HARPER,6034,5582,21,298,452,0.92509115,0.07490885,0.049386808
Kansas,HARVEY,34684,29332,530,3747,5352,0.845692538,0.154307462,0.108032522
Kansas,HASKELL,4256,3036,4,1149,1220,0.713345865,0.286654135,0.269971805
Kansas,HODGEMAN,1916,1748,20,118,168,0.912317328,0.087682672,0.061586639
Kansas,JACKSON,13462,11559,69,438,1903,0.858639132,0.141360868,0.032536027
Kansas,JEFFERSON,19126,18170,100,339,956,0.950015685,0.049984315,0.017724563
Kansas,JEWELL,3077,2959,4,63,118,0.961650959,0.038349041,0.020474488
Kansas,JOHNSON,544179,446044,23028,38949,98135,0.819664118,0.180335882,0.071573876
Kansas,KEARNY,3977,2726,16,1135,1251,0.685441287,0.314558713,0.285390998
Kansas,KINGMAN,7858,7486,13,199,372,0.95265971,0.04734029,0.02532451
Kansas,KIOWA,2553,2378,12,99,175,0.931453192,0.068546808,0.038777908
Kansas,LABETTE,21607,18467,987,875,3140,0.854676725,0.145323275,0.040496136
Kansas,LANE,1750,1628,8,74,122,0.930285714,0.069714286,0.042285714
Kansas,LEAVENWORTH,76227,61226,7007,4308,15001,0.803206213,0.196793787,0.056515408
Kansas,LINCOLN,3241,3116,8,72,125,0.961431657,0.038568343,0.022215366
Kansas,LINN,9656,9184,41,186,472,0.951118476,0.048881524,0.019262635
Kansas,LOGAN,2756,2609,16,80,147,0.946661829,0.053338171,0.029027576
Kansas,LYON,33690,24704,731,6755,8986,0.733273969,0.266726031,0.200504601
Kansas,MCPHERSON,29180,27176,279,1025,2004,0.931322824,0.068677176,0.035126799
Kansas,MARION,12660,11992,95,296,668,0.947235387,0.052764613,0.023380727
Kansas,MARSHALL,10117,9727,26,193,390,0.961451023,0.038548977,0.019076801
Kansas,MEADE,4575,3761,31,676,814,0.822076503,0.177923497,0.147759563
Kansas,MIAMI,32787,30708,411,828,2079,0.936590722,0.063409278,0.025253912
Kansas,MITCHELL,6373,6197,13,73,176,0.972383493,0.027616507,0.011454574
Kansas,MONTGOMERY,35471,28712,2022,1844,6759,0.809449973,0.190550027,0.05198613
Kansas,MORRIS,5923,5572,25,212,351,0.94073949,0.05926051,0.035792673
Kansas,MORTON,3233,2466,14,623,767,0.762759047,0.237240953,0.192700278
Kansas,NEMAHA,10178,9843,51,121,335,0.967085871,0.032914129,0.011888387
Kansas,NEOSHO,16512,15136,192,686,1376,0.916666667,0.083333333,0.041545543
Kansas,NESS,3107,2828,17,229,279,0.910202768,0.089797232,0.073704538
Kansas,NORTON,5671,5166,162,240,505,0.91095045,0.08904955,0.042320578
Kansas,OSAGE,16295,15560,44,330,735,0.954894139,0.045105861,0.020251611
Kansas,OSBORNE,3858,3743,8,46,115,0.970191809,0.029808191,0.011923276
Kansas,OTTAWA,6091,5828,49,121,263,0.95682154,0.04317846,0.019865375
Kansas,PAWNEE,6973,6018,318,461,955,0.863043166,0.136956834,0.066112147
Kansas,PHILLIPS,5642,5394,22,121,248,0.956043956,0.043956044,0.021446296
Kansas,POTTAWATOMIE,21604,19690,214,957,1914,0.911405295,0.088594705,0.044297352
Kansas,PRATT,9656,8812,100,525,844,0.912593206,0.087406794,0.05437034
Kansas,RAWLINS,2519,2400,8,80,119,0.952759031,0.047240969,0.031758634
Kansas,RENO,64511,55543,1843,5209,8968,0.860984948,0.139015052,0.080745919
Kansas,REPUBLIC,4980,4851,22,53,129,0.974096386,0.025903614,0.01064257
Kansas,RICE,10083,8683,112,1018,1400,0.861152435,0.138847565,0.100962015
Kansas,RILEY,71115,56571,4344,4610,14544,0.795486184,0.204513816,0.06482458
Kansas,ROOKS,5181,4981,21,107,200,0.961397414,0.038602586,0.020652384
Kansas,RUSH,3307,3165,8,84,142,0.95706078,0.04293922,0.025400665
Kansas,RUSSELL,6970,6640,53,115,330,0.952654232,0.047345768,0.016499283
Kansas,SALINE,55606,45671,1743,5403,9935,0.82133223,0.17866777,0.097165773
Kansas,SCOTT,4936,4097,16,753,839,0.830024311,0.169975689,0.152552674
Kansas,SEDGWICK,498365,348434,44931,64636,149931,0.699154234,0.300845766,0.129696106
Kansas,SEWARD,22952,8261,687,12990,14691,0.359925061,0.640074939,0.56596375
Kansas,SHAWNEE,177934,134549,14598,19303,43385,0.756173637,0.243826363,0.108484045
Kansas,SHERIDAN,2556,2436,3,84,120,0.953051643,0.046948357,0.03286385
Kansas,SHERMAN,6010,5214,34,647,796,0.867554077,0.132445923,0.10765391
Kansas,SMITH,3853,3712,10,57,141,0.963405139,0.036594861,0.014793667
Kansas,STAFFORD,4437,3805,10,529,632,0.857561415,0.142438585,0.119224701
Kansas,STANTON,2235,1351,12,828,884,0.604474273,0.395525727,0.370469799
Kansas,STEVENS,5724,3744,14,1866,1980,0.65408805,0.34591195,0.325995807
Kansas,SUMNER,24132,22044,211,1097,2088,0.913475883,0.086524117,0.045458313
Kansas,THOMAS,7900,7336,47,370,564,0.928607595,0.071392405,0.046835443
Kansas,TREGO,3001,2902,13,51,99,0.967010996,0.032989004,0.016994335
Kansas,WABAUNSEE,7053,6664,28,205,389,0.944846165,0.055153835,0.029065646
Kansas,WALLACE,1485,1354,2,108,131,0.911784512,0.088215488,0.072727273
Kansas,WASHINGTON,5799,5558,23,144,241,0.958441111,0.041558889,0.024831868
Kansas,WICHITA,2234,1647,14,550,587,0.737242614,0.262757386,0.246195166
Kansas,WILSON,9409,8866,30,217,543,0.942289297,0.057710703,0.023063025
Kansas,WOODSON,3309,3139,12,69,170,0.948624962,0.051375038,0.020852221
Kansas,WYANDOTTE,157505,68170,39046,41633,89335,0.432811657,0.567188343,0.264328117
Kentucky,ADAIR,18656,17558,501,319,1098,0.94114494,0.05885506,0.017099057
Kentucky,ALLEN,19956,19203,159,297,753,0.962266987,0.037733013,0.014882742
Kentucky,ANDERSON,21421,20314,427,288,1107,0.94832174,0.05167826,0.01344475
Kentucky,BALLARD,8249,7762,238,90,487,0.940962541,0.059037459,0.010910413
Kentucky,BARREN,42173,38597,1617,1110,3576,0.915206412,0.084793588,0.026320157
Kentucky,BATH,11591,11130,152,157,461,0.960227763,0.039772237,0.013544992
Kentucky,BELL,28691,27297,633,198,1394,0.951413335,0.048586665,0.006901119
Kentucky,BOONE,118811,106955,2928,4205,11856,0.90021126,0.09978874,0.035392346
Kentucky,BOURBON,19985,17027,1187,1368,2958,0.851988992,0.148011008,0.068451339
Kentucky,BOYD,49542,46463,1374,714,3079,0.937850713,0.062149287,0.014412014
Kentucky,BOYLE,28432,24704,2106,796,3728,0.868880135,0.131119865,0.027996624
Kentucky,BRACKEN,8488,8251,29,96,237,0.972078228,0.027921772,0.011310085
Kentucky,BREATHITT,13878,13575,43,89,303,0.978166883,0.021833117,0.006413028
Kentucky,BRECKINRIDGE,20059,19134,404,175,925,0.953886036,0.046113964,0.008724263
Kentucky,BULLITT,74319,71368,472,1038,2951,0.960292792,0.039707208,0.013966819
Kentucky,BUTLER,12690,12182,47,322,508,0.959968479,0.040031521,0.02537431
Kentucky,CALDWELL,12984,11952,664,129,1032,0.92051756,0.07948244,0.009935305
Kentucky,CALLOWAY,37191,33672,1375,890,3519,0.905380334,0.094619666,0.023930521
Kentucky,CAMPBELL,90336,84406,2253,1495,5930,0.934356181,0.065643819,0.016549327
Kentucky,CARLISLE,5104,4906,35,83,198,0.961206897,0.038793103,0.016261755
Kentucky,CARROLL,10811,9575,160,789,1236,0.885672001,0.114327999,0.072981223
Kentucky,CARTER,27720,26930,145,321,790,0.971500722,0.028499278,0.011580087
Kentucky,CASEY,15955,15326,80,378,629,0.960576622,0.039423378,0.023691633
Kentucky,CHRISTIAN,73955,50709,15445,4541,23246,0.685673721,0.314326279,0.061402204
Kentucky,CLARK,35613,32407,1693,891,3206,0.909976694,0.090023306,0.025018954
Kentucky,CLAY,21730,20189,900,402,1541,0.929084215,0.070915785,0.01849977
Kentucky,CLINTON,10272,9865,39,231,407,0.960377726,0.039622274,0.022488318
Kentucky,CRITTENDEN,9315,9065,76,48,250,0.973161567,0.026838433,0.005152979
Kentucky,CUMBERLAND,6856,6508,177,63,348,0.94924154,0.05075846,0.009189032
Kentucky,DAVIESS,96656,87005,4583,2525,9651,0.900151051,0.099848949,0.026123572
Kentucky,EDMONSON,12161,11733,166,100,428,0.964805526,0.035194474,0.008223008
Kentucky,ELLIOTT,7852,7473,262,62,379,0.951732043,0.048267957,0.007896077
Kentucky,ESTILL,14672,14407,28,101,265,0.981938386,0.018061614,0.00688386
Kentucky,FAYETTE,295803,216072,42336,20474,79731,0.730459123,0.269540877,0.069214984
Kentucky,FLEMING,14348,13858,181,149,490,0.965848899,0.034151101,0.010384723
Kentucky,FLOYD,39451,38624,292,219,827,0.979037287,0.020962713,0.00555119
Kentucky,FRANKLIN,49285,41026,5078,1374,8259,0.832423658,0.167576342,0.027878665
Kentucky,FULTON,6813,4973,1607,53,1840,0.729928079,0.270071921,0.007779246
Kentucky,GALLATIN,8589,7952,109,372,637,0.925835371,0.074164629,0.043311212
Kentucky,GARRARD,16912,15965,339,403,947,0.944004257,0.055995743,0.023829234
Kentucky,GRANT,24662,23545,173,577,1117,0.954707647,0.045292353,0.023396318
Kentucky,GRAVES,37121,32608,1597,2099,4513,0.878424611,0.121575389,0.056544813
Kentucky,GRAYSON,25746,24885,260,258,861,0.966557912,0.033442088,0.010020974
Kentucky,GREEN,11258,10691,222,159,567,0.949635815,0.050364185,0.01412329
Kentucky,GREENUP,36910,35752,255,284,1158,0.968626389,0.031373611,0.007694392
Kentucky,HANCOCK,8565,8282,70,94,283,0.966958552,0.033041448,0.010974898
Kentucky,HARDIN,105543,82139,11878,5317,23404,0.778251518,0.221748482,0.050377571
Kentucky,HARLAN,29278,28030,639,210,1248,0.957374138,0.042625862,0.007172621
Kentucky,HARRISON,18846,17846,379,337,1000,0.946938342,0.053061658,0.017881779
Kentucky,HART,18199,16771,883,261,1428,0.92153415,0.07846585,0.014341447
Kentucky,HENDERSON,46250,40773,3568,858,5477,0.881578378,0.118421622,0.018551351
Kentucky,HENRY,15416,14272,410,447,1144,0.925791386,0.074208614,0.028995848
Kentucky,HICKMAN,4902,4298,451,57,604,0.876784986,0.123215014,0.011627907
Kentucky,HOPKINS,46920,41940,3069,734,4980,0.893861893,0.106138107,0.015643649
Kentucky,JACKSON,13494,13298,13,84,196,0.985475026,0.014524974,0.006224989
Kentucky,JEFFERSON,741096,522561,152451,32542,218535,0.705119175,0.294880825,0.04391064
Kentucky,JESSAMINE,48586,44336,1487,1353,4250,0.912526242,0.087473758,0.027847528
Kentucky,JOHNSON,23356,22900,56,109,456,0.980476109,0.019523891,0.004666895
Kentucky,KENTON,159720,143430,7267,4225,16290,0.898009016,0.101990984,0.026452542
Kentucky,KNOTT,16346,16015,116,99,331,0.979750398,0.020249602,0.006056528
Kentucky,KNOX,31883,30805,344,270,1078,0.966188878,0.033811122,0.008468463
Kentucky,LARUE,14193,13096,441,401,1097,0.922708377,0.077291623,0.028253364
Kentucky,LAUREL,58849,56732,405,717,2117,0.964026576,0.035973424,0.012183724
Kentucky,LAWRENCE,15860,15582,32,77,278,0.982471627,0.017528373,0.004854981
Kentucky,LEE,7887,7564,185,58,323,0.959046532,0.040953468,0.007353873
Kentucky,LESLIE,11310,11152,22,40,158,0.986030062,0.013969938,0.003536693
Kentucky,LETCHER,24519,24120,85,124,399,0.983726906,0.016273094,0.005057303
Kentucky,LEWIS,13870,13650,35,78,220,0.984138428,0.015861572,0.005623648
Kentucky,LINCOLN,24742,23404,560,372,1338,0.945921914,0.054078086,0.015035163
Kentucky,LIVINGSTON,9519,9243,16,123,276,0.971005358,0.028994642,0.012921525
Kentucky,LOGAN,26835,23934,1734,651,2901,0.891894913,0.108105087,0.024259363
Kentucky,LYON,8314,7672,437,77,642,0.922780852,0.077219148,0.009261487
Kentucky,MCCRACKEN,65565,55025,7179,1383,10540,0.839243499,0.160756501,0.021093571
Kentucky,MCCREARY,18306,16557,977,392,1749,0.904457555,0.095542445,0.021413744
Kentucky,MCLEAN,9531,9278,53,106,253,0.973455041,0.026544959,0.011121603
Kentucky,MADISON,82916,74967,3565,1813,7949,0.904131893,0.095868107,0.021865502
Kentucky,MAGOFFIN,13333,13106,18,95,227,0.982974574,0.017025426,0.007125178
Kentucky,MARION,19820,17285,1593,482,2535,0.87209889,0.12790111,0.02431887
Kentucky,MARSHALL,31448,30669,48,350,779,0.975228949,0.024771051,0.011129484
Kentucky,MARTIN,12929,11533,882,388,1396,0.892025679,0.107974321,0.030010055
Kentucky,MASON,17490,15686,1117,248,1804,0.896855346,0.103144654,0.014179531
Kentucky,MEADE,28602,25905,899,859,2697,0.905705895,0.094294105,0.030032865
Kentucky,MENIFEE,6306,6056,112,51,250,0.960355217,0.039644783,0.008087536
Kentucky,MERCER,21331,19614,751,490,1717,0.919506821,0.080493179,0.022971262
Kentucky,METCALFE,10099,9730,153,115,369,0.963461729,0.036538271,0.011387266
Kentucky,MONROE,10963,10314,231,289,649,0.940800876,0.059199124,0.026361397
Kentucky,MONTGOMERY,26499,24715,712,660,1784,0.932676705,0.067323295,0.0249066
Kentucky,MORGAN,13923,13048,598,108,875,0.937154349,0.062845651,0.007756949
Kentucky,MUHLENBERG,31499,29301,1417,367,2198,0.930220007,0.069779993,0.011651164
Kentucky,NELSON,43437,39498,2168,888,3939,0.909316942,0.090683058,0.020443401
Kentucky,NICHOLAS,7135,6922,41,98,213,0.970147162,0.029852838,0.013735109
Kentucky,OHIO,23842,22531,187,844,1311,0.945013002,0.054986998,0.035399715
Kentucky,OLDHAM,60316,53796,2571,2133,6520,0.891902646,0.108097354,0.035363751
Kentucky,OWEN,10841,10367,90,246,474,0.956277096,0.043722904,0.022691634
Kentucky,OWSLEY,4755,4659,13,39,96,0.979810726,0.020189274,0.008201893
Kentucky,PENDLETON,14877,14521,47,143,356,0.976070444,0.023929556,0.009612153
Kentucky,PERRY,28712,27622,432,185,1090,0.962036779,0.037963221,0.006443299
Kentucky,PIKE,65024,63431,348,446,1593,0.975501353,0.024498647,0.006859006
Kentucky,POWELL,12613,12264,78,132,349,0.972330136,0.027669864,0.010465393
Kentucky,PULASKI,63063,59943,705,1318,3120,0.950525665,0.049474335,0.020899735
Kentucky,ROBERTSON,2282,2232,3,22,50,0.978089395,0.021910605,0.009640666
Kentucky,ROCKCASTLE,17056,16741,19,103,315,0.981531426,0.018468574,0.006038931
Kentucky,ROWAN,23333,22266,341,294,1067,0.954270775,0.045729225,0.01260018
Kentucky,RUSSELL,17565,16676,79,585,889,0.949387987,0.050612013,0.033304868
Kentucky,SCOTT,47173,41441,2433,1994,5732,0.878489814,0.121510186,0.042269943
Kentucky,SHELBY,42074,34080,3038,3812,7994,0.810001426,0.189998574,0.090602272
Kentucky,SIMPSON,17327,14941,1615,325,2386,0.862295839,0.137704161,0.018756853
Kentucky,SPENCER,17061,16278,256,239,783,0.954105855,0.045894145,0.014008558
Kentucky,TAYLOR,24512,22329,1210,433,2183,0.91094158,0.08905842,0.017664817
Kentucky,TODD,12460,10797,989,494,1663,0.866532905,0.133467095,0.03964687
Kentucky,TRIGG,14339,12675,1171,175,1664,0.883952856,0.116047144,0.012204477
Kentucky,TRIMBLE,8809,8408,21,223,401,0.954478374,0.045521626,0.025315019
Kentucky,UNION,15007,12654,1803,243,2353,0.843206504,0.156793496,0.016192444
Kentucky,WARREN,113792,92807,10204,5174,20985,0.815584575,0.184415425,0.045468926
Kentucky,WASHINGTON,11717,10401,736,393,1316,0.887684561,0.112315439,0.033541009
Kentucky,WAYNE,20813,19591,308,601,1222,0.941286696,0.058713304,0.028876183
Kentucky,WEBSTER,13621,12233,553,580,1388,0.898098524,0.101901476,0.042581308
Kentucky,WHITLEY,35637,34521,205,310,1116,0.968684233,0.031315767,0.008698824
Kentucky,WOLFE,7355,7241,10,41,114,0.98450034,0.01549966,0.005574439
Kentucky,WOODFORD,24939,21556,1216,1680,3383,0.864349012,0.135650988,0.067364369
Louisiana,ACADIA PARISH,61773,48555,11133,1060,13218,0.78602302,0.21397698,0.0171596
Louisiana,ALLEN PARISH,25764,18276,5957,342,7488,0.7093619,0.2906381,0.013274336
Louisiana,ASCENSION PARISH,107215,75949,23727,5024,31266,0.708380357,0.291619643,0.046859115
Louisiana,ASSUMPTION PARISH,23421,15442,7111,498,7979,0.65932283,0.34067717,0.021262969
Louisiana,AVOYELLES PARISH,42073,27877,12318,606,14196,0.662586457,0.337413543,0.014403537
Louisiana,BEAUREGARD PARISH,35654,28730,4597,1003,6924,0.805800191,0.194199809,0.028131486
Louisiana,BIENVILLE PARISH,14353,7850,6048,207,6503,0.546923988,0.453076012,0.014422072
Louisiana,BOSSIER PARISH,116979,80991,24245,7026,35988,0.692355038,0.307644962,0.060062062
Louisiana,CADDO PARISH,254969,121969,119697,6129,133000,0.478367958,0.521632042,0.024038216
Louisiana,CALCASIEU PARISH,192768,133703,47490,4945,59065,0.69359541,0.30640459,0.025652598
Louisiana,CALDWELL PARISH,10132,8045,1735,222,2087,0.79401895,0.20598105,0.021910778
Louisiana,CAMERON PARISH,6839,6465,119,154,374,0.945313642,0.054686358,0.022517912
Louisiana,CATAHOULA PARISH,10407,6946,3273,90,3461,0.66743538,0.33256462,0.008648025
Louisiana,CLAIBORNE PARISH,17195,8084,8707,171,9111,0.470136668,0.529863332,0.009944751
Louisiana,CONCORDIA PARISH,20822,11829,8503,209,8993,0.568101047,0.431898953,0.01003746
Louisiana,DE SOTO PARISH,26656,15092,10402,661,11564,0.566176471,0.433823529,0.024797419
Louisiana,EAST BATON ROUGE PARISH,440171,206664,198590,16274,233507,0.469508441,0.530491559,0.036971995
Louisiana,EAST CARROLL PARISH,7759,2198,5324,127,5561,0.283283928,0.716716072,0.016368089
Louisiana,EAST FELICIANA PARISH,20267,10666,9052,208,9601,0.526274239,0.473725761,0.010262989
Louisiana,EVANGELINE PARISH,33984,23071,9565,776,10913,0.678878296,0.321121704,0.022834275
Louisiana,FRANKLIN PARISH,20767,13853,6500,196,6914,0.667067944,0.332932056,0.009438051
Louisiana,GRANT PARISH,22309,17361,3441,931,4948,0.778206105,0.221793895,0.041732036
Louisiana,IBERIA PARISH,73240,44502,23280,2299,28738,0.607618788,0.392381212,0.031389951
Louisiana,IBERVILLE PARISH,33387,15987,16338,664,17400,0.478839069,0.521160931,0.01988798
Louisiana,JACKSON PARISH,16274,10989,4829,209,5285,0.675248863,0.324751137,0.012842571
Louisiana,JEFFERSON PARISH,432552,242268,112013,53702,190284,0.560089885,0.439910115,0.124151547
Louisiana,JEFFERSON DAVIS PARISH,31594,24835,5450,538,6759,0.786066975,0.213933025,0.01702855
Louisiana,LAFAYETTE PARISH,221578,148972,56633,8597,72606,0.672323065,0.327676935,0.038798978
Louisiana,LAFOURCHE PARISH,96318,75080,12679,3647,21238,0.779501235,0.220498765,0.037864158
Louisiana,LA SALLE PARISH,14890,12520,1758,331,2370,0.840832774,0.159167226,0.022229684
Louisiana,LINCOLN PARISH,46735,25313,18860,1189,21422,0.54162833,0.45837167,0.025441318
Louisiana,LIVINGSTON PARISH,128026,115362,6455,3801,12664,0.901082593,0.098917407,0.029689282
Louisiana,MADISON PARISH,12093,4396,7357,188,7697,0.363516084,0.636483916,0.015546184
Louisiana,MOREHOUSE PARISH,27979,14251,13078,255,13728,0.509346295,0.490653705,0.009113978
Louisiana,NATCHITOCHES PARISH,39566,21109,16296,735,18457,0.533513623,0.466486377,0.018576556
Louisiana,ORLEANS PARISH,343829,104770,204866,18051,239059,0.304715425,0.695284575,0.052499935
Louisiana,OUACHITA PARISH,153720,91573,55946,2760,62147,0.595712985,0.404287015,0.017954723
Louisiana,PLAQUEMINES PARISH,23042,15617,4675,1067,7425,0.677762347,0.322237653,0.046306744
Louisiana,POINTE COUPEE PARISH,22802,13748,8247,492,9054,0.602929568,0.397070432,0.021577055
Louisiana,RAPIDES PARISH,131613,81623,41937,3418,49990,0.620174299,0.379825701,0.025970079
Louisiana,RED RIVER PARISH,9091,5305,3586,101,3786,0.583544165,0.416455835,0.011109889
Louisiana,RICHLAND PARISH,20725,12714,7406,332,8011,0.613462002,0.386537998,0.0160193
Louisiana,SABINE PARISH,24233,16776,4009,820,7457,0.692279124,0.307720876,0.033838155
Louisiana,ST. BERNARD PARISH,35897,24607,6272,3309,11290,0.685489038,0.314510962,0.092180405
Louisiana,ST. CHARLES PARISH,52780,34925,13925,2648,17855,0.661708981,0.338291019,0.050170519
Louisiana,ST. HELENA PARISH,11203,4999,5964,99,6204,0.446219763,0.553780237,0.008836919
Louisiana,ST. JAMES PARISH,22102,10478,11145,256,11624,0.474074744,0.525925256,0.011582662
Louisiana,ST. JOHN THE BAPTIST PARISH,45924,18374,24405,2175,27550,0.40009581,0.59990419,0.047360857
Louisiana,ST. LANDRY PARISH,83384,46025,34295,1321,37359,0.551964406,0.448035594,0.015842368
Louisiana,ST. MARTIN PARISH,52160,33831,15956,1071,18329,0.64860046,0.35139954,0.020532975
Louisiana,ST. MARY PARISH,54650,31267,17648,2920,23383,0.572131747,0.427868253,0.053430924
Louisiana,ST. TAMMANY PARISH,233740,188317,26430,10970,45423,0.805668692,0.194331308,0.046932489
Louisiana,TANGIPAHOA PARISH,121097,77807,36485,4260,43290,0.642517981,0.357482019,0.035178411
Louisiana,TENSAS PARISH,5252,2178,2957,65,3074,0.414699162,0.585300838,0.012376238
Louisiana,TERREBONNE PARISH,111860,76789,21046,4421,35071,0.686474164,0.313525836,0.039522618
Louisiana,UNION PARISH,22721,15398,6153,943,7323,0.677699045,0.322300955,0.041503455
Louisiana,VERMILION PARISH,57999,46305,8246,1381,11694,0.798375834,0.201624166,0.023810755
Louisiana,VERNON PARISH,52334,37794,7280,3775,14540,0.722169144,0.277830856,0.072132839
Louisiana,WASHINGTON PARISH,47168,31019,14561,887,16149,0.657628053,0.342371947,0.018805122
Louisiana,WEBSTER PARISH,41207,26067,13756,670,15140,0.632586696,0.367413304,0.016259373
Louisiana,WEST BATON ROUGE PARISH,23788,13931,8953,544,9857,0.585631411,0.414368589,0.022868673
Louisiana,WEST CARROLL PARISH,11604,9337,1810,299,2267,0.804636332,0.195363668,0.025766977
Louisiana,WEST FELICIANA PARISH,15625,8002,7235,251,7623,0.512128,0.487872,0.016064
Louisiana,WINN PARISH,15313,10108,4666,240,5205,0.660092732,0.339907268,0.015672958
Maine,ANDROSCOGGIN,107702,98931,3858,1669,8771,0.918562329,0.081437671,0.015496462
Maine,AROOSTOOK,71870,68341,430,667,3529,0.950897454,0.049102546,0.009280646
Maine,CUMBERLAND,281674,258468,6577,5045,23206,0.917613979,0.082386021,0.017910776
Maine,FRANKLIN,30768,29731,70,315,1037,0.966296152,0.033703848,0.01023791
Maine,HANCOCK,54418,52353,206,594,2065,0.962052997,0.037947003,0.010915506
Maine,KENNEBEC,122151,116549,642,1504,5602,0.95413873,0.04586127,0.012312629
Maine,KNOX,39736,38337,192,337,1399,0.964792631,0.035207369,0.008480974
Maine,LINCOLN,34457,33437,96,287,1020,0.970397887,0.029602113,0.008329222
Maine,OXFORD,57833,55584,202,587,2249,0.961112168,0.038887832,0.010149914
Maine,PENOBSCOT,153923,145700,1117,1620,8223,0.946577185,0.053422815,0.010524743
Maine,PISCATAQUIS,17535,16893,52,169,642,0.963387511,0.036612489,0.009637867
Maine,SAGADAHOC,35293,33663,237,453,1630,0.953815204,0.046184796,0.012835406
Maine,SOMERSET,52228,50437,185,409,1791,0.965708049,0.034291951,0.007831048
Maine,WALDO,38786,37453,122,349,1333,0.965631929,0.034368071,0.008998092
Maine,WASHINGTON,32856,29998,132,452,2858,0.913014366,0.086985634,0.013757
Maine,YORK,197131,188422,1036,2478,8709,0.955821256,0.044178744,0.012570321
Maryland,ALLEGANY,75087,66195,5959,1085,8892,0.88157737,0.11842263,0.014449905
Maryland,ANNE ARUNDEL,537656,389386,81819,32902,148270,0.724228875,0.275771125,0.061195262
Maryland,BALTIMORE,805029,504556,206913,33735,300473,0.626755061,0.373244939,0.041905323
Maryland,CALVERT,88737,70680,11816,2437,18057,0.796511038,0.203488962,0.027463178
Maryland,CAROLINE,33066,25853,4520,1816,7213,0.781860521,0.218139479,0.054920462
Maryland,CARROLL,167134,152428,5229,4363,14706,0.912010722,0.087989278,0.026104802
Maryland,CECIL,101108,88348,6080,3407,12760,0.873798315,0.126201685,0.033696641
Maryland,CHARLES,146551,70905,59201,6259,75646,0.483824744,0.516175256,0.042708682
Maryland,DORCHESTER,32618,21581,8937,1130,11037,0.661628549,0.338371451,0.034643448
Maryland,FREDERICK,233385,181645,19611,17135,51740,0.778306232,0.221693768,0.073419457
Maryland,GARRETT,30097,29278,299,220,819,0.972787986,0.027212014,0.007309699
Maryland,HARFORD,244826,194004,30334,8613,50822,0.792415838,0.207584162,0.035180087
Maryland,HOWARD,287085,169972,49150,16729,117113,0.592061585,0.407938415,0.05827194
Maryland,KENT,20197,15783,3003,907,4414,0.781452691,0.218547309,0.04490766
Maryland,MONTGOMERY,971777,478765,161689,165398,493012,0.492669615,0.507330385,0.1702016
Maryland,PRINCE GEORGE'S,863420,128853,548439,128972,734567,0.149235598,0.850764402,0.149373422
Maryland,QUEEN ANNE'S,47798,41733,3258,1452,6065,0.873111846,0.126888154,0.03037784
Maryland,ST. MARY'S,105151,80402,14831,3972,24749,0.764633717,0.235366283,0.037774248
Maryland,SOMERSET,26470,13796,11082,863,12674,0.521193804,0.478806196,0.032602947
Maryland,TALBOT,37782,29829,4778,2073,7953,0.789502938,0.210497062,0.054867397
Maryland,WASHINGTON,147430,122748,13836,5104,24682,0.832584956,0.167415044,0.03461982
Maryland,WICOMICO,98733,65767,23534,4478,32966,0.666109609,0.333890391,0.045354643
Maryland,WORCESTER,51454,41331,6973,1622,10123,0.803261165,0.196738835,0.031523302
Maryland,BALTIMORE CITY,620961,174120,392938,25960,446841,0.280404083,0.719595917,0.041806168
Massachusetts,BARNSTABLE,215888,197327,3857,4687,18561,0.914024865,0.085975135,0.021710331
Massachusetts,BERKSHIRE,131219,118926,3334,4530,12293,0.906316921,0.093683079,0.03452244
Massachusetts,BRISTOL,548285,469344,15736,33020,78941,0.856021959,0.143978041,0.060224153
Massachusetts,DUKES,16535,14275,477,384,2260,0.86332023,0.13667977,0.023223465
Massachusetts,ESSEX,743159,565035,19566,122745,178124,0.760315087,0.239684913,0.165166539
Massachusetts,FRANKLIN,71372,65978,703,2250,5394,0.924424144,0.075575856,0.031524968
Massachusetts,HAMPDEN,463490,313846,35692,96776,149644,0.677136508,0.322863492,0.208798464
Massachusetts,HAMPSHIRE,158080,136249,3547,7455,21831,0.861899038,0.138100962,0.047159666
Massachusetts,MIDDLESEX,1503085,1150251,65733,98350,352834,0.765260115,0.234739885,0.065432095
Massachusetts,NANTUCKET,10172,8192,664,957,1980,0.805348014,0.194651986,0.094081793
Massachusetts,NORFOLK,670850,538758,36329,22004,132092,0.803097563,0.196902437,0.032800179
Massachusetts,PLYMOUTH,494919,415341,33991,15619,79578,0.839210053,0.160789947,0.0315587
Massachusetts,SUFFOLK,722023,346979,142980,143455,375044,0.480565024,0.519434976,0.198684806
Massachusetts,WORCESTER,798552,644299,29084,75422,154253,0.80683412,0.19316588,0.094448452
Michigan,ALCONA,10942,10621,13,124,321,0.970663498,0.029336502,0.01133248
Michigan,ALGER,9601,8213,607,114,1388,0.855431726,0.144568274,0.011873763
Michigan,ALLEGAN,111408,99945,1264,7454,11463,0.897107928,0.102892072,0.066907224
Michigan,ALPENA,29598,28623,78,304,975,0.967058585,0.032941415,0.010270964
Michigan,ANTRIM,23580,22546,35,404,1034,0.956149279,0.043850721,0.017133164
Michigan,ARENAC,15899,15231,29,225,668,0.957984779,0.042015221,0.014151833
Michigan,BARAGA,8860,6605,635,86,2255,0.745485327,0.254514673,0.009706546
Michigan,BARRY,59173,56487,205,1336,2686,0.954607676,0.045392324,0.022577865
Michigan,BAY,107771,98241,1574,5093,9530,0.911571759,0.088428241,0.047257611
Michigan,BENZIE,17525,16658,71,302,867,0.950527817,0.049472183,0.017232525
Michigan,BERRIEN,156813,119389,23766,7054,37424,0.761346317,0.238653683,0.044983515
Michigan,BRANCH,45248,41116,1380,1804,4132,0.908681047,0.091318953,0.039869165
Michigan,CALHOUN,136146,108664,14630,6177,27482,0.79814317,0.20185683,0.045370411
Michigan,CASS,52293,45704,2776,1570,6589,0.873998432,0.126001568,0.030023139
Michigan,CHARLEVOIX,25949,24602,76,359,1347,0.948090485,0.051909515,0.01383483
Michigan,CHEBOYGAN,26152,24324,129,211,1828,0.930100948,0.069899052,0.008068217
Michigan,CHIPPEWA,38520,27542,2503,480,10978,0.715005192,0.284994808,0.012461059
Michigan,CLARE,30926,29612,145,464,1314,0.957511479,0.042488521,0.015003557
Michigan,CLINTON,75382,68243,1506,2947,7139,0.905295694,0.094704306,0.039094213
Michigan,CRAWFORD,14074,13586,42,182,488,0.965326133,0.034673867,0.012931647
Michigan,DELTA,37069,34920,71,318,2149,0.942027031,0.057972969,0.008578597
Michigan,DICKINSON,26168,25269,86,270,899,0.965645063,0.034354937,0.010317946
Michigan,EATON,107759,91540,6661,5101,16219,0.84948821,0.15051179,0.047337113
Michigan,EMMET,32694,30132,152,429,2562,0.921636998,0.078363002,0.013121674
Michigan,GENESEE,425790,309683,87352,12983,116107,0.727313934,0.272686066,0.030491557
Michigan,GLADWIN,25692,24904,60,310,788,0.969328974,0.030671026,0.012066013
Michigan,GOGEBIC,16427,14965,676,142,1462,0.911000183,0.088999817,0.008644305
Michigan,GRAND TRAVERSE,86986,81188,1023,1874,5798,0.933345596,0.066654404,0.021543697
Michigan,GRATIOT,42476,37144,2341,2301,5332,0.874470289,0.125529711,0.054171768
Michigan,HILLSDALE,46688,44765,206,826,1923,0.958811686,0.041188314,0.017691912
Michigan,HOUGHTON,36628,34299,193,415,2329,0.936414765,0.063585235,0.01133013
Michigan,HURON,33118,31830,121,657,1288,0.961108763,0.038891237,0.019838154
Michigan,INGHAM,280895,203459,31931,20526,77436,0.724324036,0.275675964,0.073073568
Michigan,IONIA,63905,56962,2962,2791,6943,0.891354354,0.108645646,0.043674204
Michigan,IOSCO,25887,24710,121,403,1177,0.954533163,0.045466837,0.015567659
Michigan,IRON,11817,11370,14,161,447,0.96217314,0.03782686,0.013624439
Michigan,ISABELLA,70311,61514,1643,2197,8797,0.874884442,0.125115558,0.031246889
Michigan,JACKSON,160248,137588,12560,4837,22660,0.858594179,0.141405821,0.030184464
Michigan,KALAMAZOO,250331,200047,26677,9959,50284,0.799129952,0.200870048,0.039783327
Michigan,KALKASKA,17153,16456,50,214,697,0.959365709,0.040634291,0.012475952
Michigan,KENT,602622,457769,56372,58437,144853,0.759628756,0.240371244,0.096971236
Michigan,KEWEENAW,2156,2117,3,15,39,0.981910946,0.018089054,0.006957328
Michigan,LAKE,11539,9897,1034,243,1642,0.857699974,0.142300026,0.021059017
Michigan,LAPEER,88319,82147,896,3622,6172,0.930116962,0.069883038,0.041010428
Michigan,LEELANAU,21708,19799,56,794,1909,0.91206007,0.08793993,0.036576377
Michigan,LENAWEE,99892,87483,2397,7614,12409,0.875775838,0.124224162,0.07622232
Michigan,LIVINGSTON,180967,172513,776,3460,8454,0.9532843,0.0467157,0.019119508
Michigan,LUCE,6631,5275,735,82,1356,0.795505957,0.204494043,0.012366159
Michigan,MACKINAC,11113,8411,57,126,2702,0.756861334,0.243138666,0.011338073
Michigan,MACOMB,840978,705693,72053,19095,135285,0.839133723,0.160866277,0.022705707
Michigan,MANISTEE,24733,22402,718,634,2331,0.905753447,0.094246553,0.025633769
Michigan,MARQUETTE,67077,62412,1126,767,4665,0.930453061,0.069546939,0.01143462
Michigan,MASON,28705,26595,156,1150,2110,0.926493642,0.073506358,0.040062707
Michigan,MECOSTA,42798,39633,1055,731,3165,0.926047946,0.073952054,0.017080237
Michigan,MENOMINEE,24029,22715,68,278,1314,0.945316076,0.054683924,0.011569354
Michigan,MIDLAND,83629,77846,983,1704,5783,0.930849347,0.069150653,0.020375707
Michigan,MISSAUKEE,14849,14230,42,306,619,0.958313691,0.041686309,0.020607448
Michigan,MONROE,152021,140609,3144,4667,11412,0.924931424,0.075068576,0.030699706
Michigan,MONTCALM,63342,58635,1476,1932,4707,0.925689116,0.074310884,0.030501089
Michigan,MONTMORENCY,9765,9465,15,96,300,0.969278034,0.030721966,0.009831029
Michigan,MUSKEGON,172188,133132,24599,8261,39056,0.773178154,0.226821846,0.04797663
Michigan,NEWAYGO,48460,44119,474,2663,4341,0.910420966,0.089579034,0.054952538
Michigan,OAKLAND,1202362,903398,162303,41920,298964,0.751352754,0.248647246,0.034864708
Michigan,OCEANA,26570,22227,100,3629,4343,0.836544976,0.163455024,0.136582612
Michigan,OGEMAW,21699,20865,37,309,834,0.961565049,0.038434951,0.014240288
Michigan,ONTONAGON,6780,6546,6,64,234,0.965486726,0.034513274,0.009439528
Michigan,OSCEOLA,23528,22531,125,344,997,0.957624957,0.042375043,0.014620877
Michigan,OSCODA,8640,8380,14,79,260,0.969907407,0.030092593,0.009143519
Michigan,OTSEGO,24164,23186,78,299,978,0.959526568,0.040473432,0.012373779
Michigan,OTTAWA,263801,226156,3551,22761,37645,0.857297736,0.142702264,0.086280947
Michigan,PRESQUE ISLE,13376,12972,56,116,404,0.969796651,0.030203349,0.008672249
Michigan,ROSCOMMON,24449,23592,89,275,857,0.964947442,0.035052558,0.011247904
Michigan,SAGINAW,200169,141187,37222,15573,58982,0.705338989,0.294661011,0.07779926
Michigan,ST. CLAIR,163040,150213,3860,4708,12827,0.921326055,0.078673945,0.028876349
Michigan,ST. JOSEPH,61295,53930,1555,4034,7365,0.87984338,0.12015662,0.065812872
Michigan,SANILAC,43114,40852,142,1439,2262,0.947534444,0.052465556,0.033376629
Michigan,SCHOOLCRAFT,8485,7394,11,64,1091,0.871420153,0.128579847,0.007542722
Michigan,SHIAWASSEE,70648,67240,305,1695,3408,0.951760842,0.048239158,0.023992187
Michigan,TUSCOLA,55729,52547,621,1571,3182,0.942902259,0.057097741,0.028189991
Michigan,VAN BUREN,76258,63028,3007,7758,13230,0.826510006,0.173489994,0.101733589
Michigan,WASHTENAW,344791,248675,43152,13860,96116,0.721234023,0.278765977,0.040198265
Michigan,WAYNE,1820584,902180,732801,95260,918404,0.495544287,0.504455713,0.05232387
Michigan,WEXFORD,32735,31246,122,519,1489,0.954513518,0.045486482,0.01585459
Minnesota,AITKIN,16202,15398,53,151,804,0.950376497,0.049623503,0.009319837
Minnesota,ANOKA,330844,281929,14282,12020,48915,0.852150863,0.147849137,0.036331322
Minnesota,BECKER,32504,28539,128,398,3965,0.878015014,0.121984986,0.012244647
Minnesota,BELTRAMI,44442,33066,251,676,11376,0.744025921,0.255974079,0.015210837
Minnesota,BENTON,38451,35939,738,632,2512,0.9346701,0.0653299,0.016436504
Minnesota,BIG STONE,5269,5150,10,41,119,0.977415069,0.022584931,0.007781363
Minnesota,BLUE EARTH,64013,58394,1717,1586,5619,0.912220955,0.087779045,0.024776217
Minnesota,BROWN,25893,24662,56,860,1231,0.952458193,0.047541807,0.03321361
Minnesota,CARLTON,35386,31458,494,484,3928,0.888995648,0.111004352,0.013677726
Minnesota,CARVER,91042,82536,1068,3515,8506,0.906570594,0.093429406,0.038608554
Minnesota,CASS,28567,24383,59,340,4184,0.853537298,0.146462702,0.011901845
Minnesota,CHIPPEWA,12441,11370,65,611,1071,0.913913673,0.086086327,0.049111808
Minnesota,CHISAGO,53887,51013,636,835,2874,0.946666172,0.053333828,0.015495388
Minnesota,CLAY,58999,53434,825,2056,5565,0.905676367,0.094323633,0.034848048
Minnesota,CLEARWATER,8695,7537,30,120,1158,0.866820012,0.133179988,0.013801035
Minnesota,COOK,5176,4528,15,58,648,0.874806801,0.125193199,0.011205564
Minnesota,COTTONWOOD,11687,10432,82,720,1255,0.892615727,0.107384273,0.061606914
Minnesota,CROW WING,62500,59979,297,652,2521,0.959664,0.040336,0.010432
Minnesota,DAKOTA,398552,327962,18235,23966,70590,0.822883839,0.177116161,0.06013268
Minnesota,DODGE,20087,18780,59,915,1307,0.934933041,0.065066959,0.045551849
Minnesota,DOUGLAS,36009,34974,146,341,1035,0.971257186,0.028742814,0.009469855
Minnesota,FARIBAULT,14553,13519,43,817,1034,0.928949358,0.071050642,0.056139628
Minnesota,FILLMORE,20866,20375,48,207,491,0.976468897,0.023531103,0.009920445
Minnesota,FREEBORN,31255,27701,200,2750,3554,0.886290194,0.113709806,0.087985922
Minnesota,GOODHUE,46183,43027,429,1342,3156,0.931663166,0.068336834,0.029058311
Minnesota,GRANT,6018,5832,19,94,186,0.969092722,0.030907278,0.015619807
Minnesota,HENNEPIN,1152425,826670,134240,77676,325755,0.717330846,0.282669154,0.067402217
Minnesota,HOUSTON,19027,18482,98,132,545,0.971356493,0.028643507,0.00693751
Minnesota,HUBBARD,20428,19122,47,327,1306,0.936068142,0.063931858,0.016007441
Minnesota,ISANTI,37816,35958,228,582,1858,0.950867358,0.049132642,0.015390311
Minnesota,ITASCA,45058,41951,136,417,3107,0.931044432,0.068955568,0.009254738
Minnesota,JACKSON,10266,9701,47,277,565,0.944963959,0.055036041,0.026982272
Minnesota,KANABEC,16239,15606,52,214,633,0.961019767,0.038980233,0.013178151
Minnesota,KANDIYOHI,42239,35964,952,4710,6275,0.851440612,0.148559388,0.111508322
Minnesota,KITTSON,4552,4434,11,69,118,0.974077329,0.025922671,0.015158172
Minnesota,KOOCHICHING,13311,12512,76,147,799,0.939974457,0.060025543,0.011043498
Minnesota,LAC QUI PARLE,7259,7040,17,108,219,0.969830555,0.030169445,0.014878082
Minnesota,LAKE,10866,10558,16,80,308,0.971654703,0.028345297,0.007362415
Minnesota,LAKE OF THE WOODS,4045,3863,13,35,182,0.95500618,0.04499382,0.008652658
Minnesota,LE SUEUR,27703,25691,88,1444,2012,0.927372487,0.072627513,0.052124319
Minnesota,LINCOLN,5896,5749,8,72,147,0.975067843,0.024932157,0.012211669
Minnesota,LYON,25857,22637,575,1541,3220,0.875468925,0.124531075,0.059597014
Minnesota,MCLEOD,36651,34005,184,1811,2646,0.927805517,0.072194483,0.049412022
Minnesota,MAHNOMEN,5413,2698,11,99,2715,0.498429706,0.501570294,0.018289304
Minnesota,MARSHALL,9439,8952,25,337,487,0.948405551,0.051594449,0.035702935
Minnesota,MARTIN,20840,19766,62,744,1074,0.948464491,0.051535509,0.035700576
Minnesota,MEEKER,23300,22233,68,767,1067,0.954206009,0.045793991,0.032918455
Minnesota,MILLE LACS,26097,23582,96,377,2515,0.90362877,0.09637123,0.014446105
Minnesota,MORRISON,33198,32174,122,402,1024,0.969154768,0.030845232,0.012109163
Minnesota,MOWER,39163,32975,791,4138,6188,0.841993719,0.158006281,0.105660955
Minnesota,MURRAY,8725,8326,20,242,399,0.954269341,0.045730659,0.02773639
Minnesota,NICOLLET,32727,29944,658,1226,2783,0.91496318,0.08503682,0.037461423
Minnesota,NOBLES,21378,14365,727,4820,7013,0.671952475,0.328047525,0.225465432
Minnesota,NORMAN,6852,6293,11,276,559,0.91841798,0.08158202,0.04028021
Minnesota,OLMSTED,144248,120348,6751,6081,23900,0.834313127,0.165686873,0.042156564
Minnesota,OTTER TAIL,57303,54244,422,1490,3059,0.946617106,0.053382894,0.026002129
Minnesota,PENNINGTON,13930,12867,181,380,1063,0.923689878,0.076310122,0.027279253
Minnesota,PINE,29750,26924,576,723,2826,0.905008403,0.094991597,0.024302521
Minnesota,PIPESTONE,9596,8880,52,355,716,0.925385577,0.074614423,0.036994581
Minnesota,POLK,31600,28497,248,1720,3103,0.901803797,0.098196203,0.05443038
Minnesota,POPE,10995,10720,35,95,275,0.974988631,0.025011369,0.008640291
Minnesota,RAMSEY,508640,340194,54835,36483,168446,0.668830607,0.331169393,0.071726565
Minnesota,RED LAKE,4089,3876,7,101,213,0.947909024,0.052090976,0.024700416
Minnesota,REDWOOD,16059,14119,71,335,1940,0.879195467,0.120804533,0.020860577
Minnesota,RENVILLE,15730,14351,40,1046,1379,0.912333121,0.087666879,0.066497139
Minnesota,RICE,64142,54566,2021,5122,9576,0.850706246,0.149293754,0.079854074
Minnesota,ROCK,9687,9239,58,197,448,0.953752452,0.046247548,0.020336533
Minnesota,ROSEAU,15629,14696,37,116,933,0.940303282,0.059696718,0.0074221
Minnesota,ST. LOUIS,200226,184769,2688,2409,15457,0.922802233,0.077197767,0.012031405
Minnesota,SCOTT,129928,109816,3298,5771,20112,0.845206576,0.154793424,0.044416908
Minnesota,SHERBURNE,88499,81983,1644,1941,6516,0.926372049,0.073627951,0.021932451
Minnesota,SIBLEY,15226,13835,41,1098,1391,0.90864311,0.09135689,0.07211349
Minnesota,STEARNS,150642,136414,4595,4190,14228,0.905550909,0.094449091,0.027814288
Minnesota,STEELE,36576,32544,1003,2282,4032,0.88976378,0.11023622,0.062390639
Minnesota,STEVENS,9726,8931,75,337,795,0.918260333,0.081739667,0.034649393
Minnesota,SWIFT,9783,9271,48,350,512,0.947664316,0.052335684,0.035776347
Minnesota,TODD,24895,23052,73,1288,1843,0.92596907,0.07403093,0.051737297
Minnesota,TRAVERSE,3558,3324,12,50,234,0.934232715,0.065767285,0.014052839
Minnesota,WABASHA,21676,20712,80,592,964,0.95552685,0.04447315,0.027311312
Minnesota,WADENA,13843,13262,109,176,581,0.958029329,0.041970671,0.012714007
Minnesota,WASECA,19136,17308,371,985,1828,0.904473244,0.095526756,0.051473662
Minnesota,WASHINGTON,238136,204111,8376,8127,34025,0.857119461,0.142880539,0.034127557
Minnesota,WATONWAN,11211,8632,74,2338,2579,0.769958077,0.230041923,0.208545179
Minnesota,WILKIN,6576,6294,13,130,282,0.957116788,0.042883212,0.019768856
Minnesota,WINONA,51461,47828,642,1244,3633,0.929402849,0.070597151,0.024173646
Minnesota,WRIGHT,124700,116786,1286,3052,7914,0.936535686,0.063464314,0.024474739
Minnesota,YELLOW MEDICINE,10438,9581,15,397,857,0.917896149,0.082103851,0.038034106
Mississippi,ADAMS,32297,12485,17150,2150,19812,0.386568412,0.613431588,0.06656965
Mississippi,ALCORN,37057,31313,4209,1010,5744,0.844995547,0.155004453,0.027255309
Mississippi,AMITE,13131,7516,5396,110,5615,0.572385957,0.427614043,0.008377123
Mississippi,ATTALA,19564,10866,8180,323,8698,0.555407892,0.444592108,0.016509916
Mississippi,BENTON,8729,5229,3244,148,3500,0.59903769,0.40096231,0.016954978
Mississippi,BOLIVAR,34145,11241,21839,639,22904,0.329213648,0.670786352,0.018714307
Mississippi,CALHOUN,14962,9851,4128,805,5111,0.658401283,0.341598717,0.053802968
Mississippi,CARROLL,10597,6927,3444,106,3670,0.653675569,0.346324431,0.010002831
Mississippi,CHICKASAW,17392,9254,7292,643,8138,0.532083717,0.467916283,0.036971021
Mississippi,CHOCTAW,8547,5803,2571,76,2744,0.678951679,0.321048321,0.008892009
Mississippi,CLAIBORNE,9604,1353,8072,74,8251,0.1408788,0.8591212,0.007705123
Mississippi,CLARKE,16732,10674,5749,132,6058,0.637939278,0.362060722,0.007889075
Mississippi,CLAY,20634,8276,11977,199,12358,0.401085587,0.598914413,0.009644276
Mississippi,COAHOMA,26151,5918,19698,293,20233,0.226301097,0.773698903,0.01120416
Mississippi,COPIAH,29449,13399,14924,773,16050,0.454989983,0.545010017,0.026248769
Mississippi,COVINGTON,19568,12202,6798,369,7366,0.623569092,0.376430908,0.018857318
Mississippi,DESOTO,161252,113553,35124,8086,47699,0.704195917,0.295804083,0.050145114
Mississippi,FORREST,74934,43766,26956,2637,31168,0.58406064,0.41593936,0.035190968
Mississippi,FRANKLIN,8118,5230,2776,47,2888,0.644247352,0.355752648,0.005789603
Mississippi,GEORGE,22578,20009,1821,453,2569,0.886216671,0.113783329,0.020063779
Mississippi,GREENE,14400,10363,3735,133,4037,0.719652778,0.280347222,0.009236111
Mississippi,GRENADA,21906,12350,9106,197,9556,0.563772482,0.436227518,0.00899297
Mississippi,HANCOCK,43929,37914,3075,1446,6015,0.863074507,0.136925493,0.032916752
Mississippi,HARRISON,187105,125741,40975,9937,61364,0.672034419,0.327965581,0.053109217
Mississippi,HINDS,245285,68609,168839,3630,176676,0.279711356,0.720288644,0.014799111
Mississippi,HOLMES,19198,2993,15925,134,16205,0.155901656,0.844098344,0.006979894
Mississippi,HUMPHREYS,9375,2133,6949,202,7242,0.22752,0.77248,0.021546667
Mississippi,ISSAQUENA,1406,482,905,8,924,0.342816501,0.657183499,0.0056899
Mississippi,ITAWAMBA,23401,21490,1386,300,1911,0.918336823,0.081663177,0.012819965
Mississippi,JACKSON,139668,97670,29768,6378,41998,0.6993012,0.3006988,0.045665435
Mississippi,JASPER,17062,7855,8944,136,9207,0.460379791,0.539620209,0.00797093
Mississippi,JEFFERSON,7726,1056,6601,28,6670,0.136681336,0.863318664,0.003624126
Mississippi,JEFFERSON DAVIS,12487,4802,7461,101,7685,0.384559942,0.615440058,0.008088412
Mississippi,JONES,67761,44432,19076,3199,23329,0.655716415,0.344283585,0.047210047
Mississippi,KEMPER,10456,3665,6273,52,6791,0.35051645,0.64948355,0.004973221
Mississippi,LAFAYETTE,47351,33538,11155,1073,13813,0.708284936,0.291715064,0.022660556
Mississippi,LAMAR,55658,42296,10834,1205,13362,0.759926695,0.240073305,0.021650077
Mississippi,LAUDERDALE,80261,43312,34158,1448,36949,0.539639426,0.460360574,0.018041141
Mississippi,LAWRENCE,12929,8567,3961,274,4362,0.662618919,0.337381081,0.021192668
Mississippi,LEAKE,23805,11611,9620,1020,12194,0.487754673,0.512245327,0.042848141
Mississippi,LEE,82910,56854,22498,1991,26056,0.685731516,0.314268484,0.024013991
Mississippi,LEFLORE,32317,7930,23246,743,24387,0.245381688,0.754618312,0.022990995
Mississippi,LINCOLN,34869,23702,10400,330,11167,0.679744185,0.320255815,0.009463994
Mississippi,LOWNDES,59779,31847,25904,914,27932,0.532745613,0.467254387,0.01528965
Mississippi,MADISON,95203,53287,36227,2806,41916,0.559719757,0.440280243,0.029473861
Mississippi,MARION,27088,17661,8729,336,9427,0.651986119,0.348013881,0.012404017
Mississippi,MARSHALL,37144,18161,17369,1192,18983,0.488934956,0.511065044,0.03209132
Mississippi,MONROE,36989,24847,11381,355,12142,0.671740247,0.328259753,0.009597448
Mississippi,MONTGOMERY,10925,5769,4948,97,5156,0.52805492,0.47194508,0.008878719
Mississippi,NESHOBA,29676,17797,6169,469,11879,0.599710204,0.400289796,0.015804017
Mississippi,NEWTON,21720,13599,6536,287,8121,0.626104972,0.373895028,0.013213628
Mississippi,NOXUBEE,11545,3113,8249,92,8432,0.269640537,0.730359463,0.007968818
Mississippi,OKTIBBEHA,47671,27825,17356,683,19846,0.583688196,0.416311804,0.014327369
Mississippi,PANOLA,34707,16981,16801,494,17726,0.489267295,0.510732705,0.01423344
Mississippi,PEARL RIVER,55834,45911,6853,1636,9923,0.822276749,0.177723251,0.029301143
Mississippi,PERRY,12250,9514,2449,119,2736,0.776653061,0.223346939,0.009714286
Mississippi,PIKE,40404,18564,20740,489,21840,0.459459459,0.540540541,0.012102762
Mississippi,PONTOTOC,29957,23531,4096,1849,6426,0.785492539,0.214507461,0.061721801
Mississippi,PRENTISS,25276,21172,3481,307,4104,0.837632537,0.162367463,0.012145909
Mississippi,QUITMAN,8223,2369,5709,55,5854,0.288094369,0.711905631,0.006688556
Mississippi,RANKIN,141617,108086,26519,3795,33531,0.763227579,0.236772421,0.02679763
Mississippi,SCOTT,28264,14353,10502,3013,13911,0.507819134,0.492180866,0.106602038
Mississippi,SHARKEY,4916,1366,3475,39,3550,0.277868186,0.722131814,0.007933279
Mississippi,SIMPSON,27503,17131,9624,387,10372,0.622877504,0.377122496,0.014071192
Mississippi,SMITH,16491,12421,3758,198,4070,0.753198714,0.246801286,0.012006549
Mississippi,STONE,17786,13820,3395,239,3966,0.77701563,0.22298437,0.013437535
Mississippi,SUNFLOWER,29450,7410,21362,404,22040,0.251612903,0.748387097,0.013718166
Mississippi,TALLAHATCHIE,15378,5580,8634,866,9798,0.362856028,0.637143972,0.056314215
Mississippi,TATE,28886,19091,8723,639,9795,0.660908399,0.339091601,0.022121443
Mississippi,TIPPAH,22232,17404,3509,985,4828,0.782835552,0.217164448,0.044305506
Mississippi,TISHOMINGO,19593,18326,516,553,1267,0.935334048,0.064665952,0.028224366
Mississippi,TUNICA,10778,2486,7894,245,8292,0.230655038,0.769344962,0.02273149
Mississippi,UNION,27134,21649,3911,1210,5485,0.79785509,0.20214491,0.044593499
Mississippi,WALTHALL,15443,8145,6837,238,7298,0.527423428,0.472576572,0.015411513
Mississippi,WARREN,48773,24143,22836,896,24630,0.495007484,0.504992516,0.01837082
Mississippi,WASHINGTON,51137,13654,36348,529,37483,0.267008233,0.732991767,0.01034476
Mississippi,WAYNE,20747,12243,8035,246,8504,0.590109413,0.409890587,0.011857136
Mississippi,WEBSTER,10253,8007,2036,104,2246,0.780942163,0.219057837,0.010143373
Mississippi,WILKINSON,9878,2820,6969,41,7058,0.285482891,0.714517109,0.004150638
Mississippi,WINSTON,19198,9891,8729,184,9307,0.515209918,0.484790082,0.009584332
Mississippi,YALOBUSHA,12678,7606,4772,151,5072,0.599936899,0.400063101,0.011910396
Mississippi,YAZOO,28065,10477,15893,1301,17588,0.373311954,0.626688046,0.046356672
Missouri,ADAIR,25607,23751,392,523,1856,0.927519819,0.072480181,0.020424103
Missouri,ANDREW,17291,16641,70,290,650,0.962408189,0.037591811,0.016771731
Missouri,ATCHISON,5685,5556,17,55,129,0.977308707,0.022691293,0.009674582
Missouri,AUDRAIN,25529,22613,1637,665,2916,0.88577696,0.11422304,0.026048807
Missouri,BARRY,35597,31505,87,2745,4092,0.885046493,0.114953507,0.07711324
Missouri,BARTON,12402,11704,42,231,698,0.943718755,0.056281245,0.018626028
Missouri,BATES,17049,16296,143,275,753,0.955833187,0.044166813,0.016129978
Missouri,BENTON,19056,18311,56,291,745,0.960904702,0.039095298,0.015270781
Missouri,BOLLINGER,12363,12037,32,98,326,0.973630996,0.026369004,0.007926879
Missouri,BOONE,162642,131677,14943,4895,30965,0.809612523,0.190387477,0.030096777
Missouri,BUCHANAN,89201,76937,4572,4674,12264,0.862512752,0.137487248,0.052398516
Missouri,BUTLER,42794,38504,2235,666,4290,0.899752302,0.100247698,0.015562929
Missouri,CALDWELL,9424,9035,39,143,389,0.958722411,0.041277589,0.015174024
Missouri,CALLAWAY,44332,40350,2006,707,3982,0.91017775,0.08982225,0.015947848
Missouri,CAMDEN,44002,41913,170,1014,2089,0.952524885,0.047475115,0.023044407
Missouri,CAPE GIRARDEAU,75674,66532,5290,1476,9142,0.879192325,0.120807675,0.019504718
Missouri,CARROLL,9295,8893,149,118,402,0.956750941,0.043249059,0.012694997
Missouri,CARTER,6265,5992,5,104,273,0.956424581,0.043575419,0.01660016
Missouri,CASS,99478,89079,3444,3988,10399,0.895464324,0.104535676,0.040089266
Missouri,CEDAR,13982,13432,14,204,550,0.96066371,0.03933629,0.014590187
Missouri,CHARITON,7831,7544,155,40,287,0.963350785,0.036649215,0.005107904
Missouri,CHRISTIAN,77422,72982,433,1898,4440,0.942651959,0.057348041,0.024514996
Missouri,CLARK,7139,6978,19,42,161,0.977447822,0.022552178,0.005883177
Missouri,CLAY,221939,186611,11220,13101,35328,0.840821127,0.159178873,0.059029733
Missouri,CLINTON,20743,19606,284,322,1137,0.945186328,0.054813672,0.015523309
Missouri,COLE,75990,63247,8421,1795,12743,0.832306882,0.167693118,0.023621529
Missouri,COOPER,17601,15754,1201,232,1847,0.895062781,0.104937219,0.013181069
Missouri,CRAWFORD,24696,23804,64,365,892,0.96388079,0.03611921,0.014779721
Missouri,DADE,7883,7476,29,121,407,0.94836991,0.05163009,0.015349486
Missouri,DALLAS,16777,16037,29,260,740,0.955891995,0.044108005,0.015497407
Missouri,DAVIESS,8433,8211,23,87,222,0.973674849,0.026325151,0.010316613
Missouri,DEKALB,12892,11045,1454,219,1847,0.856732858,0.143267142,0.016987279
Missouri,DENT,15657,15021,55,148,636,0.959379191,0.040620809,0.009452641
Missouri,DOUGLAS,13684,13218,28,110,466,0.96594563,0.03405437,0.008038585
Missouri,DUNKLIN,31953,26498,3081,1727,5455,0.829280506,0.170719494,0.054048133
Missouri,FRANKLIN,101492,97390,847,1397,4102,0.959583021,0.040416979,0.013764632
Missouri,GASCONADE,15222,14801,26,152,421,0.972342662,0.027657338,0.009985547
Missouri,GENTRY,6738,6604,20,36,134,0.980112793,0.019887207,0.005342832
Missouri,GREENE,275174,246378,7738,8207,28796,0.895353485,0.104646515,0.029824765
Missouri,GRUNDY,10261,9854,58,178,407,0.96033525,0.03966475,0.017347237
Missouri,HARRISON,8957,8659,28,141,298,0.966729932,0.033270068,0.015741878
Missouri,HENRY,22272,21230,219,369,1042,0.953214799,0.046785201,0.016567888
Missouri,HICKORY,9627,9278,24,91,349,0.963747793,0.036252207,0.009452581
Missouri,HOLT,4912,4775,7,39,137,0.972109121,0.027890879,0.007939739
Missouri,HOWARD,10144,9240,527,122,904,0.910883281,0.089116719,0.012026814
Missouri,HOWELL,40400,38499,154,697,1901,0.952945545,0.047054455,0.017252475
Missouri,IRON,10630,10162,131,133,468,0.955973659,0.044026341,0.012511759
Missouri,JACKSON,674158,426574,159442,56434,247584,0.632750779,0.367249221,0.083710347
Missouri,JASPER,117404,101019,2166,8027,16385,0.860439167,0.139560833,0.068370754
Missouri,JEFFERSON,218733,208742,1776,3408,9991,0.954323307,0.045676693,0.015580639
Missouri,JOHNSON,52595,46367,2227,1611,6228,0.881585702,0.118414298,0.030630288
Missouri,KNOX,4131,4027,14,34,104,0.974824498,0.025175502,0.008230453
Missouri,LACLEDE,35571,33596,237,719,1975,0.944477243,0.055522757,0.020213095
Missouri,LAFAYETTE,33381,31002,726,740,2379,0.928731913,0.071268087,0.022168299
Missouri,LAWRENCE,38634,35140,83,2444,3494,0.909561526,0.090438474,0.063260341
Missouri,LEWIS,10211,9546,321,159,665,0.934874155,0.065125845,0.015571443
Missouri,LINCOLN,52566,49364,963,1032,3202,0.939086101,0.060913899,0.019632462
Missouri,LINN,12761,12297,85,193,464,0.963639213,0.036360787,0.015124207
Missouri,LIVINGSTON,15195,14386,365,181,809,0.946758802,0.053241198,0.011911813
Missouri,MCDONALD,23083,18700,127,2587,4383,0.810120002,0.189879998,0.112073821
Missouri,MACON,15566,14735,349,150,831,0.946614416,0.053385584,0.009636387
Missouri,MADISON,12226,11781,32,244,445,0.963602159,0.036397841,0.019957468
Missouri,MARIES,9176,8912,24,75,264,0.971229294,0.028770706,0.008173496
Missouri,MARION,28781,26202,1400,391,2579,0.910392273,0.089607727,0.013585351
Missouri,MERCER,3785,3683,6,28,102,0.973051519,0.026948481,0.007397622
Missouri,MILLER,24748,23762,95,343,986,0.960158397,0.039841603,0.013859706
Missouri,MISSISSIPPI,14358,10521,3423,231,3837,0.732762223,0.267237777,0.016088592
Missouri,MONITEAU,15607,14160,580,586,1447,0.907285193,0.092714807,0.037547254
Missouri,MONROE,8840,8340,263,85,500,0.943438914,0.056561086,0.009615385
Missouri,MONTGOMERY,12236,11642,199,172,594,0.951454724,0.048545276,0.014056881
Missouri,MORGAN,20565,19573,123,365,992,0.951762704,0.048237296,0.017748602
Missouri,NEW MADRID,18956,15380,2983,214,3576,0.811352606,0.188647394,0.011289302
Missouri,NEWTON,58114,50967,429,2537,7147,0.877017586,0.122982414,0.043655574
Missouri,NODAWAY,23370,21881,563,302,1489,0.936285837,0.063714163,0.01292255
Missouri,OREGON,10881,10407,15,131,474,0.956437827,0.043562173,0.012039335
Missouri,OSAGE,13878,13654,28,84,224,0.983859346,0.016140654,0.006052745
Missouri,OZARK,9723,9387,11,128,336,0.965442765,0.034557235,0.013164661
Missouri,PEMISCOT,18296,12741,4879,341,5555,0.696381723,0.303618277,0.018637954
Missouri,PERRY,18971,18299,70,318,672,0.964577513,0.035422487,0.016762427
Missouri,PETTIS,42201,36701,1244,3046,5500,0.869671335,0.130328665,0.072178384
Missouri,PHELPS,45156,40792,977,923,4364,0.90335725,0.09664275,0.020440252
Missouri,PIKE,18516,16519,1327,331,1997,0.892147332,0.107852668,0.017876431
Missouri,PLATTE,89322,75135,5147,4424,14187,0.841170148,0.158829852,0.049528672
Missouri,POLK,31137,29565,226,615,1572,0.949513441,0.050486559,0.019751421
Missouri,PULASKI,52274,37863,5680,4705,14411,0.724318017,0.275681983,0.090006504
Missouri,PUTNAM,4979,4865,9,36,114,0.977103836,0.022896164,0.007230368
Missouri,RALLS,10167,9828,107,98,339,0.966656831,0.033343169,0.009639028
Missouri,RANDOLPH,25414,22865,1477,413,2549,0.899700952,0.100299048,0.016250885
Missouri,RAY,23494,22338,265,415,1156,0.950795948,0.049204052,0.017664084
Missouri,REYNOLDS,6696,6433,45,64,263,0.96072282,0.03927718,0.009557945
Missouri,RIPLEY,14100,13563,49,142,537,0.961914894,0.038085106,0.010070922
Missouri,ST. CHARLES,360485,321078,14827,9983,39407,0.890683385,0.109316615,0.027693247
Missouri,ST. CLAIR,9805,9366,47,170,439,0.955226925,0.044773075,0.017338093
Missouri,STE. GENEVIEVE,18145,17607,117,149,538,0.970349959,0.029650041,0.008211629
Missouri,ST. FRANCOIS,65359,60631,2759,778,4728,0.927661072,0.072338928,0.011903487
Missouri,ST. LOUIS,998954,687984,231801,25024,310970,0.688704385,0.311295615,0.025050203
Missouri,SALINE,23370,19441,1217,1925,3929,0.831878477,0.168121523,0.082370561
Missouri,SCHUYLER,4431,4353,1,29,78,0.98239675,0.01760325,0.006544798
Missouri,SCOTLAND,4843,4760,3,33,83,0.982861862,0.017138138,0.006813958
Missouri,SCOTT,39191,33257,4436,705,5934,0.848587686,0.151412314,0.017988824
Missouri,SHANNON,8441,8014,16,139,427,0.949413577,0.050586423,0.016467243
Missouri,SHELBY,6373,6202,32,71,171,0.973168053,0.026831947,0.01114075
Missouri,STODDARD,29968,28931,274,356,1037,0.965396423,0.034603577,0.011879338
Missouri,STONE,32202,30938,46,553,1264,0.96074778,0.03925222,0.017172846
Missouri,SULLIVAN,6714,5350,30,1248,1364,0.796842419,0.203157581,0.18588025
Missouri,TANEY,51675,47083,405,2494,4592,0.911136913,0.088863087,0.048263183
Missouri,TEXAS,26008,24010,871,425,1998,0.923177484,0.076822516,0.016341126
Missouri,VERNON,21159,20197,100,336,962,0.954534713,0.045465287,0.015879767
Missouri,WARREN,32513,30201,598,957,2312,0.928889982,0.071110018,0.02943438
Missouri,WASHINGTON,25195,23969,554,255,1226,0.951339551,0.048660449,0.010121056
Missouri,WAYNE,13521,13053,33,140,468,0.965387176,0.034612824,0.010354264
Missouri,WEBSTER,36202,34469,320,612,1733,0.952129717,0.047870283,0.016905143
Missouri,WORTH,2171,2115,11,23,56,0.974205435,0.025794565,0.010594196
Missouri,WRIGHT,18815,18123,87,238,692,0.963220834,0.036779166,0.012649482
Missouri,ST. LOUIS CITY,319294,134702,156389,11130,184592,0.421874511,0.578125489,0.034858156
Montana,BEAVERHEAD,9246,8567,19,338,679,0.926562838,0.073437162,0.036556349
Montana,BIG HORN,12865,3908,30,510,8957,0.303769918,0.696230082,0.039642441
Montana,BLAINE,6491,3107,7,115,3384,0.478662764,0.521337236,0.017716839
Montana,BROADWATER,5612,5310,15,126,302,0.946186743,0.053813257,0.022451889
Montana,CARBON,10078,9668,30,188,410,0.959317325,0.040682675,0.018654495
Montana,CARTER,1160,1132,1,8,28,0.975862069,0.024137931,0.006896552
Montana,CASCADE,81327,71100,958,2711,10227,0.874248405,0.125751595,0.033334563
Montana,CHOUTEAU,5813,4387,1,94,1426,0.754687769,0.245312231,0.016170652
Montana,CUSTER,11699,11009,31,263,690,0.9410206,0.0589794,0.022480554
Montana,DANIELS,1751,1653,3,27,98,0.944031982,0.055968018,0.01541976
Montana,DAWSON,8966,8477,25,178,489,0.945460629,0.054539371,0.019852777
Montana,DEER LODGE,9298,8518,36,271,780,0.916110992,0.083889008,0.029146053
Montana,FALLON,2890,2793,2,34,97,0.966435986,0.033564014,0.011764706
Montana,FERGUS,11586,11085,18,171,501,0.956758156,0.043241844,0.014759192
Montana,FLATHEAD,90928,85439,180,2070,5489,0.939633556,0.060366444,0.022765265
Montana,GALLATIN,89513,83545,277,2470,5968,0.93332812,0.06667188,0.027593757
Montana,GARFIELD,1206,1187,3,3,19,0.984245439,0.015754561,0.002487562
Montana,GLACIER,13399,4117,17,241,9282,0.307261736,0.692738264,0.017986417
Montana,GOLDEN VALLEY,884,822,0,31,62,0.929864253,0.070135747,0.035067873
Montana,GRANITE,3079,2968,3,44,111,0.963949334,0.036050666,0.014290354
Montana,HILL,16096,11741,47,373,4355,0.729435885,0.270564115,0.023173459
Montana,JEFFERSON,11406,10724,16,224,682,0.940206909,0.059793091,0.019638787
Montana,JUDITH BASIN,2072,2014,1,24,58,0.972007722,0.027992278,0.011583012
Montana,LAKE,28746,19568,88,998,9178,0.680720796,0.319279204,0.034717874
Montana,LEWIS AND CLARK,63395,58599,203,1582,4796,0.924347346,0.075652654,0.024954649
Montana,LIBERTY,2339,2293,2,8,46,0.980333476,0.019666524,0.003420265
Montana,LINCOLN,19687,18546,20,462,1141,0.942042973,0.057957027,0.023467263
Montana,MCCONE,1734,1689,3,13,45,0.974048443,0.025951557,0.007497116
Montana,MADISON,7691,7335,15,186,356,0.953712131,0.046287869,0.024184111
Montana,MEAGHER,1891,1827,2,28,64,0.966155473,0.033844527,0.01480698
Montana,MINERAL,4223,3952,9,80,271,0.935827611,0.064172389,0.018943879
Montana,MISSOULA,109299,99489,412,2861,9810,0.910246205,0.089753795,0.026175903
Montana,MUSSELSHELL,4538,4278,10,118,260,0.942706038,0.057293962,0.026002644
Montana,PARK,15636,14893,19,325,743,0.952481453,0.047518547,0.020785367
Montana,PETROLEUM,494,486,0,5,8,0.983805668,0.016194332,0.010121457
Montana,PHILLIPS,4253,3665,1,81,588,0.861744651,0.138255349,0.01904538
Montana,PONDERA,6153,5060,7,87,1093,0.822363075,0.177636925,0.014139444
Montana,POWDER RIVER,1743,1645,1,24,98,0.9437751,0.0562249,0.013769363
Montana,POWELL,7027,6425,65,117,602,0.91433044,0.08566956,0.016650064
Montana,PRAIRIE,1179,1125,0,16,54,0.954198473,0.045801527,0.013570823
Montana,RAVALLI,40212,37764,72,1195,2448,0.93912265,0.06087735,0.029717497
Montana,RICHLAND,9746,9089,12,297,657,0.932587728,0.067412272,0.030474041
Montana,ROOSEVELT,10425,3709,12,132,6716,0.355779376,0.644220624,0.012661871
Montana,ROSEBUD,9233,5556,23,313,3677,0.601754576,0.398245424,0.033900141
Montana,SANDERS,11413,10320,17,233,1093,0.904232016,0.095767984,0.020415316
Montana,SHERIDAN,3384,3201,7,51,183,0.945921986,0.054078014,0.015070922
Montana,SILVER BOW,34200,31515,103,1253,2685,0.921491228,0.078508772,0.036637427
Montana,STILLWATER,9117,8688,9,214,429,0.952945048,0.047054952,0.023472634
Montana,SWEET GRASS,3651,3491,4,51,160,0.95617639,0.04382361,0.013968776
Montana,TETON,6073,5792,3,76,281,0.953729623,0.046270377,0.012514408
Montana,TOOLE,5324,4813,28,129,511,0.904019534,0.095980466,0.024229902
Montana,TREASURE,718,666,0,25,52,0.927576602,0.072423398,0.034818942
Montana,VALLEY,7369,6364,17,91,1005,0.863617859,0.136382141,0.01234903
Montana,WHEATLAND,2168,2064,7,32,104,0.95202952,0.04797048,0.014760148
Montana,WIBAUX,1017,987,0,13,30,0.970501475,0.029498525,0.012782694
Montana,YELLOWSTONE,147972,130463,852,6955,17509,0.88167356,0.11832644,0.047002136
Nebraska,ADAMS,31364,27747,219,2544,3617,0.884676699,0.115323301,0.081112103
Nebraska,ANTELOPE,6685,6418,19,178,267,0.960059835,0.039940165,0.026626776
Nebraska,ARTHUR,460,435,0,19,25,0.945652174,0.054347826,0.041304348
Nebraska,BANNER,690,656,0,26,34,0.950724638,0.049275362,0.037681159
Nebraska,BLAINE,478,474,1,0,4,0.991631799,0.008368201,0
Nebraska,BOONE,5505,5383,23,65,122,0.977838329,0.022161671,0.011807448
Nebraska,BOX BUTTE,11308,9564,49,1157,1744,0.845772904,0.154227096,0.102316944
Nebraska,BOYD,2099,2024,1,33,75,0.964268699,0.035731301,0.015721772
Nebraska,BROWN,3145,3072,2,29,73,0.976788553,0.023211447,0.009220986
Nebraska,BUFFALO,46102,41128,354,3432,4974,0.892108802,0.107891198,0.074443625
Nebraska,BURT,6858,6520,23,126,338,0.950714494,0.049285506,0.018372703
Nebraska,BUTLER,8395,8092,24,195,303,0.963907088,0.036092912,0.023228112
Nebraska,CASS,25241,24083,82,608,1158,0.954122261,0.045877739,0.024087794
Nebraska,CEDAR,8852,8659,7,113,193,0.978197018,0.021802982,0.012765477
Nebraska,CHASE,3966,3491,5,442,475,0.880231972,0.119768028,0.111447302
Nebraska,CHERRY,5713,5141,11,95,572,0.899877472,0.100122528,0.016628741
Nebraska,CHEYENNE,9998,9079,19,610,919,0.908081616,0.091918384,0.061012202
Nebraska,CLAY,6542,5941,21,502,601,0.90813207,0.09186793,0.076734943
Nebraska,COLFAX,10515,6031,49,4315,4484,0.573561579,0.426438421,0.410366144
Nebraska,CUMING,9139,8271,8,754,868,0.905022431,0.094977569,0.082503556
Nebraska,CUSTER,10939,10551,28,216,388,0.964530579,0.035469421,0.019745863
Nebraska,DAKOTA,21006,11596,641,7419,9410,0.552032753,0.447967247,0.353184804
Nebraska,DAWES,9182,8058,130,306,1124,0.877586582,0.122413418,0.033326073
Nebraska,DAWSON,24326,15464,710,7746,8862,0.63569843,0.36430157,0.318424731
Nebraska,DEUEL,1941,1839,1,75,102,0.947449768,0.052550232,0.038639876
Nebraska,DIXON,6000,5293,14,622,707,0.882166667,0.117833333,0.103666667
Nebraska,DODGE,36691,32120,183,3689,4571,0.87541904,0.12458096,0.100542367
Nebraska,DOUGLAS,517110,372029,59176,57804,145081,0.719438804,0.280561196,0.111782793
Nebraska,DUNDY,2008,1852,7,117,156,0.922310757,0.077689243,0.058266932
Nebraska,FILLMORE,5890,5619,30,178,271,0.953989813,0.046010187,0.030220713
Nebraska,FRANKLIN,3225,3145,1,33,80,0.975193798,0.024806202,0.010232558
Nebraska,FRONTIER,2756,2687,0,35,69,0.974963716,0.025036284,0.012699565
Nebraska,FURNAS,4959,4745,8,132,214,0.956846138,0.043153862,0.02661827
Nebraska,GAGE,22311,21432,72,385,879,0.960602393,0.039397607,0.017256062
Nebraska,GARDEN,2057,1942,4,80,115,0.94409334,0.05590666,0.03889159
Nebraska,GARFIELD,2049,2022,3,15,27,0.98682284,0.01317716,0.007320644
Nebraska,GOSPER,2044,1954,8,49,90,0.955968689,0.044031311,0.023972603
Nebraska,GRANT,614,600,0,7,14,0.977198697,0.022801303,0.011400651
Nebraska,GREELEY,2538,2451,16,51,87,0.96572104,0.03427896,0.020094563
Nebraska,HALL,58607,42537,906,13653,16070,0.725800672,0.274199328,0.23295852
Nebraska,HAMILTON,9124,8839,19,181,285,0.9687637,0.0312363,0.01983779
Nebraska,HARLAN,3423,3343,1,45,80,0.976628688,0.023371312,0.013146363
Nebraska,HAYES,967,928,0,33,39,0.95966908,0.04033092,0.034126163
Nebraska,HITCHCOCK,2908,2820,6,42,88,0.969738652,0.030261348,0.014442916
Nebraska,HOLT,10435,10021,16,305,414,0.960325827,0.039674173,0.029228558
Nebraska,HOOKER,736,721,0,8,15,0.979619565,0.020380435,0.010869565
Nebraska,HOWARD,6274,6067,15,109,207,0.967006694,0.032993306,0.017373287
Nebraska,JEFFERSON,7547,7225,17,200,322,0.95733404,0.04266596,0.026500596
Nebraska,JOHNSON,5217,4355,278,435,862,0.834770941,0.165229059,0.083381254
Nebraska,KEARNEY,6489,6162,10,244,327,0.949607027,0.050392973,0.037602096
Nebraska,KEITH,8368,7728,16,474,640,0.923518164,0.076481836,0.056644359
Nebraska,KEYA PAHA,824,815,0,4,9,0.98907767,0.01092233,0.004854369
Nebraska,KIMBALL,3821,3461,6,244,360,0.905783826,0.094216174,0.063857629
Nebraska,KNOX,8701,7688,8,155,1013,0.8835766,0.1164234,0.017814044
Nebraska,LANCASTER,285407,240702,9636,16685,44705,0.843364038,0.156635962,0.058460374
Nebraska,LINCOLN,36288,32741,235,2602,3547,0.902254189,0.097745811,0.071704145
Nebraska,LOGAN,763,739,1,13,24,0.968545216,0.031454784,0.017038008
Nebraska,LOUP,632,617,1,13,15,0.976265823,0.023734177,0.02056962
Nebraska,MCPHERSON,539,528,2,2,11,0.979591837,0.020408163,0.003710575
Nebraska,MADISON,34876,29062,409,4504,5814,0.833295103,0.166704897,0.12914325
Nebraska,MERRICK,7845,7405,14,271,440,0.943913321,0.056086679,0.034544296
Nebraska,MORRILL,5042,4256,8,687,786,0.84410948,0.15589052,0.136255454
Nebraska,NANCE,3735,3627,8,65,108,0.971084337,0.028915663,0.017402945
Nebraska,NEMAHA,7248,6939,62,133,309,0.95736755,0.04263245,0.01834989
Nebraska,NUCKOLLS,4500,4333,6,97,167,0.962888889,0.037111111,0.021555556
Nebraska,OTOE,15740,14499,68,902,1241,0.92115629,0.07884371,0.057306226
Nebraska,PAWNEE,2773,2683,9,35,90,0.967544176,0.032455824,0.012621709
Nebraska,PERKINS,2970,2848,10,95,122,0.958922559,0.041077441,0.031986532
Nebraska,PHELPS,9188,8694,12,373,494,0.946234219,0.053765781,0.04059643
Nebraska,PIERCE,7266,7098,11,93,168,0.976878613,0.023121387,0.012799339
Nebraska,PLATTE,32237,27167,128,4452,5070,0.842727301,0.157272699,0.138102181
Nebraska,POLK,5406,5186,6,156,220,0.959304477,0.040695523,0.028856826
Nebraska,RED WILLOW,11055,10345,81,462,710,0.935775667,0.064224333,0.041791045
Nebraska,RICHARDSON,8363,7830,11,112,533,0.93626689,0.06373311,0.013392323
Nebraska,ROCK,1526,1502,1,2,24,0.984272608,0.015727392,0.001310616
Nebraska,SALINE,14200,10817,92,2870,3383,0.761760563,0.238239437,0.202112676
Nebraska,SARPY,158840,133132,6119,11569,25708,0.838151599,0.161848401,0.072834299
Nebraska,SAUNDERS,20780,19992,69,415,788,0.962078922,0.037921078,0.019971126
Nebraska,SCOTTS BLUFF,36970,27931,157,7785,9039,0.755504463,0.244495537,0.210576143
Nebraska,SEWARD,16750,16152,59,272,598,0.964298507,0.035701493,0.016238806
Nebraska,SHERIDAN,5469,4559,12,171,910,0.833607607,0.166392393,0.031267142
Nebraska,SHERMAN,3152,3095,3,31,57,0.981916244,0.018083756,0.009835025
Nebraska,SIOUX,1311,1240,1,52,71,0.945842868,0.054157132,0.039664378
Nebraska,STANTON,6129,5729,36,281,400,0.934736499,0.065263501,0.04584761
Nebraska,THAYER,5228,5077,10,76,151,0.971117062,0.028882938,0.014537108
Nebraska,THOMAS,647,629,1,12,18,0.972179289,0.027820711,0.018547141
Nebraska,THURSTON,6940,2739,17,190,4201,0.394668588,0.605331412,0.027377522
Nebraska,VALLEY,4260,4129,3,79,131,0.969248826,0.030751174,0.018544601
Nebraska,WASHINGTON,20234,19405,120,419,829,0.959029357,0.040970643,0.02070772
Nebraska,WAYNE,9595,8893,127,401,702,0.926836894,0.073163106,0.0417926
Nebraska,WEBSTER,3812,3588,18,133,224,0.941238195,0.058761805,0.034889822
Nebraska,WHEELER,818,802,0,6,16,0.980440098,0.019559902,0.007334963
Nebraska,YORK,13665,12725,149,555,940,0.931211123,0.068788877,0.040614709
Nevada,CHURCHILL,24877,19030,366,3009,5847,0.764963621,0.235036379,0.120955099
Nevada,CLARK,1951269,935955,194821,568644,1015314,0.479664772,0.520335228,0.291422659
Nevada,DOUGLAS,46997,39094,174,5103,7903,0.83184033,0.16815967,0.108581399
Nevada,ELKO,48818,33730,329,11158,15088,0.690933672,0.309066328,0.228563235
Nevada,ESMERALDA,783,605,0,120,178,0.772669221,0.227330779,0.153256705
Nevada,EUREKA,1987,1662,2,238,325,0.836436839,0.163563161,0.119778561
Nevada,HUMBOLDT,16528,11395,78,4038,5133,0.689436108,0.310563892,0.244312682
Nevada,LANDER,5775,4259,17,1219,1516,0.737489177,0.262510823,0.211082251
Nevada,LINCOLN,5345,4698,120,332,647,0.878952292,0.121047708,0.062114125
Nevada,LYON,51980,40634,363,7674,11346,0.78172374,0.21827626,0.147633705
Nevada,MINERAL,4772,3271,182,436,1501,0.685456832,0.314543168,0.091366303
Nevada,NYE,43946,34663,836,5967,9283,0.788763482,0.211236518,0.135780276
Nevada,PERSHING,6753,4605,251,1508,2148,0.681919147,0.318080853,0.223308159
Nevada,STOREY,4010,3532,40,228,478,0.880798005,0.119201995,0.056857855
Nevada,WASHOE,421407,278213,9088,93724,143194,0.660200234,0.339799766,0.222407316
Nevada,WHITE PINE,10030,7652,388,1326,2378,0.762911266,0.237088734,0.13220339
Nevada,CARSON CITY,55274,39083,1003,11777,16191,0.707077469,0.292922531,0.213065818
New Hampshire,BELKNAP,60088,57553,261,724,2535,0.957811876,0.042188124,0.012048995
New Hampshire,CARROLL,47818,46285,126,473,1533,0.967940943,0.032059057,0.009891673
New Hampshire,CHESHIRE,77117,73537,363,1090,3580,0.953577032,0.046422968,0.014134367
New Hampshire,COOS,33055,31801,141,401,1254,0.962063228,0.037936772,0.012131296
New Hampshire,GRAFTON,89118,82294,768,1600,6824,0.923427366,0.076572634,0.017953724
New Hampshire,HILLSBOROUGH,400721,351224,7405,21241,49497,0.876480145,0.123519855,0.053006955
New Hampshire,MERRIMACK,146445,138048,1452,2339,8397,0.942661067,0.057338933,0.015971867
New Hampshire,ROCKINGHAM,295223,278011,1790,6142,17212,0.941698309,0.058301691,0.020804612
New Hampshire,STRAFFORD,123143,114210,1144,2201,8933,0.927458321,0.072541679,0.017873529
New Hampshire,SULLIVAN,43742,42087,175,493,1655,0.96216451,0.03783549,0.011270632
New Jersey,ATLANTIC,274549,160871,40882,46241,113678,0.585946407,0.414053593,0.168425308
New Jersey,BERGEN,905116,566053,46850,145281,339063,0.625392767,0.374607233,0.160510918
New Jersey,BURLINGTON,448734,317021,71247,28831,131713,0.706478671,0.293521329,0.064249645
New Jersey,CAMDEN,513657,309648,94762,73124,204009,0.602830293,0.397169707,0.14235959
New Jersey,CAPE MAY,97265,84522,4244,6054,12743,0.868986789,0.131013211,0.062242328
New Jersey,CUMBERLAND,156898,78931,29376,42457,77967,0.50307206,0.49692794,0.270602557
New Jersey,ESSEX,783969,260177,308358,159117,523792,0.331871541,0.668128459,0.202963382
New Jersey,GLOUCESTER,288288,233695,27906,13712,54593,0.810630342,0.189369658,0.047563548
New Jersey,HUDSON,634266,195510,71315,267853,438756,0.308246067,0.691753933,0.422303891
New Jersey,HUNTERDON,128349,112607,3233,6722,15742,0.877350038,0.122649962,0.052372827
New Jersey,MERCER,366513,199909,71378,55318,166604,0.54543495,0.45456505,0.150930526
New Jersey,MIDDLESEX,809858,398724,71557,148975,411134,0.492338163,0.507661837,0.183952001
New Jersey,MONMOUTH,630380,483435,43931,60939,146945,0.766894572,0.233105428,0.096670262
New Jersey,MORRIS,492276,369551,14134,56482,122725,0.750698795,0.249301205,0.114736449
New Jersey,OCEAN,576567,495534,16583,47783,81033,0.859456056,0.140543944,0.082875017
New Jersey,PASSAIC,501226,227144,55480,185677,274082,0.45317681,0.54682319,0.370445667
New Jersey,SALEM,66083,50736,8940,4507,15347,0.767761754,0.232238246,0.068202109
New Jersey,SOMERSET,323444,201849,27480,42091,121595,0.624061661,0.375938339,0.13013381
New Jersey,SUSSEX,149265,132484,2448,9617,16781,0.887575788,0.112424212,0.064429036
New Jersey,UNION,536499,243312,111705,146704,293187,0.453518087,0.546481913,0.273446922
New Jersey,WARREN,108692,93165,3592,7659,15527,0.8571468,0.1428532,0.070465168
New Mexico,BERNALILLO,662564,274862,16293,317089,387702,0.414845962,0.585154038,0.478578673
New Mexico,CATRON,3725,2832,15,709,893,0.760268456,0.239731544,0.19033557
New Mexico,CHAVES,65645,28801,1079,34139,36844,0.43873867,0.56126133,0.52005484
New Mexico,CIBOLA,27213,5857,221,9934,21356,0.215228016,0.784771984,0.365046118
New Mexico,COLFAX,13750,6863,39,6488,6887,0.499127273,0.500872727,0.471854545
New Mexico,CURRY,48376,24545,2774,19117,23831,0.507379692,0.492620308,0.395175294
New Mexico,DE BACA,2022,1200,2,779,822,0.59347181,0.40652819,0.385262117
New Mexico,EDDY,53829,28111,589,23731,25718,0.522227795,0.477772205,0.440859017
New Mexico,GRANT,29514,14356,185,14252,15158,0.486413228,0.513586772,0.482889476
New Mexico,GUADALUPE,4687,753,66,3730,3934,0.160657137,0.839342863,0.795818221
New Mexico,HARDING,695,391,2,299,304,0.562589928,0.437410072,0.430215827
New Mexico,HIDALGO,4894,2025,17,2769,2869,0.413771966,0.586228034,0.565794851
New Mexico,LEA,64727,27845,2399,33063,36882,0.430191419,0.569808581,0.510806928
New Mexico,LINCOLN,20497,13600,74,6110,6897,0.663511733,0.336488267,0.298092404
New Mexico,LOS ALAMOS,17950,13689,97,2646,4261,0.762618384,0.237381616,0.147409471
New Mexico,LUNA,25095,8997,189,15423,16098,0.358517633,0.641482367,0.614584579
New Mexico,MCKINLEY,71492,7384,317,9473,64108,0.103284284,0.896715716,0.132504336
New Mexico,MORA,4881,873,10,3953,4008,0.178856792,0.821143208,0.809875026
New Mexico,OTERO,63797,33716,2048,22026,30081,0.5284888,0.4715112,0.345251344
New Mexico,QUAY,9041,4847,82,3834,4194,0.536113262,0.463886738,0.424068134
New Mexico,RIO ARRIBA,40246,5148,103,28703,35098,0.127913333,0.872086667,0.713188888
New Mexico,ROOSEVELT,19846,11022,296,7913,8824,0.555376398,0.444623602,0.398720145
New Mexico,SANDOVAL,131561,62445,2462,46129,69116,0.474646742,0.525353258,0.350628226
New Mexico,SAN JUAN,130044,55254,617,24776,74790,0.424886961,0.575113039,0.190520132
New Mexico,SAN MIGUEL,29393,5781,339,22583,23612,0.196679482,0.803320518,0.768312183
New Mexico,SANTA FE,144170,63291,947,73015,80879,0.439002566,0.560997434,0.506450718
New Mexico,SIERRA,11988,8205,44,3352,3783,0.684434434,0.315565566,0.279612946
New Mexico,SOCORRO,17866,6711,142,8664,11155,0.375629688,0.624370312,0.484943468
New Mexico,TAOS,32937,11958,104,18381,20979,0.363056745,0.636943255,0.558065398
New Mexico,TORRANCE,16383,9173,172,6399,7210,0.559909662,0.440090338,0.390587804
New Mexico,UNION,4549,2549,74,1805,2000,0.560342933,0.439657067,0.396790503
New Mexico,VALENCIA,76569,27734,839,44605,48835,0.362209249,0.637790751,0.582546461
New York,ALBANY,304204,231152,36396,14917,73052,0.759858516,0.240141484,0.049036173
New York,ALLEGANY,48946,46701,494,670,2245,0.954133126,0.045866874,0.013688555
New York,BRONX,1385108,151209,416695,741413,1233899,0.109167661,0.890832339,0.535274506
New York,BROOME,200600,173074,8850,6778,27526,0.862781655,0.137218345,0.033788634
New York,CATTARAUGUS,80317,73849,966,1345,6468,0.919469104,0.080530896,0.016746143
New York,CAYUGA,80026,73098,3009,1896,6928,0.913428136,0.086571864,0.0236923
New York,CHAUTAUQUA,134905,120463,2763,8241,14442,0.892946889,0.107053111,0.061087432
New York,CHEMUNG,88830,77643,5528,2240,11187,0.874062817,0.125937183,0.025216706
New York,CHENANGO,50477,48265,323,929,2212,0.956178061,0.043821939,0.018404422
New York,CLINTON,82128,74832,2953,2054,7296,0.911163063,0.088836937,0.025009741
New York,COLUMBIA,63096,55672,2691,2454,7424,0.882338025,0.117661975,0.038893115
New York,CORTLAND,49336,46252,705,1094,3084,0.937489865,0.062510135,0.022174477
New York,DELAWARE,47980,44706,691,1560,3274,0.931763235,0.068236765,0.032513547
New York,DUTCHESS,297488,221812,27395,31267,75676,0.74561663,0.25438337,0.105103399
New York,ERIE,919040,714156,119916,41731,204884,0.777067375,0.222932625,0.045407164
New York,ESSEX,39370,36588,982,993,2782,0.929337059,0.070662941,0.02522225
New York,FRANKLIN,51599,42640,2834,1506,8959,0.826372604,0.173627396,0.029186612
New York,FULTON,55531,52110,981,1263,3421,0.93839477,0.06160523,0.022744053
New York,GENESEE,60079,54990,1491,1616,5089,0.915294862,0.084705138,0.026897918
New York,GREENE,49221,42857,2606,2419,6364,0.870705593,0.129294407,0.04914569
New York,HAMILTON,4836,4664,33,51,172,0.964433416,0.035566584,0.010545906
New York,HERKIMER,64519,61690,640,1040,2829,0.956152451,0.043847549,0.016119283
New York,JEFFERSON,116229,99682,5475,6143,16547,0.857634497,0.142365503,0.052852558
New York,KINGS,2504700,893306,799066,496285,1611394,0.356651894,0.643348106,0.198141494
New York,LEWIS,27087,26225,170,357,862,0.968176616,0.031823384,0.013179754
New York,LIVINGSTON,65393,60296,1491,1802,5097,0.922055878,0.077944122,0.027556466
New York,MADISON,73442,68916,1260,1316,4526,0.938373138,0.061626862,0.017918902
New York,MONROE,744344,542034,107448,54005,202310,0.728203626,0.271796374,0.072553819
New York,MONTGOMERY,50219,42732,712,5654,7487,0.850913001,0.149086999,0.11258687
New York,NASSAU,1339532,877309,141305,195355,462223,0.654936948,0.345063052,0.145838248
New York,NEW YORK,1585873,761493,205340,403577,824380,0.48017275,0.51982725,0.254482547
New York,NIAGARA,216469,188907,14511,4694,27562,0.872674609,0.127325391,0.021684398
New York,ONEIDA,234878,199254,13682,10819,35624,0.848329771,0.151670229,0.046062211
New York,ONONDAGA,467026,370040,48696,18829,96986,0.792332761,0.207667239,0.040316813
New York,ONTARIO,107931,99119,2226,3679,8812,0.918355245,0.081644755,0.034086592
New York,ORANGE,372813,254259,33895,67185,118554,0.682001432,0.317998568,0.18021099
New York,ORLEANS,42883,37658,2368,1757,5225,0.878156845,0.121843155,0.040971947
New York,OSWEGO,122109,116091,862,2552,6018,0.950716163,0.049283837,0.02089936
New York,OTSEGO,62259,57734,958,1921,4525,0.927319745,0.072680255,0.030854977
New York,PUTNAM,99710,82709,2047,11661,17001,0.829495537,0.170504463,0.116949153
New York,QUEENS,2230722,616727,395881,613750,1613995,0.276469681,0.723530319,0.275135136
New York,RENSSELAER,159429,136555,9592,6080,22874,0.856525475,0.143474525,0.038136098
New York,RICHMOND,468730,300169,44313,81051,168561,0.640387857,0.359612143,0.172916178
New York,ROCKLAND,311687,203670,34623,48783,108017,0.653444,0.346556,0.156512784
New York,ST. LAWRENCE,111944,103943,2259,2146,8001,0.928526763,0.071473237,0.019170299
New York,SARATOGA,219607,203647,3053,5279,15960,0.927324721,0.072675279,0.024038396
New York,SCHENECTADY,154727,119409,13528,8827,35318,0.771739903,0.228260097,0.057048867
New York,SCHOHARIE,32749,30742,394,924,2007,0.938715686,0.061284314,0.028214602
New York,SCHUYLER,18343,17646,143,234,697,0.962001854,0.037998146,0.01275691
New York,SENECA,35251,31999,1513,952,3252,0.907747298,0.092252702,0.027006326
New York,STEUBEN,98990,93476,1487,1371,5514,0.944297404,0.055702596,0.013849884
New York,SUFFOLK,1493350,1068728,102117,246239,424622,0.715658084,0.284341916,0.164890347
New York,SULLIVAN,77547,57780,6349,10554,19767,0.745096522,0.254903478,0.136098108
New York,TIOGA,51125,49105,349,694,2020,0.960488998,0.039511002,0.013574572
New York,TOMPKINS,101564,81490,3773,4264,20074,0.802351227,0.197648773,0.04198338
New York,ULSTER,182493,149099,9982,15909,33394,0.817012159,0.182987841,0.087175946
New York,WARREN,65707,62585,556,1178,3122,0.952486036,0.047513964,0.017928075
New York,WASHINGTON,63216,58996,1734,1446,4220,0.933244748,0.066755252,0.022873956
New York,WAYNE,93772,85318,2743,3476,8454,0.909845156,0.090154844,0.037068635
New York,WESTCHESTER,949113,544563,126585,207032,404550,0.573759921,0.426240079,0.218132088
New York,WYOMING,42155,38042,2233,1244,4113,0.902431503,0.097568497,0.029510141
New York,YATES,25348,24371,196,421,977,0.961456525,0.038543475,0.016608805
North Carolina,ALAMANCE,151131,101718,27985,16639,49413,0.673045239,0.326954761,0.110096539
North Carolina,ALEXANDER,37198,32671,2025,1601,4527,0.878299909,0.121700091,0.043039948
North Carolina,ALLEGHANY,11155,9862,133,1004,1293,0.884087853,0.115912147,0.090004482
North Carolina,ANSON,26948,12344,13038,812,14604,0.458067389,0.541932611,0.030132106
North Carolina,ASHE,27281,25420,148,1311,1861,0.931784026,0.068215974,0.048055423
North Carolina,AVERY,17797,16029,706,797,1768,0.900657414,0.099342586,0.044782829
North Carolina,BEAUFORT,47759,31705,12105,3166,16054,0.663853933,0.336146067,0.06629117
North Carolina,BERTIE,21282,7393,13252,267,13889,0.347382765,0.652617235,0.012545813
North Carolina,BLADEN,35190,19242,12202,2502,15948,0.546803069,0.453196931,0.071099744
North Carolina,BRUNSWICK,107431,86818,12120,5549,20613,0.808128008,0.191871992,0.051651758
North Carolina,BUNCOMBE,238318,201241,14979,14254,37077,0.844422159,0.155577841,0.059810841
North Carolina,BURKE,90912,75472,5953,4634,15440,0.830165435,0.169834565,0.050972369
North Carolina,CABARRUS,178011,127526,26660,16767,50485,0.716393931,0.283606069,0.094190808
North Carolina,CALDWELL,83029,73565,4025,3796,9464,0.886015729,0.113984271,0.045718966
North Carolina,CAMDEN,9980,8103,1299,215,1877,0.811923848,0.188076152,0.021543086
North Carolina,CARTERET,66469,58101,3986,2241,8368,0.874106726,0.125893274,0.033714965
North Carolina,CASWELL,23719,14513,7991,744,9206,0.611872339,0.388127661,0.031367258
North Carolina,CATAWBA,154358,120388,12857,13032,33970,0.779927182,0.220072818,0.084427111
North Carolina,CHATHAM,63505,45185,8272,8228,18320,0.711518778,0.288481222,0.129564601
North Carolina,CHEROKEE,27444,25341,327,688,2103,0.923371229,0.076628771,0.025069232
North Carolina,CHOWAN,14793,9040,5054,467,5753,0.611099845,0.388900155,0.031568985
North Carolina,CLAY,10587,10080,64,258,507,0.95211108,0.04788892,0.02436951
North Carolina,CLEVELAND,98078,72793,20237,2756,25285,0.742194988,0.257805012,0.028100084
North Carolina,COLUMBUS,58098,35068,17587,2662,23030,0.603600812,0.396399188,0.045819133
North Carolina,CRAVEN,103505,69425,22868,6272,34080,0.670740544,0.329259456,0.060596106
North Carolina,CUMBERLAND,319431,150749,113939,30190,168682,0.471929775,0.528070225,0.094511804
North Carolina,CURRITUCK,23547,20876,1348,704,2671,0.886567291,0.113432709,0.029897652
North Carolina,DARE,33920,30061,812,2210,3859,0.886232311,0.113767689,0.065153302
North Carolina,DAVIDSON,162878,133486,14269,10408,29392,0.819545918,0.180454082,0.063900588
North Carolina,DAVIE,41240,35257,2552,2496,5983,0.854922405,0.145077595,0.060523763
North Carolina,DUPLIN,58505,30959,14640,12059,27546,0.529168447,0.470831553,0.206119135
North Carolina,DURHAM,267587,112697,100260,36077,154890,0.421160221,0.578839779,0.134823441
North Carolina,EDGECOMBE,56552,21360,32318,2104,35192,0.377705475,0.622294525,0.037204697
North Carolina,FORSYTH,350670,205934,89533,41775,144736,0.587258676,0.412741324,0.119129096
North Carolina,FRANKLIN,60619,38478,15995,4776,22141,0.634751481,0.365248519,0.078787179
North Carolina,GASTON,206086,156310,31002,12201,49776,0.758469765,0.241530235,0.059203439
North Carolina,GATES,12197,7684,4040,173,4513,0.629990981,0.370009019,0.014183816
North Carolina,GRAHAM,8861,7942,17,194,919,0.896287101,0.103712899,0.021893691
North Carolina,GRANVILLE,59916,34550,19454,4482,25366,0.57664063,0.42335937,0.074804727
North Carolina,GREENE,21362,10038,7902,3054,11324,0.469899822,0.530100178,0.142964142
North Carolina,GUILFORD,488406,265228,156982,34826,223178,0.543048202,0.456951798,0.07130543
North Carolina,HALIFAX,54691,21569,28986,1152,33122,0.394379331,0.605620669,0.021063795
North Carolina,HARNETT,114678,73707,23591,12359,40971,0.642730079,0.357269921,0.107771325
North Carolina,HAYWOOD,59036,55368,615,1999,3668,0.937868419,0.062131581,0.033860695
North Carolina,HENDERSON,106740,90105,3149,10424,16635,0.844154019,0.155845981,0.09765786
North Carolina,HERTFORD,24669,8479,14845,644,16190,0.34371073,0.65628927,0.026105639
North Carolina,HOKE,46952,19142,15392,5823,27810,0.407692963,0.592307037,0.124020276
North Carolina,HYDE,5810,3436,1833,411,2374,0.591394148,0.408605852,0.070740103
North Carolina,IREDELL,159437,124107,18748,10844,35330,0.778407772,0.221592228,0.068014325
North Carolina,JACKSON,40271,32795,729,2038,7476,0.814357726,0.185642274,0.050607137
North Carolina,JOHNSTON,168878,117869,25082,21814,51009,0.697953552,0.302046448,0.12917017
North Carolina,JONES,10153,6217,3276,398,3936,0.612331331,0.387668669,0.039200236
North Carolina,LEE,57866,34321,11369,10576,23545,0.593111672,0.406888328,0.182767083
North Carolina,LENOIR,59495,30492,23968,3917,29003,0.512513657,0.487486343,0.065837465
North Carolina,LINCOLN,78265,67139,4269,5238,11126,0.857841947,0.142158053,0.066926468
North Carolina,MCDOWELL,44996,39982,1663,2392,5014,0.888567873,0.111432127,0.053160281
North Carolina,MACON,33922,30599,419,2230,3323,0.902039974,0.097960026,0.065739048
North Carolina,MADISON,20764,19734,233,423,1030,0.950394914,0.049605086,0.020371797
North Carolina,MARTIN,24505,12790,10601,769,11715,0.521934299,0.478065701,0.031381351
North Carolina,MECKLENBURG,919628,465372,278042,111944,454256,0.506043748,0.493956252,0.121727481
North Carolina,MITCHELL,15579,14656,53,631,923,0.940753579,0.059246421,0.040503242
North Carolina,MONTGOMERY,27798,17875,5182,3926,9923,0.643031873,0.356968127,0.141233182
North Carolina,MOORE,88247,68487,11727,5261,19760,0.77608304,0.22391696,0.059616758
North Carolina,NASH,95840,51770,35449,6015,44070,0.540171119,0.459828881,0.062760851
North Carolina,NEW HANOVER,202667,155631,29469,10716,47036,0.767914855,0.232085145,0.052874913
North Carolina,NORTHAMPTON,22099,8596,12847,305,13503,0.388976877,0.611023123,0.013801529
North Carolina,ONSLOW,177772,122558,26577,17896,55214,0.689411156,0.310588844,0.100668272
North Carolina,ORANGE,133801,94671,15722,11017,39130,0.707550766,0.292449234,0.082338697
North Carolina,PAMLICO,13144,9828,2618,412,3316,0.74771759,0.25228241,0.0313451
North Carolina,PASQUOTANK,40661,22369,15256,1642,18292,0.550134035,0.449865965,0.040382676
North Carolina,PENDER,52217,38568,9208,3194,13649,0.738610031,0.261389969,0.061167819
North Carolina,PERQUIMANS,13453,9608,3328,286,3845,0.714190143,0.285809857,0.021259199
North Carolina,PERSON,39464,26354,10599,1593,13110,0.6677985,0.3322015,0.040365903
North Carolina,PITT,168148,96038,56813,9202,72110,0.571151605,0.428848395,0.054725599
North Carolina,POLK,20510,18126,911,1122,2384,0.883764018,0.116235982,0.054705022
North Carolina,RANDOLPH,141752,115205,7979,14698,26547,0.812722219,0.187277781,0.103688131
North Carolina,RICHMOND,46639,27369,14159,2741,19270,0.586826476,0.413173524,0.058770557
North Carolina,ROBESON,134168,36160,32347,10932,98008,0.26951285,0.73048715,0.081479936
North Carolina,ROCKINGHAM,93643,68744,17529,5159,24899,0.734107194,0.265892806,0.055092212
North Carolina,ROWAN,138428,101986,22153,10644,36442,0.736744011,0.263255989,0.076891958
North Carolina,RUTHERFORD,67810,57054,6804,2397,10756,0.841380327,0.158619673,0.035348769
North Carolina,SAMPSON,63431,33754,16948,10440,29677,0.532137283,0.467862717,0.164588293
North Carolina,SCOTLAND,36157,16605,13884,754,19552,0.459247172,0.540752828,0.0208535
North Carolina,STANLY,60585,49877,6590,2166,10708,0.823256582,0.176743418,0.035751424
North Carolina,STOKES,47401,43447,1897,1254,3954,0.916584038,0.083415962,0.026455138
North Carolina,SURRY,73673,62611,2644,7155,11062,0.849850013,0.150149987,0.097118347
North Carolina,SWAIN,13981,9168,75,540,4813,0.655747085,0.344252915,0.038623847
North Carolina,TRANSYLVANIA,33090,30049,1279,964,3041,0.908099124,0.091900876,0.029132668
North Carolina,TYRRELL,4407,2350,1677,240,2057,0.533242569,0.466757431,0.054458816
North Carolina,UNION,201292,150098,23134,20967,51194,0.745672953,0.254327047,0.104162113
North Carolina,VANCE,45422,19101,22477,3051,26321,0.420523095,0.579476905,0.067170094
North Carolina,WAKE,900993,560536,182793,87922,340457,0.62213136,0.37786864,0.097583444
North Carolina,WARREN,20972,7971,10911,692,13001,0.3800782,0.6199218,0.032996376
North Carolina,WASHINGTON,13228,5998,6567,466,7230,0.453432114,0.546567886,0.035228304
North Carolina,WATAUGA,51079,47268,855,1713,3811,0.925390082,0.074609918,0.033536287
North Carolina,WAYNE,122623,68216,38107,12162,54407,0.556306729,0.443693271,0.099182046
North Carolina,WILKES,69340,61587,2785,3772,7753,0.888188636,0.111811364,0.054398616
North Carolina,WILSON,81234,40157,31462,7724,41077,0.494337346,0.505662654,0.095083339
North Carolina,YADKIN,38406,33022,1165,3749,5384,0.859813571,0.140186429,0.097614956
North Carolina,YANCEY,17818,16652,128,814,1166,0.934560557,0.065439443,0.04568414
North Dakota,ADAMS,2343,2266,8,20,77,0.96713615,0.03286385,0.008536065
North Dakota,BARNES,11066,10599,83,123,467,0.957798663,0.042201337,0.011115127
North Dakota,BENSON,6660,2861,1,77,3799,0.42957958,0.57042042,0.011561562
North Dakota,BILLINGS,783,771,0,4,12,0.98467433,0.01532567,0.005108557
North Dakota,BOTTINEAU,6429,6062,25,82,367,0.942914917,0.057085083,0.012754705
North Dakota,BOWMAN,3151,3039,3,78,112,0.964455728,0.035544272,0.024754046
North Dakota,BURKE,1968,1891,4,37,77,0.960873984,0.039126016,0.018800813
North Dakota,BURLEIGH,81308,75054,476,986,6254,0.923082599,0.076917401,0.012126728
North Dakota,CASS,149778,135530,3372,3015,14248,0.904872545,0.095127455,0.020129792
North Dakota,CAVALIER,3993,3890,4,24,103,0.974204859,0.025795141,0.006010518
North Dakota,DICKEY,5289,5044,35,100,245,0.953677444,0.046322556,0.018907166
North Dakota,DIVIDE,2071,2006,5,30,65,0.968614196,0.031385804,0.014485756
North Dakota,DUNN,3536,2984,8,38,552,0.843891403,0.156108597,0.010746606
North Dakota,EDDY,2385,2242,4,52,143,0.940041929,0.059958071,0.021802935
North Dakota,EMMONS,3550,3468,2,34,82,0.976901408,0.023098592,0.009577465
North Dakota,FOSTER,3343,3272,3,29,71,0.978761591,0.021238409,0.008674843
North Dakota,GOLDEN VALLEY,1680,1613,9,35,67,0.960119048,0.039880952,0.020833333
North Dakota,GRAND FORKS,66861,59271,1322,1951,7590,0.886480908,0.113519092,0.02917994
North Dakota,GRANT,2394,2325,1,7,69,0.971177945,0.028822055,0.002923977
North Dakota,GRIGGS,2420,2387,7,9,33,0.986363636,0.013636364,0.003719008
North Dakota,HETTINGER,2477,2372,6,12,105,0.957610012,0.042389988,0.00484457
North Dakota,KIDDER,2435,2329,6,71,106,0.956468172,0.043531828,0.029158111
North Dakota,LAMOURE,4139,4053,5,34,86,0.979222034,0.020777966,0.008214545
North Dakota,LOGAN,1990,1954,2,12,36,0.981909548,0.018090452,0.006030151
North Dakota,MCHENRY,5395,5218,8,80,177,0.967191844,0.032808156,0.014828545
North Dakota,MCINTOSH,2809,2725,6,38,84,0.97009612,0.02990388,0.013527946
North Dakota,MCKENZIE,6360,4746,4,139,1614,0.746226415,0.253773585,0.021855346
North Dakota,MCLEAN,8962,8115,6,111,847,0.905489846,0.094510154,0.012385628
North Dakota,MERCER,8424,7996,16,121,428,0.949192783,0.050807217,0.014363723
North Dakota,MORTON,27471,25537,112,400,1934,0.929598486,0.070401514,0.01456081
North Dakota,MOUNTRAIL,7673,4931,16,286,2742,0.642643034,0.357356966,0.037273557
North Dakota,NELSON,3126,3018,8,33,108,0.965451056,0.034548944,0.010556622
North Dakota,OLIVER,1846,1782,3,19,64,0.965330444,0.034669556,0.010292524
North Dakota,PEMBINA,7413,6947,21,190,466,0.937137461,0.062862539,0.025630649
North Dakota,PIERCE,4357,4084,19,44,273,0.937342208,0.062657792,0.010098692
North Dakota,RAMSEY,11451,9980,41,137,1471,0.871539604,0.128460396,0.011964021
North Dakota,RANSOM,5457,5285,19,66,172,0.96848085,0.03151915,0.012094557
North Dakota,RENVILLE,2470,2401,2,24,69,0.972064777,0.027935223,0.009716599
North Dakota,RICHLAND,16321,15351,110,271,970,0.940567367,0.059432633,0.016604375
North Dakota,ROLETTE,13937,2802,21,133,11135,0.201047571,0.798952429,0.009542943
North Dakota,SARGENT,3829,3717,2,51,112,0.970749543,0.029250457,0.013319405
North Dakota,SHERIDAN,1321,1272,0,16,49,0.962906889,0.037093111,0.012112036
North Dakota,SIOUX,4153,517,6,82,3636,0.124488322,0.875511678,0.019744763
North Dakota,SLOPE,727,707,0,12,20,0.972489684,0.027510316,0.01650619
North Dakota,STARK,24199,22765,186,454,1434,0.940741353,0.059258647,0.018761106
North Dakota,STEELE,1975,1916,3,20,59,0.970126582,0.029873418,0.010126582
North Dakota,STUTSMAN,21100,19996,126,361,1104,0.947677725,0.052322275,0.017109005
North Dakota,TOWNER,2246,2165,2,10,81,0.963935886,0.036064114,0.00445236
North Dakota,TRAILL,8121,7693,39,214,428,0.947297131,0.052702869,0.026351435
North Dakota,WALSH,11119,9834,24,969,1285,0.884432053,0.115567947,0.087148125
North Dakota,WARD,61675,54717,1469,1869,6958,0.887182813,0.112817187,0.030304013
North Dakota,WELLS,4207,4143,3,21,64,0.984787259,0.015212741,0.004991681
North Dakota,WILLIAMS,22398,20364,57,436,2034,0.90918832,0.09081168,0.019466024
Ohio,ADAMS,28550,27713,84,243,837,0.970683012,0.029316988,0.008511384
Ohio,ALLEN,106331,87708,12508,2513,18623,0.824858226,0.175141774,0.023633747
Ohio,ASHLAND,53139,51352,395,501,1787,0.966371215,0.033628785,0.009428104
Ohio,ASHTABULA,101497,92126,3467,3441,9371,0.907672148,0.092327852,0.03390248
Ohio,ATHENS,64757,58779,1741,1002,5978,0.907685656,0.092314344,0.015473231
Ohio,AUGLAIZE,45949,44625,124,543,1324,0.971185445,0.028814555,0.01181745
Ohio,BELMONT,70400,65902,2815,429,4498,0.936107955,0.063892045,0.00609375
Ohio,BROWN,44846,43570,382,269,1276,0.971547072,0.028452928,0.005998305
Ohio,BUTLER,368130,310183,26463,14670,57947,0.842590933,0.157409067,0.039850053
Ohio,CARROLL,28836,28044,133,238,792,0.972534332,0.027465668,0.008253572
Ohio,CHAMPAIGN,40097,37743,874,451,2354,0.941292366,0.058707634,0.011247724
Ohio,CLARK,138333,117976,11999,3805,20357,0.852840609,0.147159391,0.02750609
Ohio,CLERMONT,197363,187331,2234,2896,10032,0.949169804,0.050830196,0.01467347
Ohio,CLINTON,42040,39496,905,559,2544,0.939486204,0.060513796,0.01329686
Ohio,COLUMBIANA,107841,102326,2323,1348,5515,0.948859896,0.051140104,0.012499884
Ohio,COSHOCTON,36901,35632,391,279,1269,0.965610688,0.034389312,0.007560771
Ohio,CRAWFORD,43784,42227,375,533,1557,0.964439064,0.035560936,0.012173397
Ohio,CUYAHOGA,1280122,785977,374968,61270,494145,0.613986011,0.386013989,0.047862626
Ohio,DARKE,52959,51365,233,646,1594,0.969901244,0.030098756,0.012198116
Ohio,DEFIANCE,39037,34345,666,3409,4692,0.879806338,0.120193662,0.087327407
Ohio,DELAWARE,174214,153969,5756,3669,20245,0.883792347,0.116207653,0.021060305
Ohio,ERIE,77079,65463,6534,2604,11616,0.849297474,0.150702526,0.033783521
Ohio,FAIRFIELD,146156,130377,8609,2510,15779,0.892040012,0.107959988,0.017173431
Ohio,FAYETTE,29030,27227,569,520,1803,0.937891836,0.062108164,0.017912504
Ohio,FRANKLIN,1163414,783048,244200,55718,380366,0.673060493,0.326939507,0.047891808
Ohio,FULTON,42698,38569,138,3341,4129,0.903297578,0.096702422,0.078247225
Ohio,GALLIA,30934,29150,800,275,1784,0.942328829,0.057671171,0.008889895
Ohio,GEAUGA,93389,89766,1187,1001,3623,0.961205281,0.038794719,0.010718607
Ohio,GREENE,161573,137440,11506,3439,24133,0.850637173,0.149362827,0.021284497
Ohio,GUERNSEY,40087,38276,580,349,1811,0.954823259,0.045176741,0.008706064
Ohio,HAMILTON,802374,542273,204748,20607,260101,0.675835708,0.324164292,0.025682537
Ohio,HANCOCK,74782,67888,1084,3363,6894,0.90781204,0.09218796,0.044970715
Ohio,HARDIN,32058,30774,255,407,1284,0.959947595,0.040052405,0.012695739
Ohio,HARRISON,15864,15169,324,79,695,0.956190116,0.043809884,0.004979829
Ohio,HENRY,28215,25861,103,1860,2354,0.916569201,0.083430799,0.065922382
Ohio,HIGHLAND,43589,41852,597,319,1737,0.960150497,0.039849503,0.00731836
Ohio,HOCKING,29380,28509,215,198,871,0.970353982,0.029646018,0.006739278
Ohio,HOLMES,42366,41607,123,329,759,0.982084691,0.017915309,0.007765661
Ohio,HURON,59626,54649,560,3333,4977,0.916529702,0.083470298,0.055898434
Ohio,JACKSON,33225,32096,191,265,1129,0.966019564,0.033980436,0.007975922
Ohio,JEFFERSON,69709,63519,3856,773,6190,0.911202284,0.088797716,0.011088956
Ohio,KNOX,60921,58498,485,737,2423,0.960227179,0.039772821,0.012097635
Ohio,LAKE,230041,208994,7156,7825,21047,0.908507614,0.091492386,0.034015675
Ohio,LAWRENCE,62450,59547,1267,445,2903,0.953514812,0.046485188,0.007125701
Ohio,LICKING,166492,153811,5643,2312,12681,0.923834178,0.076165822,0.013886553
Ohio,LOGAN,45858,43385,728,539,2473,0.946072659,0.053927341,0.011753674
Ohio,LORAIN,301356,241543,24289,25290,59813,0.801520461,0.198479539,0.083920679
Ohio,LUCAS,441815,313596,82541,26974,128219,0.709790297,0.290209703,0.061052703
Ohio,MADISON,43435,38994,2852,622,4441,0.897755266,0.102244734,0.014320249
Ohio,MAHONING,238823,185230,36400,11136,53593,0.775595315,0.224404685,0.046628675
Ohio,MARION,66501,59733,3754,1503,6768,0.898227094,0.101772906,0.022601164
Ohio,MEDINA,172332,163794,1982,2747,8538,0.950456096,0.049543904,0.015940162
Ohio,MEIGS,23770,23087,202,115,683,0.971266302,0.028733698,0.004838031
Ohio,MERCER,40814,39453,91,614,1361,0.966653599,0.033346401,0.015043857
Ohio,MIAMI,102506,95908,2063,1341,6598,0.935633036,0.064366964,0.013082161
Ohio,MONROE,14642,14326,60,59,316,0.978418249,0.021581751,0.004029504
Ohio,MONTGOMERY,535153,388917,111105,12177,146236,0.72673983,0.27326017,0.02275424
Ohio,MORGAN,15054,13972,428,97,1082,0.928125415,0.071874585,0.00644347
Ohio,MORROW,34827,33772,117,380,1055,0.969707411,0.030292589,0.010911075
Ohio,MUSKINGUM,86074,79600,3214,650,6474,0.92478565,0.07521435,0.007551642
Ohio,NOBLE,14645,14036,368,52,609,0.958415842,0.041584158,0.0035507
Ohio,OTTAWA,41428,38780,302,1755,2648,0.936081877,0.063918123,0.042362653
Ohio,PAULDING,19614,18348,158,838,1266,0.935454267,0.064545733,0.042724584
Ohio,PERRY,36058,35170,92,195,888,0.97537301,0.02462699,0.005407954
Ohio,PICKAWAY,55698,52259,1876,588,3439,0.938256311,0.061743689,0.010556932
Ohio,PIKE,28709,27610,251,207,1099,0.961719321,0.038280679,0.007210282
Ohio,PORTAGE,161419,147527,6611,2073,13892,0.91393826,0.08606174,0.012842354
Ohio,PREBLE,42270,41088,177,254,1182,0.972036906,0.027963094,0.00600899
Ohio,PUTNAM,34499,32246,79,1890,2253,0.934693759,0.065306241,0.054784197
Ohio,RICHLAND,124475,107726,11612,1732,16749,0.86544286,0.13455714,0.013914441
Ohio,ROSS,78064,70378,4804,748,7686,0.901542324,0.098457676,0.009581882
Ohio,SANDUSKY,60944,52527,1624,5435,8417,0.861889604,0.138110396,0.089180231
Ohio,SCIOTO,79499,74531,2107,888,4968,0.937508648,0.062491352,0.011169952
Ohio,SENECA,56745,51739,1227,2524,5006,0.911780774,0.088219226,0.04447969
Ohio,SHELBY,49423,46423,928,661,3000,0.939299516,0.060700484,0.01337434
Ohio,STARK,375586,329497,28272,5965,46089,0.877287758,0.122712242,0.015881849
Ohio,SUMMIT,541781,431624,77373,8660,110157,0.796676148,0.203323852,0.015984318
Ohio,TRUMBULL,210312,185388,17200,2801,24924,0.881490357,0.118509643,0.013318308
Ohio,TUSCARAWAS,92582,88614,696,1767,3968,0.957140697,0.042859303,0.019085783
Ohio,UNION,52300,48169,1202,661,4131,0.921013384,0.078986616,0.012638623
Ohio,VAN WERT,28744,27351,237,740,1393,0.951537712,0.048462288,0.025744503
Ohio,VINTON,13435,13103,37,71,332,0.975288426,0.024711574,0.005284704
Ohio,WARREN,212693,189305,6838,4784,23388,0.890038694,0.109961306,0.022492513
Ohio,WASHINGTON,61778,59281,657,461,2497,0.959581081,0.040418919,0.007462203
Ohio,WAYNE,114520,108450,1689,1800,6070,0.946996158,0.053003842,0.015717779
Ohio,WILLIAMS,37642,35283,358,1390,2359,0.937330641,0.062669359,0.036926837
Ohio,WOOD,125488,113021,2906,5663,12467,0.900651855,0.099348145,0.045127821
Ohio,WYANDOT,22615,21727,42,504,888,0.960734026,0.039265974,0.022286093
Oklahoma,ADAIR,22683,9558,53,1197,13125,0.421372834,0.578627166,0.052770798
Oklahoma,ALFALFA,5642,4923,224,224,719,0.872562921,0.127437079,0.039702233
Oklahoma,ATOKA,14182,10318,527,409,3864,0.727541955,0.272458045,0.028839374
Oklahoma,BEAVER,5636,4313,31,1135,1323,0.765259049,0.234740951,0.20138396
Oklahoma,BECKHAM,22119,17459,842,2619,4660,0.789321398,0.210678602,0.118404991
Oklahoma,BLAINE,11943,7512,298,2873,4431,0.628987692,0.371012308,0.240559323
Oklahoma,BRYAN,42416,31294,640,2107,11122,0.737787627,0.262212373,0.049674651
Oklahoma,CADDO,29600,17618,804,2995,11982,0.595202703,0.404797297,0.101182432
Oklahoma,CANADIAN,115541,92120,2820,7794,23421,0.797292736,0.202707264,0.067456574
Oklahoma,CARTER,47557,34498,3134,2528,13059,0.7254032,0.2745968,0.053157264
Oklahoma,CHEROKEE,46987,23591,582,2952,23396,0.502075042,0.497924958,0.062825888
Oklahoma,CHOCTAW,15205,9693,1654,427,5512,0.637487669,0.362512331,0.028082867
Oklahoma,CIMARRON,2475,1894,6,514,581,0.765252525,0.234747475,0.207676768
Oklahoma,CLEVELAND,255755,193549,10572,17892,62206,0.756775039,0.243224961,0.069957577
Oklahoma,COAL,5925,4329,25,152,1596,0.730632911,0.269367089,0.025654008
Oklahoma,COMANCHE,124098,73122,20794,13896,50976,0.589227868,0.410772132,0.111976019
Oklahoma,COTTON,6193,4905,126,344,1288,0.792023252,0.207976748,0.055546585
Oklahoma,CRAIG,15029,9852,440,370,5177,0.655532637,0.344467363,0.02461907
Oklahoma,CREEK,69967,54821,1528,2152,15146,0.78352652,0.21647348,0.030757357
Oklahoma,CUSTER,27469,20169,794,3830,7300,0.734245877,0.265754123,0.139429903
Oklahoma,DELAWARE,41487,27328,83,1248,14159,0.658712368,0.341287632,0.030081712
Oklahoma,DEWEY,4810,4136,16,231,674,0.85987526,0.14012474,0.048024948
Oklahoma,ELLIS,4151,3759,11,251,392,0.905564924,0.094435076,0.060467357
Oklahoma,GARFIELD,60580,48744,1765,5353,11836,0.804621987,0.195378013,0.088362496
Oklahoma,GARVIN,27576,21791,690,1713,5785,0.79021613,0.20978387,0.062119234
Oklahoma,GRADY,52431,43853,1239,2405,8578,0.836394499,0.163605501,0.04586981
Oklahoma,GRANT,4527,4142,35,158,385,0.914954716,0.085045284,0.034901701
Oklahoma,GREER,6239,4894,438,609,1345,0.78442058,0.21557942,0.097611797
Oklahoma,HARMON,2922,1839,197,756,1083,0.62936345,0.37063655,0.258726899
Oklahoma,HARPER,3685,2957,2,645,728,0.802442334,0.197557666,0.175033921
Oklahoma,HASKELL,12769,9362,51,426,3407,0.733181925,0.266818075,0.033362049
Oklahoma,HUGHES,14003,9351,739,530,4652,0.667785475,0.332214525,0.037849032
Oklahoma,JACKSON,26446,17403,1918,5538,9043,0.658057929,0.341942071,0.20940785
Oklahoma,JEFFERSON,6472,5216,41,552,1256,0.805933251,0.194066749,0.085290482
Oklahoma,JOHNSTON,10957,7854,209,423,3103,0.716802044,0.283197956,0.038605458
Oklahoma,KAY,46562,36113,910,2992,10449,0.775589537,0.224410463,0.064258408
Oklahoma,KINGFISHER,15034,12030,157,2022,3004,0.800186245,0.199813755,0.134495144
Oklahoma,KIOWA,9446,7302,390,832,2144,0.773025619,0.226974381,0.08807961
Oklahoma,LATIMER,11154,7718,80,293,3436,0.691949077,0.308050923,0.026268603
Oklahoma,LE FLORE,50384,36842,1016,3454,13542,0.731224198,0.268775802,0.068553509
Oklahoma,LINCOLN,34273,28985,608,838,5288,0.845709451,0.154290549,0.024450734
Oklahoma,LOGAN,41848,32864,3752,2170,8984,0.785318295,0.214681705,0.05185433
Oklahoma,LOVE,9423,7186,163,1113,2237,0.762602144,0.237397856,0.11811525
Oklahoma,MCCLAIN,34506,27942,229,2400,6564,0.809772214,0.190227786,0.069553121
Oklahoma,MCCURTAIN,33151,21829,2872,1552,11322,0.658471841,0.341528159,0.046816084
Oklahoma,MCINTOSH,20252,14053,642,390,6199,0.693906775,0.306093225,0.019257357
Oklahoma,MAJOR,7527,6629,32,565,898,0.88069616,0.11930384,0.075063106
Oklahoma,MARSHALL,15840,11050,227,2212,4790,0.69760101,0.30239899,0.139646465
Oklahoma,MAYES,41259,27590,161,1097,13669,0.668702586,0.331297414,0.026588138
Oklahoma,MURRAY,13488,10241,176,662,3247,0.759267497,0.240732503,0.049080664
Oklahoma,MUSKOGEE,70990,41362,7960,3688,29628,0.582645443,0.417354557,0.051950979
Oklahoma,NOBLE,11561,9626,202,300,1935,0.832626935,0.167373065,0.025949312
Oklahoma,NOWATA,10536,7148,202,240,3388,0.678435839,0.321564161,0.022779043
Oklahoma,OKFUSKEE,12191,7699,1001,356,4492,0.631531458,0.368468542,0.02920187
Oklahoma,OKLAHOMA,718633,425791,108954,108543,292842,0.592501318,0.407498682,0.151040935
Oklahoma,OKMULGEE,40069,25803,3459,1293,14266,0.643964162,0.356035838,0.032269335
Oklahoma,OSAGE,47472,30709,5355,1366,16763,0.646886586,0.353113414,0.028774857
Oklahoma,OTTAWA,31848,21454,234,1499,10394,0.673637277,0.326362723,0.04706732
Oklahoma,PAWNEE,16577,13216,116,336,3361,0.797249201,0.202750799,0.020269047
Oklahoma,PAYNE,77350,61655,2757,2990,15695,0.797091144,0.202908856,0.038655462
Oklahoma,PITTSBURG,45837,32959,1497,1786,12878,0.719047931,0.280952069,0.038964156
Oklahoma,PONTOTOC,37492,25973,879,1523,11519,0.692761122,0.307238878,0.040621999
Oklahoma,POTTAWATOMIE,69442,51642,1969,2878,17800,0.743670977,0.256329023,0.041444659
Oklahoma,PUSHMATAHA,11572,8550,74,280,3022,0.738852402,0.261147598,0.024196336
Oklahoma,ROGER MILLS,3647,3184,13,165,463,0.873046339,0.126953661,0.045242665
Oklahoma,ROGERS,86905,64030,819,3229,22875,0.736781543,0.263218457,0.037155515
Oklahoma,SEMINOLE,25482,17133,1152,903,8349,0.672356958,0.327643042,0.035436779
Oklahoma,SEQUOYAH,42391,27634,718,1438,14757,0.651883655,0.348116345,0.033922295
Oklahoma,STEPHENS,45048,37173,841,2790,7875,0.825186468,0.174813532,0.061933937
Oklahoma,TEXAS,20640,10889,294,8659,9751,0.527567829,0.472432171,0.419525194
Oklahoma,TILLMAN,7992,5165,567,1783,2827,0.646271271,0.353728729,0.223098098
Oklahoma,TULSA,603403,393401,63737,66582,210002,0.651970574,0.348029426,0.110344165
Oklahoma,WAGONER,73085,53648,2669,3488,19437,0.734049395,0.265950605,0.047725251
Oklahoma,WASHINGTON,50976,38691,1194,2556,12285,0.759004237,0.240995763,0.050141243
Oklahoma,WASHITA,11629,9989,71,944,1640,0.858973257,0.141026743,0.081176369
Oklahoma,WOODS,8878,7684,286,424,1194,0.86551025,0.13448975,0.047758504
Oklahoma,WOODWARD,20081,16632,308,2128,3449,0.828245605,0.171754395,0.105970818
Oregon,BAKER,16134,14944,52,528,1190,0.926242717,0.073757283,0.03272592
Oregon,BENTON,85579,71552,715,5467,14027,0.836092967,0.163907033,0.063882495
Oregon,CLACKAMAS,375992,317648,2761,29138,58344,0.844826486,0.155173514,0.07749633
Oregon,CLATSOP,37039,32295,163,2838,4744,0.871918788,0.128081212,0.076621939
Oregon,COLUMBIA,49351,44563,195,1987,4788,0.902980689,0.097019311,0.040262609
Oregon,COOS,63043,54820,234,3391,8223,0.869565217,0.130434783,0.053788684
Oregon,CROOK,20978,18758,30,1463,2220,0.89417485,0.10582515,0.069739727
Oregon,CURRY,22364,19837,62,1201,2527,0.887005902,0.112994098,0.053702379
Oregon,DESCHUTES,157733,139470,524,11718,18263,0.884215732,0.115784268,0.074290098
Oregon,DOUGLAS,107667,96343,279,5055,11324,0.894823855,0.105176145,0.046950319
Oregon,GILLIAM,1871,1725,3,88,146,0.921966863,0.078033137,0.047033672
Oregon,GRANT,7445,6951,11,207,494,0.933646743,0.066353257,0.027803895
Oregon,HARNEY,7422,6648,16,294,774,0.895715441,0.104284559,0.039611964
Oregon,HOOD RIVER,22346,14714,63,6589,7632,0.658462365,0.341537635,0.294862615
Oregon,JACKSON,203206,170023,1227,21745,33183,0.836702656,0.163297344,0.107009636
Oregon,JEFFERSON,21720,13429,117,4195,8291,0.618278085,0.381721915,0.193139963
Oregon,JOSEPHINE,82713,73289,295,5251,9424,0.886063859,0.113936141,0.063484579
Oregon,KLAMATH,66380,53822,394,6915,12558,0.810816511,0.189183489,0.104172944
Oregon,LAKE,7895,6875,37,545,1020,0.870804307,0.129195693,0.069031032
Oregon,LANE,351715,297808,3102,26167,53907,0.846731018,0.153268982,0.074398305
Oregon,LINCOLN,46034,38863,159,3655,7171,0.844223835,0.155776165,0.079397836
Oregon,LINN,116672,101579,456,9127,15093,0.870637342,0.129362658,0.078227852
Oregon,MALHEUR,31313,19906,331,9867,11407,0.635710408,0.364289592,0.315108741
Oregon,MARION,315335,216758,2906,76594,98577,0.687389602,0.312610398,0.242897236
Oregon,MORROW,11173,7218,36,3497,3955,0.646021659,0.353978341,0.312986664
Oregon,MULTNOMAH,735334,530303,39919,80138,205031,0.721172964,0.278827036,0.108981769
Oregon,POLK,75403,60702,394,9088,14701,0.805034282,0.194965718,0.120525709
Oregon,SHERMAN,1765,1616,2,98,149,0.915580737,0.084419263,0.055524079
Oregon,TILLAMOOK,25250,21902,62,2284,3348,0.867405941,0.132594059,0.090455446
Oregon,UMATILLA,75889,52691,557,18107,23198,0.694316699,0.305683301,0.238598479
Oregon,UNION,25748,23407,126,1002,2341,0.909080317,0.090919683,0.038915644
Oregon,WALLOWA,7008,6625,26,156,383,0.945348174,0.054651826,0.022260274
Oregon,WASCO,25213,19556,85,3743,5657,0.775631619,0.224368381,0.148455162
Oregon,WASHINGTON,529710,369453,8861,83270,160257,0.697462763,0.302537237,0.157199222
Oregon,WHEELER,1441,1307,0,62,134,0.907009022,0.092990978,0.043025677
Oregon,YAMHILL,99193,78448,784,14592,20745,0.790862258,0.209137742,0.147107155
Pennsylvania,ADAMS,101407,91830,1450,6115,9577,0.905558788,0.094441212,0.060301557
Pennsylvania,ALLEGHENY,1223348,986212,159998,19070,237136,0.806158182,0.193841818,0.015588369
Pennsylvania,ARMSTRONG,68941,67326,540,366,1615,0.976574172,0.023425828,0.005308887
Pennsylvania,BEAVER,170539,154196,10586,1998,16343,0.904168548,0.095831452,0.011715795
Pennsylvania,BEDFORD,49762,48535,236,450,1227,0.975342631,0.024657369,0.009043045
Pennsylvania,BERKS,411442,316406,16517,67355,95036,0.769017261,0.230982739,0.163704726
Pennsylvania,BLAIR,127089,121495,2051,1230,5594,0.955983602,0.044016398,0.009678257
Pennsylvania,BRADFORD,62622,60584,269,702,2038,0.967455527,0.032544473,0.011210118
Pennsylvania,BUCKS,625249,543207,21454,26782,82042,0.868785076,0.131214924,0.042834135
Pennsylvania,BUTLER,183862,176259,1954,1941,7603,0.958648334,0.041351666,0.010556831
Pennsylvania,CAMBRIA,143679,134073,5073,2006,9606,0.93314263,0.06685737,0.013961678
Pennsylvania,CAMERON,5085,4985,12,19,100,0.980334317,0.019665683,0.00373648
Pennsylvania,CARBON,65249,61168,888,2145,4081,0.93745498,0.06254502,0.032874067
Pennsylvania,CENTRE,153990,135427,4456,3690,18563,0.879453211,0.120546789,0.023962595
Pennsylvania,CHESTER,498886,409561,29388,32503,89325,0.820951079,0.179048921,0.065151157
Pennsylvania,CLARION,39988,38724,468,245,1264,0.968390517,0.031609483,0.006126838
Pennsylvania,CLEARFIELD,81642,77031,1697,1907,4611,0.943521717,0.056478283,0.023358076
Pennsylvania,CLINTON,39238,37618,612,437,1620,0.958713492,0.041286508,0.011137163
Pennsylvania,COLUMBIA,67295,63500,1190,1349,3795,0.943606509,0.056393491,0.020046066
Pennsylvania,CRAWFORD,88765,84930,1503,823,3835,0.956796034,0.043203966,0.009271672
Pennsylvania,CUMBERLAND,235406,210514,7237,6448,24892,0.89425928,0.10574072,0.027390976
Pennsylvania,DAUPHIN,268100,187402,46320,18795,80698,0.699000373,0.300999627,0.070104439
Pennsylvania,DELAWARE,558979,397424,108231,16537,161555,0.710981987,0.289018013,0.029584296
Pennsylvania,ELK,31946,31345,85,183,601,0.981187003,0.018812997,0.005728417
Pennsylvania,ERIE,280566,242787,19485,9518,37779,0.865347191,0.134652809,0.033924282
Pennsylvania,FAYETTE,136606,126888,6270,1049,9718,0.928861104,0.071138896,0.007679018
Pennsylvania,FOREST,7716,5850,1374,418,1866,0.758164852,0.241835148,0.054173147
Pennsylvania,FRANKLIN,149618,135004,4348,6438,14614,0.902324587,0.097675413,0.043029582
Pennsylvania,FULTON,14845,14387,144,123,458,0.969147861,0.030852139,0.008285618
Pennsylvania,GREENE,38686,36409,1272,465,2277,0.941141498,0.058858502,0.012019852
Pennsylvania,HUNTINGDON,45913,42197,2369,727,3716,0.919064317,0.080935683,0.015834295
Pennsylvania,INDIANA,88880,83864,2374,947,5016,0.943564356,0.056435644,0.010654815
Pennsylvania,JEFFERSON,45200,44264,147,275,936,0.979292035,0.020707965,0.006084071
Pennsylvania,JUNIATA,24636,23584,134,623,1052,0.957298263,0.042701737,0.025288196
Pennsylvania,LACKAWANNA,214437,192250,4794,10682,22187,0.896533714,0.103466286,0.049814165
Pennsylvania,LANCASTER,519445,440969,16087,44930,78476,0.84892337,0.15107663,0.086496164
Pennsylvania,LAWRENCE,91108,84872,3448,931,6236,0.93155376,0.06844624,0.010218642
Pennsylvania,LEBANON,133568,116010,2134,12410,17558,0.868546358,0.131453642,0.092911476
Pennsylvania,LEHIGH,349497,250245,17230,65615,99252,0.71601473,0.28398527,0.18774124
Pennsylvania,LUZERNE,320918,283058,9539,21491,37860,0.882025938,0.117974062,0.066967263
Pennsylvania,LYCOMING,116111,106710,5060,1559,9401,0.919034372,0.080965628,0.013426807
Pennsylvania,MCKEAN,43450,41039,1008,757,2411,0.944510932,0.055489068,0.017422325
Pennsylvania,MERCER,116638,106176,6620,1248,10462,0.910303675,0.089696325,0.010699772
Pennsylvania,MIFFLIN,46682,45199,282,534,1483,0.968231867,0.031768133,0.011439099
Pennsylvania,MONROE,169842,119741,20461,22288,50101,0.705014072,0.294985928,0.131227847
Pennsylvania,MONTGOMERY,799874,631784,67582,34233,168090,0.789854402,0.210145598,0.042797991
Pennsylvania,MONTOUR,18267,17206,237,324,1061,0.941917118,0.058082882,0.017736903
Pennsylvania,NORTHAMPTON,297735,241163,13207,31179,56572,0.809992107,0.190007893,0.104720641
Pennsylvania,NORTHUMBERLAND,94528,89166,1814,2253,5362,0.943276066,0.056723934,0.023834208
Pennsylvania,PERRY,45969,44427,284,588,1542,0.966455655,0.033544345,0.012791229
Pennsylvania,PHILADELPHIA,1526006,562585,644287,187611,963421,0.368664999,0.631335001,0.122942505
Pennsylvania,PIKE,57369,47549,3050,5173,9820,0.828827416,0.171172584,0.09017065
Pennsylvania,POTTER,17457,17000,61,181,457,0.97382139,0.02617861,0.010368334
Pennsylvania,SCHUYLKILL,148289,138248,3841,4080,10041,0.932287628,0.067712372,0.027513841
Pennsylvania,SNYDER,39702,38127,375,657,1575,0.960329454,0.039670546,0.016548285
Pennsylvania,SOMERSET,77742,74265,1856,840,3477,0.955275141,0.044724859,0.01080497
Pennsylvania,SULLIVAN,6428,6089,163,92,339,0.947261979,0.052738021,0.014312383
Pennsylvania,SUSQUEHANNA,43356,42117,150,564,1239,0.97142264,0.02857736,0.01300858
Pennsylvania,TIOGA,41981,40560,322,437,1421,0.966151354,0.033848646,0.010409471
Pennsylvania,UNION,44947,38311,3048,2346,6636,0.852359446,0.147640554,0.052194807
Pennsylvania,VENANGO,54984,53052,567,478,1932,0.964862505,0.035137495,0.008693438
Pennsylvania,WARREN,41815,40827,136,305,988,0.976372115,0.023627885,0.007294033
Pennsylvania,WASHINGTON,207820,194171,6650,2366,13649,0.934322972,0.065677028,0.011384852
Pennsylvania,WAYNE,52822,48590,1563,1816,4232,0.919881867,0.080118133,0.034379615
Pennsylvania,WESTMORELAND,365169,346111,8425,3179,19058,0.947810466,0.052189534,0.008705558
Pennsylvania,WYOMING,28276,27270,185,437,1006,0.964422125,0.035577875,0.015454803
Pennsylvania,YORK,434972,374779,22493,24397,60193,0.86161638,0.13838362,0.056088668
Rhode Island,BRISTOL,49875,47052,363,989,2823,0.943398496,0.056601504,0.019829574
Rhode Island,KENT,166158,152141,2157,5309,14017,0.915640535,0.084359465,0.031951516
Rhode Island,NEWPORT,82888,72836,2645,3512,10052,0.878727922,0.121272078,0.042370428
Rhode Island,PROVIDENCE,626667,414326,45048,117819,212341,0.661158159,0.338841841,0.188008943
Rhode Island,WASHINGTON,126979,117330,1347,3026,9649,0.924011057,0.075988943,0.023830712
South Carolina,ABBEVILLE,25417,17564,7160,255,7853,0.69103356,0.30896644,0.010032655
South Carolina,AIKEN,160099,108566,39043,7824,51533,0.678117915,0.321882085,0.048869762
South Carolina,ALLENDALE,10419,2410,7645,239,8009,0.231308187,0.768691813,0.022938862
South Carolina,ANDERSON,187126,147362,29810,5447,39764,0.78750147,0.21249853,0.029108729
South Carolina,BAMBERG,15987,5691,9786,258,10296,0.355976731,0.644023269,0.016138112
South Carolina,BARNWELL,22621,11715,9964,411,10906,0.517881614,0.482118386,0.018168958
South Carolina,BEAUFORT,162233,107279,30662,19567,54954,0.661264971,0.338735029,0.12061048
South Carolina,BERKELEY,177843,113553,44023,10755,64290,0.638501375,0.361498625,0.060474688
South Carolina,CALHOUN,15175,8059,6420,458,7116,0.53107084,0.46892916,0.030181219
South Carolina,CHARLESTON,350209,217260,103479,18877,132949,0.620372406,0.379627594,0.053902098
South Carolina,CHEROKEE,55342,40939,11214,2032,14403,0.739745582,0.260254418,0.036717141
South Carolina,CHESTER,33140,19590,12349,479,13550,0.591128546,0.408871454,0.014453832
South Carolina,CHESTERFIELD,46734,28790,15179,1666,17944,0.616039714,0.383960286,0.035648564
South Carolina,CLARENDON,34971,16160,17379,899,18811,0.462097166,0.537902834,0.025707014
South Carolina,COLLETON,38892,21736,15109,1094,17156,0.558881004,0.441118996,0.028129178
South Carolina,DARLINGTON,68681,37993,28463,1140,30688,0.553180647,0.446819353,0.016598477
South Carolina,DILLON,32062,15152,14730,833,16910,0.472584368,0.527415632,0.025980912
South Carolina,DORCHESTER,136555,89427,34861,6075,47128,0.654878986,0.345121014,0.044487569
South Carolina,EDGEFIELD,26985,15196,9951,1414,11789,0.563127664,0.436872336,0.052399481
South Carolina,FAIRFIELD,23956,9098,14112,374,14858,0.379779596,0.620220404,0.015611955
South Carolina,FLORENCE,136885,74105,56204,3030,62780,0.541366841,0.458633159,0.022135369
South Carolina,GEORGETOWN,60158,37311,20128,1867,22847,0.620216763,0.379783237,0.031034941
South Carolina,GREENVILLE,451225,317197,80569,36495,134028,0.702968586,0.297031414,0.080879827
South Carolina,GREENWOOD,69661,42709,21728,3789,26952,0.613097716,0.386902284,0.054391984
South Carolina,HAMPTON,21090,8699,11264,744,12391,0.412470365,0.587529635,0.035277383
South Carolina,HORRY,269291,208096,35753,16683,61195,0.772755124,0.227244876,0.061951569
South Carolina,JASPER,24777,9263,11303,3752,15514,0.373854785,0.626145215,0.151430762
South Carolina,KERSHAW,61697,43009,15057,2298,18688,0.697100345,0.302899655,0.037246544
South Carolina,LANCASTER,76652,53490,18162,3384,23162,0.69782915,0.30217085,0.044147576
South Carolina,LAURENS,66537,45900,16808,2729,20637,0.689841742,0.310158258,0.041014774
South Carolina,LEE,19220,6322,12315,334,12898,0.3289282,0.6710718,0.017377732
South Carolina,LEXINGTON,262391,201946,36995,14529,60445,0.769637678,0.230362322,0.055371564
South Carolina,MCCORMICK,10233,4941,5069,81,5292,0.482849604,0.517150396,0.007915567
South Carolina,MARION,33062,13230,18365,791,19832,0.40015728,0.59984272,0.023924747
South Carolina,MARLBORO,28933,11657,14652,800,17276,0.402896347,0.597103653,0.027650088
South Carolina,NEWBERRY,37508,22690,11533,2690,14818,0.604937613,0.395062387,0.071718033
South Carolina,OCONEE,74273,63807,5550,3349,10466,0.859087421,0.140912579,0.04509041
South Carolina,ORANGEBURG,92501,31206,57286,1767,61295,0.337358515,0.662641485,0.019102496
South Carolina,PICKENS,119224,103958,7792,3743,15266,0.871955311,0.128044689,0.031394686
South Carolina,RICHLAND,384504,174267,174549,18637,210237,0.453225454,0.546774546,0.048470237
South Carolina,SALUDA,19875,11548,5196,2857,8327,0.581031447,0.418968553,0.143748428
South Carolina,SPARTANBURG,284307,199184,58115,16658,85123,0.70059478,0.29940522,0.058591593
South Carolina,SUMTER,107456,50423,50110,3532,57033,0.469243225,0.530756775,0.032869267
South Carolina,UNION,28961,19146,9022,282,9815,0.661095957,0.338904043,0.009737233
South Carolina,WILLIAMSBURG,34423,10725,22526,689,23698,0.311564942,0.688435058,0.020015687
South Carolina,YORK,226073,164371,42608,10075,61702,0.72707046,0.27292954,0.044565251
South Dakota,AURORA,2710,2531,9,101,179,0.933948339,0.066051661,0.037269373
South Dakota,BEADLE,17398,14934,118,1337,2464,0.858374526,0.141625474,0.076847914
South Dakota,BENNETT,3431,1141,3,67,2290,0.332556106,0.667443894,0.019527834
South Dakota,BON HOMME,7070,6285,65,130,785,0.888967468,0.111032532,0.018387553
South Dakota,BROOKINGS,31965,29513,246,636,2452,0.9232911,0.0767089,0.019896762
South Dakota,BROWN,36531,33825,187,496,2706,0.925925926,0.074074074,0.01357751
South Dakota,BRULE,5255,4615,12,75,640,0.878211227,0.121788773,0.014272122
South Dakota,BUFFALO,1912,283,4,35,1629,0.148012552,0.851987448,0.018305439
South Dakota,BUTTE,10110,9360,20,306,750,0.925816024,0.074183976,0.030267062
South Dakota,CAMPBELL,1466,1430,1,20,36,0.975443383,0.024556617,0.013642565
South Dakota,CHARLES MIX,9129,5899,8,152,3230,0.646182495,0.353817505,0.016650236
South Dakota,CLARK,3691,3596,6,63,95,0.974261718,0.025738282,0.017068545
South Dakota,CLAY,13864,12484,179,277,1380,0.900461627,0.099538373,0.019979804
South Dakota,CODINGTON,27227,25762,88,433,1465,0.946193117,0.053806883,0.015903331
South Dakota,CORSON,4050,1202,3,106,2848,0.296790123,0.703209877,0.02617284
South Dakota,CUSTER,8216,7624,15,182,592,0.927945472,0.072054528,0.022151899
South Dakota,DAVISON,19504,18296,71,294,1208,0.938063987,0.061936013,0.015073831
South Dakota,DAY,5710,5004,8,62,706,0.876357268,0.123642732,0.010858144
South Dakota,DEUEL,4364,4220,12,86,144,0.96700275,0.03299725,0.019706691
South Dakota,DEWEY,5301,1108,5,98,4193,0.209017167,0.790982833,0.018487078
South Dakota,DOUGLAS,3002,2891,11,23,111,0.96302465,0.03697535,0.007661559
South Dakota,EDMUNDS,4071,3949,5,58,122,0.970031933,0.029968067,0.014247114
South Dakota,FALL RIVER,7094,6199,46,159,895,0.873837045,0.126162955,0.022413307
South Dakota,FAULK,2364,2323,3,18,41,0.982656514,0.017343486,0.007614213
South Dakota,GRANT,7356,7072,10,168,284,0.961392061,0.038607939,0.022838499
South Dakota,GREGORY,4271,3818,6,38,453,0.893935846,0.106064154,0.008897214
South Dakota,HAAKON,1937,1823,2,17,114,0.941146102,0.058853898,0.008776458
South Dakota,HAMLIN,5903,5679,10,149,224,0.962053193,0.037946807,0.025241403
South Dakota,HAND,3431,3368,3,19,63,0.981638006,0.018361994,0.005537744
South Dakota,HANSON,3331,3279,0,15,52,0.984389072,0.015610928,0.004503152
South Dakota,HARDING,1255,1197,1,20,58,0.953784861,0.046215139,0.015936255
South Dakota,HUGHES,17022,14471,84,306,2551,0.850135119,0.149864881,0.017976736
South Dakota,HUTCHINSON,7343,7090,28,120,253,0.965545417,0.034454583,0.016342095
South Dakota,HYDE,1420,1263,1,15,157,0.88943662,0.11056338,0.01056338
South Dakota,JACKSON,3031,1292,5,38,1739,0.42626196,0.57373804,0.012537116
South Dakota,JERAULD,2071,1960,1,84,111,0.946402704,0.053597296,0.040560116
South Dakota,JONES,1006,949,1,13,57,0.94333996,0.05666004,0.012922465
South Dakota,KINGSBURY,5148,4987,7,72,161,0.968725719,0.031274281,0.013986014
South Dakota,LAKE,11200,10708,55,175,492,0.956071429,0.043928571,0.015625
South Dakota,LAWRENCE,24097,22349,87,612,1748,0.92745985,0.07254015,0.025397352
South Dakota,LINCOLN,44828,42700,315,553,2128,0.952529669,0.047470331,0.01233604
South Dakota,LYMAN,3755,2181,3,42,1574,0.580825566,0.419174434,0.011185087
South Dakota,MCCOOK,5618,5451,8,99,167,0.970274119,0.029725881,0.01762193
South Dakota,MCPHERSON,2459,2405,1,25,54,0.978039854,0.021960146,0.010166734
South Dakota,MARSHALL,4656,3938,5,317,718,0.845790378,0.154209622,0.068084192
South Dakota,MEADE,25434,22951,307,773,2483,0.902374774,0.097625226,0.030392388
South Dakota,MELLETTE,2048,805,2,30,1243,0.393066406,0.606933594,0.014648438
South Dakota,MINER,2389,2320,3,31,69,0.971117622,0.028882378,0.012976141
South Dakota,MINNEHAHA,169468,146159,6326,6982,23309,0.862457809,0.137542191,0.041199518
South Dakota,MOODY,6486,5227,33,111,1259,0.805889608,0.194110392,0.017113784
South Dakota,PENNINGTON,100948,82438,1013,4044,18510,0.816638269,0.183361731,0.040060229
South Dakota,PERKINS,2982,2883,2,20,99,0.966800805,0.033199195,0.006706908
South Dakota,POTTER,2329,2260,3,17,69,0.970373551,0.029626449,0.00729927
South Dakota,ROBERTS,10149,6238,11,126,3911,0.614641837,0.385358163,0.012415016
South Dakota,SANBORN,2355,2296,0,28,59,0.974946921,0.025053079,0.011889597
South Dakota,SHANNON,13586,381,4,298,13205,0.028043574,0.971956426,0.021934344
South Dakota,SPINK,6415,6194,17,71,221,0.965549493,0.034450507,0.01106781
South Dakota,STANLEY,2966,2656,9,21,310,0.895482131,0.104517869,0.007080243
South Dakota,SULLY,1373,1323,1,12,50,0.963583394,0.036416606,0.008739985
South Dakota,TODD,9612,913,16,227,8699,0.094985435,0.905014565,0.023616313
South Dakota,TRIPP,5644,4676,6,60,968,0.828490432,0.171509568,0.010630758
South Dakota,TURNER,8347,8078,20,112,269,0.967772853,0.032227147,0.013417994
South Dakota,UNION,14399,13608,89,305,791,0.94506563,0.05493437,0.021182027
South Dakota,WALWORTH,5438,4472,6,39,966,0.822361162,0.177638838,0.007171754
South Dakota,YANKTON,22438,20563,327,614,1875,0.916436403,0.083563597,0.027364293
South Dakota,ZIEBACH,2801,607,6,87,2194,0.216708318,0.783291682,0.031060336
Tennessee,ANDERSON,75129,68134,2817,1768,6995,0.906893477,0.093106523,0.023532857
Tennessee,BEDFORD,45058,35389,3437,5083,9669,0.785409916,0.214590084,0.112810156
Tennessee,BENTON,16489,15563,321,291,926,0.943841349,0.056158651,0.017648129
Tennessee,BLEDSOE,12876,11936,469,255,940,0.926995961,0.073004039,0.019804287
Tennessee,BLOUNT,123010,113240,3314,3441,9770,0.920575563,0.079424437,0.027973336
Tennessee,BRADLEY,98963,87589,4116,4664,11374,0.885068157,0.114931843,0.047128725
Tennessee,CAMPBELL,40716,39510,117,472,1206,0.970380195,0.029619805,0.011592494
Tennessee,CANNON,13801,13190,167,210,611,0.955727846,0.044272154,0.015216289
Tennessee,CARROLL,28522,24455,2851,595,4067,0.857408316,0.142591684,0.02086109
Tennessee,CARTER,57424,54849,743,890,2575,0.955158122,0.044841878,0.015498746
Tennessee,CHEATHAM,39105,36914,552,910,2191,0.943971359,0.056028641,0.023270681
Tennessee,CHESTER,17131,14837,1561,343,2294,0.866090713,0.133909287,0.020022182
Tennessee,CLAIBORNE,32213,31051,280,265,1162,0.963927607,0.036072393,0.008226492
Tennessee,CLAY,7861,7524,100,126,337,0.957130136,0.042869864,0.016028495
Tennessee,COCKE,35662,33598,659,628,2064,0.942123268,0.057876732,0.017609781
Tennessee,COFFEE,52796,47539,1820,2007,5257,0.900428063,0.099571937,0.038014244
Tennessee,CROCKETT,14586,11253,1837,1274,3333,0.771493213,0.228506787,0.087344029
Tennessee,CUMBERLAND,56053,53712,146,1307,2341,0.958235955,0.041764045,0.023317218
Tennessee,DAVIDSON,626681,359883,172075,61117,266798,0.574268248,0.425731752,0.097524897
Tennessee,DECATUR,11757,10947,337,308,810,0.931104874,0.068895126,0.026197159
Tennessee,DEKALB,18723,16980,233,1239,1743,0.906905945,0.093094055,0.066175292
Tennessee,DICKSON,49666,44880,2035,1573,4786,0.90363629,0.09636371,0.031671566
Tennessee,DYER,38335,31044,5433,1002,7291,0.809808269,0.190191731,0.026137994
Tennessee,FAYETTE,38413,26193,10742,858,12220,0.681878531,0.318121469,0.022336188
Tennessee,FENTRESS,17959,17522,26,189,437,0.975666797,0.024333203,0.010523971
Tennessee,FRANKLIN,41052,36839,2086,1029,4213,0.897374062,0.102625938,0.02506577
Tennessee,GIBSON,49683,38571,9307,1012,11112,0.776342008,0.223657992,0.02036914
Tennessee,GILES,29485,25221,3006,471,4264,0.855384094,0.144615906,0.015974224
Tennessee,GRAINGER,22657,21753,101,530,904,0.960100631,0.039899369,0.023392329
Tennessee,GREENE,68831,64637,1355,1690,4194,0.939068152,0.060931848,0.02455289
Tennessee,GRUNDY,13703,13321,36,113,382,0.972122893,0.027877107,0.008246369
Tennessee,HAMBLEN,62544,51846,2394,6711,10698,0.828952417,0.171047583,0.10730046
Tennessee,HAMILTON,336463,242154,67483,14993,94309,0.719704693,0.280295307,0.04456062
Tennessee,HANCOCK,6819,6673,24,13,146,0.978589236,0.021410764,0.001906438
Tennessee,HARDEMAN,27253,15197,11228,376,12056,0.557626683,0.442373317,0.013796646
Tennessee,HARDIN,26026,24110,888,497,1916,0.926381311,0.073618689,0.019096288
Tennessee,HAWKINS,56833,54453,735,669,2380,0.958122922,0.041877078,0.01177133
Tennessee,HAYWOOD,18787,8419,9431,723,10368,0.448129025,0.551870975,0.038484058
Tennessee,HENDERSON,27769,24482,2169,532,3287,0.881630595,0.118369405,0.019158054
Tennessee,HENRY,32330,28522,2578,553,3808,0.882214661,0.117785339,0.017104856
Tennessee,HICKMAN,24690,22657,1102,455,2033,0.917658971,0.082341029,0.018428514
Tennessee,HOUSTON,8426,7931,190,129,495,0.941253264,0.058746736,0.015309756
Tennessee,HUMPHREYS,18538,17498,455,278,1040,0.943899018,0.056100982,0.014996224
Tennessee,JACKSON,11638,11267,29,164,371,0.96812167,0.03187833,0.014091768
Tennessee,JEFFERSON,51407,47738,1031,1619,3669,0.928628397,0.071371603,0.031493765
Tennessee,JOHNSON,18244,17373,373,269,871,0.952258277,0.047741723,0.014744574
Tennessee,KNOX,432226,362580,37648,15012,69646,0.838866704,0.161133296,0.03473183
Tennessee,LAKE,7832,5409,2162,136,2423,0.690628192,0.309371808,0.017364658
Tennessee,LAUDERDALE,27815,17035,9676,564,10780,0.612439331,0.387560669,0.020276829
Tennessee,LAWRENCE,41869,39690,637,689,2179,0.947956722,0.052043278,0.016456089
Tennessee,LEWIS,12161,11507,198,221,654,0.946221528,0.053778472,0.018172848
Tennessee,LINCOLN,33361,29402,2256,885,3959,0.881328497,0.118671503,0.026527982
Tennessee,LOUDON,48556,43776,517,3395,4780,0.901556965,0.098443035,0.069919268
Tennessee,MCMINN,52266,47273,2021,1482,4993,0.904469445,0.095530555,0.028354954
Tennessee,MCNAIRY,26075,23716,1541,396,2359,0.909530201,0.090469799,0.015186961
Tennessee,MACON,22248,20961,79,919,1287,0.942152104,0.057847896,0.041307084
Tennessee,MADISON,98294,57060,35530,3306,41234,0.580503388,0.419496612,0.033633793
Tennessee,MARION,28237,26328,1007,361,1909,0.932393668,0.067606332,0.012784644
Tennessee,MARSHALL,30617,26565,1985,1386,4052,0.867655224,0.132344776,0.045268968
Tennessee,MAURY,80956,64919,10076,3909,16037,0.801904738,0.198095262,0.048285488
Tennessee,MEIGS,11753,11261,116,176,492,0.958138348,0.041861652,0.0149749
Tennessee,MONROE,44519,41146,900,1448,3373,0.924234596,0.075765404,0.032525439
Tennessee,MONTGOMERY,172331,115553,32003,13752,56778,0.670529388,0.329470612,0.07979992
Tennessee,MOORE,6362,6037,145,70,325,0.948915435,0.051084565,0.011002829
Tennessee,MORGAN,21987,20638,803,188,1349,0.938645563,0.061354437,0.008550507
Tennessee,OBION,31807,26988,3353,999,4819,0.84849247,0.15150753,0.031408181
Tennessee,OVERTON,22083,21452,86,202,631,0.971425984,0.028574016,0.009147308
Tennessee,PERRY,7915,7502,116,131,413,0.947820594,0.052179406,0.016550853
Tennessee,PICKETT,5077,4964,5,67,113,0.977742761,0.022257239,0.01319677
Tennessee,POLK,16825,16262,50,233,563,0.96653789,0.03346211,0.01384844
Tennessee,PUTNAM,72321,65052,1421,3858,7269,0.899489775,0.100510225,0.053345501
Tennessee,RHEA,31809,29303,609,1187,2506,0.921217266,0.078782734,0.037316483
Tennessee,ROANE,54181,50752,1430,710,3429,0.936712132,0.063287868,0.013104225
Tennessee,ROBERTSON,66283,56159,4877,3903,10124,0.847260987,0.152739013,0.058883877
Tennessee,RUTHERFORD,262604,198483,32534,17500,64121,0.755826263,0.244173737,0.066640264
Tennessee,SCOTT,22228,21795,19,120,433,0.980520065,0.019479935,0.005398596
Tennessee,SEQUATCHIE,14112,13402,19,462,710,0.949688209,0.050311791,0.032738095
Tennessee,SEVIER,89889,82374,640,4787,7515,0.916396889,0.083603111,0.05325457
Tennessee,SHELBY,927644,359106,481431,52092,568538,0.387116178,0.612883822,0.056155163
Tennessee,SMITH,19166,18002,405,417,1164,0.939267453,0.060732547,0.021757279
Tennessee,STEWART,13324,12469,187,250,855,0.935830081,0.064169919,0.018763134
Tennessee,SULLIVAN,156823,148033,3272,2321,8790,0.943949548,0.056050452,0.014800125
Tennessee,SUMNER,160645,139693,10213,6308,20952,0.869575773,0.130424227,0.039266706
Tennessee,TIPTON,61081,46831,11393,1269,14250,0.76670323,0.23329677,0.020775691
Tennessee,TROUSDALE,7870,6761,748,198,1109,0.859085133,0.140914867,0.025158831
Tennessee,UNICOI,18313,17348,35,694,965,0.947305193,0.052694807,0.037896576
Tennessee,UNION,19109,18539,21,249,570,0.970171124,0.029828876,0.013030509
Tennessee,VAN BUREN,5548,5408,22,50,140,0.974765681,0.025234319,0.009012257
Tennessee,WARREN,39839,34739,1085,3224,5100,0.871984739,0.128015261,0.080925726
Tennessee,WASHINGTON,122979,110902,4727,3633,12077,0.901796242,0.098203758,0.029541629
Tennessee,WAYNE,17021,15535,975,277,1486,0.912696081,0.087303919,0.016274014
Tennessee,WEAKLEY,35021,30696,2717,700,4325,0.87650267,0.12349733,0.019988007
Tennessee,WHITE,25841,24496,450,425,1345,0.947950931,0.052049069,0.016446732
Tennessee,WILLIAMSON,183182,158769,7828,8166,24413,0.866728172,0.133271828,0.044578616
Tennessee,WILSON,113993,99717,7234,3691,14276,0.87476424,0.12523576,0.032379181
Texas,ANDERSON,58458,35792,12222,9287,22666,0.612268637,0.387731363,0.158866195
Texas,ANDREWS,14786,7083,199,7195,7703,0.479034222,0.520965778,0.486608954
Texas,ANGELINA,86771,54889,12840,17145,31882,0.632573095,0.367426905,0.197589056
Texas,ARANSAS,23158,16350,258,5690,6808,0.706019518,0.293980482,0.245703429
Texas,ARCHER,9054,8182,34,675,872,0.903688977,0.096311023,0.074552684
Texas,ARMSTRONG,1901,1725,11,124,176,0.907417149,0.092582851,0.065228827
Texas,ATASCOSA,44911,16295,256,27785,28616,0.362828706,0.637171294,0.618668032
Texas,AUSTIN,28417,18657,2622,6641,9760,0.656543618,0.343456382,0.233698138
Texas,BAILEY,7165,2745,67,4283,4420,0.383112352,0.616887648,0.597766923
Texas,BANDERA,20485,16576,90,3415,3909,0.809177447,0.190822553,0.166707347
Texas,BASTROP,74171,42446,5535,24190,31725,0.572272182,0.427727818,0.326138248
Texas,BAYLOR,3726,3147,71,455,579,0.844605475,0.155394525,0.122114868
Texas,BEE,31861,10967,2525,17906,20894,0.344213929,0.655786071,0.562003704
Texas,BELL,310235,157289,63380,67010,152946,0.506999533,0.493000467,0.21599755
Texas,BEXAR,1714773,519123,118460,1006958,1195650,0.302735697,0.697264303,0.587225248
Texas,BLANCO,10497,8336,62,1909,2161,0.794131657,0.205868343,0.181861484
Texas,BORDEN,641,539,0,95,102,0.840873635,0.159126365,0.148205928
Texas,BOSQUE,18212,14701,277,2926,3511,0.807215023,0.192784977,0.160663299
Texas,BOWIE,92565,61343,22230,6062,31222,0.662701885,0.337298115,0.065489116
Texas,BRAZORIA,313166,166674,36880,86643,146492,0.532222527,0.467777473,0.276667965
Texas,BRAZOS,194851,115252,20827,45405,79599,0.591487855,0.408512145,0.233024208
Texas,BREWSTER,9232,5011,79,3918,4221,0.542785962,0.457214038,0.424393414
Texas,BRISCOE,1637,1163,40,411,474,0.710445938,0.289554062,0.251069029
Texas,BROOKS,7223,573,19,6590,6650,0.079329918,0.920670082,0.912363284
Texas,BROWN,38106,28478,1303,7453,9628,0.747336377,0.252663623,0.195585997
Texas,BURLESON,17187,11696,2064,3166,5491,0.680514342,0.319485658,0.184208995
Texas,BURNET,42750,32530,700,8652,10220,0.760935673,0.239064327,0.202385965
Texas,CALDWELL,38066,16841,2456,17922,21225,0.442415804,0.557584196,0.47081385
Texas,CALHOUN,21381,9794,519,9922,11587,0.458070249,0.541929751,0.464056873
Texas,CALLAHAN,13544,12065,135,1025,1479,0.890800354,0.109199646,0.075679268
Texas,CAMERON,406220,43427,1192,357747,362793,0.106905125,0.893094875,0.880673034
Texas,CAMP,12401,7298,2133,2648,5103,0.588500927,0.411499073,0.213531167
Texas,CARSON,6182,5473,35,525,709,0.885312197,0.114687803,0.084923973
Texas,CASS,30464,23522,5299,1053,6942,0.772124475,0.227875525,0.034565389
Texas,CASTRO,8062,3004,149,4828,5058,0.372612255,0.627387745,0.598858844
Texas,CHAMBERS,35096,24767,2817,6635,10329,0.705692956,0.294307044,0.189052884
Texas,CHEROKEE,50845,31892,7401,10499,18953,0.62723965,0.37276035,0.206490314
Texas,CHILDRESS,7041,4327,684,1885,2714,0.614543389,0.385456611,0.267717654
Texas,CLAY,10752,9941,53,467,811,0.924572173,0.075427827,0.04343378
Texas,COCHRAN,3127,1329,110,1654,1798,0.425007995,0.574992005,0.528941477
Texas,COKE,3320,2651,7,602,669,0.798493976,0.201506024,0.181325301
Texas,COLEMAN,8895,7123,186,1419,1772,0.800786959,0.199213041,0.159527825
Texas,COLLIN,782341,493492,64715,115354,288849,0.630788876,0.369211124,0.147447213
Texas,COLLINGSWORTH,3057,1937,122,916,1120,0.63362774,0.36637226,0.29964017
Texas,COLORADO,20874,12496,2636,5452,8378,0.598639456,0.401360544,0.261186165
Texas,COMAL,108472,77387,1606,26989,31085,0.71342835,0.28657165,0.248810753
Texas,COMANCHE,13974,10145,25,3605,3829,0.725991126,0.274008874,0.257979104
Texas,CONCHO,4087,1810,57,2173,2277,0.442867629,0.557132371,0.531685833
Texas,COOKE,38437,30255,1018,5997,8182,0.78713219,0.21286781,0.156021542
Texas,CORYELL,75388,46776,11450,11973,28612,0.620470101,0.379529899,0.15881838
Texas,COTTLE,1505,1043,129,316,462,0.693023256,0.306976744,0.209966777
Texas,CRANE,4375,1761,122,2409,2614,0.402514286,0.597485714,0.550628571
Texas,CROCKETT,3719,1312,13,2352,2407,0.352783006,0.647216994,0.632428072
Texas,CROSBY,6059,2625,199,3171,3434,0.433239809,0.566760191,0.523353689
Texas,CULBERSON,2398,504,8,1827,1894,0.210175146,0.789824854,0.761884904
Texas,DALLAM,6703,3726,81,2717,2977,0.555870506,0.444129494,0.405340892
Texas,DALLAS,2368139,784693,518732,905940,1583446,0.331354283,0.668645717,0.382553558
Texas,DAWSON,13833,5402,860,7387,8431,0.390515434,0.609484566,0.534012868
Texas,DEAF SMITH,19372,5939,158,13039,13433,0.306576502,0.693423498,0.673084865
Texas,DELTA,5231,4351,375,288,880,0.831772128,0.168227872,0.055056395
Texas,DENTON,662614,426887,54034,120836,235727,0.644246877,0.355753123,0.182362582
Texas,DEWITT,20097,11482,1781,6502,8615,0.571329054,0.428670946,0.323530875
Texas,DICKENS,2444,1590,92,708,854,0.650572831,0.349427169,0.289689034
Texas,DIMMIT,9996,1217,81,8616,8779,0.121748699,0.878251301,0.861944778
Texas,DONLEY,3677,3136,163,309,541,0.852869187,0.147130813,0.084035899
Texas,DUVAL,11782,1206,86,10424,10576,0.102359531,0.897640469,0.884739433
Texas,EASTLAND,18583,15271,318,2673,3312,0.821772588,0.178227412,0.143841145
Texas,ECTOR,137130,56306,5596,72331,80824,0.410603077,0.589396923,0.527462991
Texas,EDWARDS,2002,947,10,1027,1055,0.473026973,0.526973027,0.512987013
Texas,ELLIS,149610,97987,13161,35161,51623,0.654949535,0.345050465,0.235017713
Texas,EL PASO,800647,105246,20649,658134,695401,0.131451189,0.868548811,0.822002705
Texas,ERATH,37890,29382,431,7279,8508,0.775455265,0.224544735,0.192108736
Texas,FALLS,17866,9381,4463,3716,8485,0.525075563,0.474924437,0.207992836
Texas,FANNIN,33915,27433,2273,3226,6482,0.808875129,0.191124871,0.095120153
Texas,FAYETTE,24554,18038,1599,4585,6516,0.734625723,0.265374277,0.186731286
Texas,FISHER,3974,2797,124,999,1177,0.703824862,0.296175138,0.251383996
Texas,FLOYD,6446,2777,211,3410,3669,0.430809805,0.569190195,0.529010239
Texas,FOARD,1336,1087,53,187,249,0.813622754,0.186377246,0.13997006
Texas,FORT BEND,585375,211680,123267,138967,373695,0.36161435,0.63838565,0.237398249
Texas,FRANKLIN,10605,8601,411,1333,2004,0.811032532,0.188967468,0.125695427
Texas,FREESTONE,19816,13656,3164,2694,6160,0.689140089,0.310859911,0.135950747
Texas,FRIO,17217,2796,524,13401,14421,0.16239763,0.83760237,0.778358599
Texas,GAINES,17526,10628,261,6413,6898,0.606413329,0.393586671,0.3659135
Texas,GALVESTON,291309,172652,39229,65270,118657,0.592676505,0.407323495,0.224057616
Texas,GARZA,6461,2962,392,3046,3499,0.458442965,0.541557035,0.471444049
Texas,GILLESPIE,24837,19472,47,4969,5365,0.783991625,0.216008375,0.20006442
Texas,GLASSCOCK,1226,825,15,378,401,0.672920065,0.327079935,0.308319739
Texas,GOLIAD,7210,4337,310,2462,2873,0.601525659,0.398474341,0.34147018
Texas,GONZALES,19807,8836,1353,9353,10971,0.446104912,0.553895088,0.472206796
Texas,GRAY,22535,15564,1055,5365,6971,0.690658975,0.309341025,0.238074107
Texas,GRAYSON,120877,95103,6938,13688,25774,0.786774986,0.213225014,0.113239078
Texas,GREGG,121730,74005,24068,20018,47725,0.60794381,0.39205619,0.164445905
Texas,GRIMES,26604,16133,4348,5652,10471,0.60641257,0.39358743,0.212449256
Texas,GUADALUPE,131533,72086,7963,46889,59447,0.548044977,0.451955023,0.356480883
Texas,HALE,36273,13647,1803,20269,22626,0.376230254,0.623769746,0.558790285
Texas,HALL,3353,1998,235,1087,1355,0.595884283,0.404115717,0.324187295
Texas,HAMILTON,8517,7495,38,863,1022,0.880004696,0.119995304,0.101326758
Texas,HANSFORD,5613,3088,31,2430,2525,0.550151434,0.449848566,0.43292357
Texas,HARDEMAN,4139,2938,217,889,1201,0.709833293,0.290166707,0.21478618
Texas,HARDIN,54635,48088,3181,2384,6547,0.88016839,0.11983161,0.043635032
Texas,HARRIS,4092459,1349646,754258,1671540,2742813,0.329788521,0.670211479,0.408443921
Texas,HARRISON,65631,42654,14303,7254,22977,0.649906294,0.350093706,0.110527038
Texas,HARTLEY,6062,4111,416,1448,1951,0.678159023,0.321840977,0.238865061
Texas,HASKELL,5899,4148,203,1414,1751,0.703170029,0.296829971,0.239701644
Texas,HAYS,157107,92062,4970,55401,65045,0.585982802,0.414017198,0.352632282
Texas,HEMPHILL,3807,2656,4,1086,1151,0.697662201,0.302337799,0.285263987
Texas,HENDERSON,78532,63494,4813,8490,15038,0.80851118,0.19148882,0.108108796
Texas,HIDALGO,774769,60553,2777,702206,714216,0.078156199,0.921843801,0.906342407
Texas,HILL,35089,25836,2161,6427,9253,0.736299125,0.263700875,0.183162815
Texas,HOCKLEY,22935,11795,801,9993,11140,0.514279486,0.485720514,0.435709614
Texas,HOOD,51182,44588,225,5234,6594,0.871165644,0.128834356,0.102262514
Texas,HOPKINS,35161,26501,2448,5368,8660,0.753704388,0.246295612,0.15266915
Texas,HOUSTON,23732,14811,6129,2364,8921,0.62409405,0.37590595,0.099612338
Texas,HOWARD,35012,18801,2079,13255,16211,0.536987319,0.463012681,0.378584485
Texas,HUDSPETH,3476,628,30,2768,2848,0.180667434,0.819332566,0.796317606
Texas,HUNT,86129,64393,6976,11751,21736,0.747634362,0.252365638,0.136434883
Texas,HUTCHINSON,22150,16482,512,4386,5668,0.744108352,0.255891648,0.198013544
Texas,IRION,1599,1153,11,407,446,0.721075672,0.278924328,0.254534084
Texas,JACK,9044,7289,340,1283,1755,0.805948695,0.194051305,0.141862008
Texas,JACKSON,14075,8855,942,4079,5220,0.629129663,0.370870337,0.289804618
Texas,JASPER,35710,26939,5931,2017,8771,0.754382526,0.245617474,0.056482778
Texas,JEFF DAVIS,2342,1490,10,790,852,0.636208369,0.363791631,0.337318531
Texas,JEFFERSON,252273,112503,84500,42899,139770,0.445957356,0.554042644,0.170049906
Texas,JIM HOGG,5300,334,18,4907,4966,0.063018868,0.936981132,0.925849057
Texas,JIM WELLS,40838,8062,156,32254,32776,0.197414173,0.802585827,0.789803614
Texas,JOHNSON,150934,115545,3797,27319,35389,0.765533279,0.234466721,0.180999642
Texas,JONES,20202,12549,2292,5009,7653,0.621176121,0.378823879,0.247945748
Texas,KARNES,14824,5956,1351,7376,8868,0.401780896,0.598219104,0.497571506
Texas,KAUFMAN,103350,72328,10571,17548,31022,0.69983551,0.30016449,0.169791969
Texas,KENDALL,33410,25746,138,6829,7664,0.770607603,0.229392397,0.20439988
Texas,KENEDY,416,86,1,319,330,0.206730769,0.793269231,0.766826923
Texas,KENT,808,669,6,120,139,0.827970297,0.172029703,0.148514851
Texas,KERR,49625,35851,739,11895,13774,0.722438287,0.277561713,0.239697733
Texas,KIMBLE,4607,3450,16,1077,1157,0.74886043,0.25113957,0.233774691
Texas,KING,286,242,0,39,44,0.846153846,0.153846154,0.136363636
Texas,KINNEY,3598,1496,39,2004,2102,0.415786548,0.584213452,0.556976098
Texas,KLEBERG,32061,7479,1070,22495,24582,0.233274071,0.766725929,0.701631265
Texas,KNOX,3719,2347,209,1101,1372,0.631083625,0.368916375,0.296047325
Texas,LAMAR,49793,37891,6628,3223,11902,0.760970418,0.239029582,0.064727974
Texas,LAMB,13977,6020,555,7231,7957,0.430707591,0.569292409,0.517349932
Texas,LAMPASAS,19677,14836,581,3443,4841,0.753976724,0.246023276,0.17497586
Texas,LA SALLE,6886,894,18,5920,5992,0.129828638,0.870171362,0.859715365
Texas,LAVACA,19263,14674,1255,3077,4589,0.761771271,0.238228729,0.159736282
Texas,LEE,16612,10798,1772,3724,5814,0.650012039,0.349987961,0.224175295
Texas,LEON,16801,13078,1181,2260,3723,0.778406047,0.221593953,0.134515803
Texas,LIBERTY,75643,52321,8074,13602,23322,0.691683302,0.308316698,0.179818357
Texas,LIMESTONE,23384,14433,4041,4465,8951,0.6172169,0.3827831,0.190942525
Texas,LIPSCOMB,3302,2213,7,1007,1089,0.670199879,0.329800121,0.304966687
Texas,LIVE OAK,11531,6805,453,4060,4726,0.590148296,0.409851704,0.352094354
Texas,LLANO,19301,17303,102,1542,1998,0.896482048,0.103517952,0.079892234
Texas,LOVING,82,60,0,18,22,0.731707317,0.268292683,0.219512195
Texas,LUBBOCK,278831,159815,19957,88924,119016,0.573160803,0.426839197,0.318917194
Texas,LYNN,5915,2984,113,2743,2931,0.504480135,0.495519865,0.463736264
Texas,MCCULLOCH,8283,5568,133,2476,2715,0.67222021,0.32777979,0.29892551
Texas,MCLENNAN,234906,138295,33892,55471,96611,0.588724852,0.411275148,0.236141265
Texas,MCMULLEN,707,432,8,261,275,0.611032532,0.388967468,0.369165488
Texas,MADISON,13664,8030,2687,2688,5634,0.587675644,0.412324356,0.196721311
Texas,MARION,10546,7564,2319,328,2982,0.717238764,0.282761236,0.03110184
Texas,MARTIN,4799,2578,67,2086,2221,0.537195249,0.462804751,0.43467389
Texas,MASON,4012,3092,14,864,920,0.770687936,0.229312064,0.215353938
Texas,MATAGORDA,36702,17400,4060,14074,19302,0.474088606,0.525911394,0.383466841
Texas,MAVERICK,54258,1552,75,51914,52706,0.028604077,0.971395923,0.956798997
Texas,MEDINA,46006,21408,913,22871,24598,0.465330609,0.534669391,0.497130809
Texas,MENARD,2242,1425,11,790,817,0.63559322,0.36440678,0.352363961
Texas,MIDLAND,136872,72822,8675,51600,64050,0.532044538,0.467955462,0.376994564
Texas,MILAM,24757,16216,2380,5780,8541,0.655006665,0.344993335,0.233469322
Texas,MILLS,4936,4024,26,818,912,0.815235008,0.184764992,0.165721232
Texas,MITCHELL,9403,4753,1043,3481,4650,0.505476975,0.494523025,0.370201
Texas,MONTAGUE,19719,17347,38,1930,2372,0.879709924,0.120290076,0.097875146
Texas,MONTGOMERY,455746,324611,18537,94698,131135,0.712262971,0.287737029,0.207786794
Texas,MOORE,21904,8370,287,11542,13534,0.382121987,0.617878013,0.52693572
Texas,MORRIS,12934,8636,2952,1003,4298,0.667697541,0.332302459,0.077547549
Texas,MOTLEY,1210,1013,24,163,197,0.837190083,0.162809917,0.134710744
Texas,NACOGDOCHES,64524,39699,11573,11356,24825,0.615259438,0.384740562,0.175996528
Texas,NAVARRO,47735,28587,6490,11345,19148,0.598868755,0.401131245,0.237666283
Texas,NEWTON,14445,10825,2891,403,3620,0.749394254,0.250605746,0.027898927
Texas,NOLAN,15216,9191,666,5103,6025,0.604035226,0.395964774,0.335370662
Texas,NUECES,340223,111870,12178,206293,228353,0.328813749,0.671186251,0.606346426
Texas,OCHILTREE,10223,5062,19,4982,5161,0.495157977,0.504842023,0.487332486
Texas,OLDHAM,2052,1699,60,243,353,0.82797271,0.17202729,0.118421053
Texas,ORANGE,81837,67895,6922,4766,13942,0.829636961,0.170363039,0.058237716
Texas,PALO PINTO,28111,21958,597,4985,6153,0.781117712,0.218882288,0.177332717
Texas,PANOLA,23796,17521,3850,1970,6275,0.736300219,0.263699781,0.082787023
Texas,PARKER,116927,99698,1842,12410,17229,0.852651654,0.147348346,0.106134597
Texas,PARMER,10269,3943,91,6164,6326,0.383971175,0.616028825,0.600253189
Texas,PECOS,15507,4326,528,10430,11181,0.278970787,0.721029213,0.672599471
Texas,POLK,45413,32830,5153,5959,12583,0.72292075,0.27707925,0.131217933
Texas,POTTER,121073,59322,11823,42692,61751,0.489968862,0.510031138,0.352613712
Texas,PRESIDIO,7818,1136,27,6521,6682,0.145305705,0.854694295,0.834100793
Texas,RAINS,10914,9553,249,839,1361,0.875297783,0.124702217,0.07687374
Texas,RANDALL,120725,94361,2701,19775,26364,0.781619383,0.218380617,0.163802029
Texas,REAGAN,3367,1219,65,2051,2148,0.362043362,0.637956638,0.609147609
Texas,REAL,3309,2398,20,814,911,0.724690239,0.275309761,0.245995769
Texas,RED RIVER,12860,9503,2211,849,3357,0.738958009,0.261041991,0.066018663
Texas,REEVES,13783,2690,672,10233,11093,0.195167961,0.804832039,0.742436335
Texas,REFUGIO,7383,3337,445,3487,4046,0.451984288,0.548015712,0.472301233
Texas,ROBERTS,929,841,0,74,88,0.905274489,0.094725511,0.079655544
Texas,ROBERTSON,16622,9821,3509,2990,6801,0.59084346,0.40915654,0.179882084
Texas,ROCKWALL,78337,58046,4397,12470,20291,0.740978082,0.259021918,0.159184038
Texas,RUNNELS,10501,6841,165,3361,3660,0.651461766,0.348538234,0.320064756
Texas,RUSK,53330,35237,9359,7609,18093,0.660735046,0.339264954,0.142677667
Texas,SABINE,10834,9484,778,344,1350,0.875392284,0.124607716,0.031751892
Texas,SAN AUGUSTINE,8865,6183,2013,532,2682,0.697461929,0.302538071,0.06001128
Texas,SAN JACINTO,26384,20204,2662,2880,6180,0.765767132,0.234232868,0.109157065
Texas,SAN PATRICIO,64804,27330,902,35248,37474,0.421733226,0.578266774,0.543917042
Texas,SAN SABA,6131,4135,194,1715,1996,0.674441364,0.325558636,0.279725983
Texas,SCHLEICHER,3461,1872,32,1536,1589,0.540884138,0.459115862,0.443802369
Texas,SCURRY,16921,9773,764,6149,7148,0.577566338,0.422433662,0.363394598
Texas,SHACKELFORD,3378,2961,14,340,417,0.876554174,0.123445826,0.100651273
Texas,SHELBY,25448,16535,4414,4164,8913,0.649756366,0.350243634,0.16362779
Texas,SHERMAN,3034,1762,12,1227,1272,0.580751483,0.419248517,0.404416612
Texas,SMITH,209714,130246,37195,36088,79468,0.621064879,0.378935121,0.172081978
Texas,SOMERVELL,8490,6595,54,1626,1895,0.776796231,0.223203769,0.191519435
Texas,STARR,60968,2449,15,58337,58519,0.040168613,0.959831387,0.956846214
Texas,STEPHENS,9630,7289,195,2011,2341,0.756905504,0.243094496,0.208826584
Texas,STERLING,1143,733,13,365,410,0.641294838,0.358705162,0.319335083
Texas,STONEWALL,1490,1206,38,209,284,0.809395973,0.190604027,0.140268456
Texas,SUTTON,4128,1639,6,2459,2489,0.397044574,0.602955426,0.595687984
Texas,SWISHER,7854,4025,552,3149,3829,0.512477718,0.487522282,0.400942195
Texas,TARRANT,1809034,937135,262522,482977,871899,0.518030617,0.481969383,0.26698061
Texas,TAYLOR,131506,88121,9122,29074,43385,0.670091099,0.329908901,0.22108497
Texas,TERRELL,984,495,6,467,489,0.50304878,0.49695122,0.474593496
Texas,TERRY,12651,5747,565,6211,6904,0.45427239,0.54572761,0.490949332
Texas,THROCKMORTON,1641,1453,9,152,188,0.88543571,0.11456429,0.092626447
Texas,TITUS,32334,15904,3000,12799,16430,0.491866147,0.508133853,0.395837199
Texas,TOM GREEN,110224,63799,3997,39315,46425,0.578812237,0.421187763,0.356682755
Texas,TRAVIS,1024266,517644,82805,342766,506622,0.505380438,0.494619562,0.334645492
Texas,TRINITY,14585,11819,1377,1117,2766,0.810353103,0.189646897,0.076585533
Texas,TYLER,21766,17507,2376,1487,4259,0.804327851,0.195672149,0.068317559
Texas,UPSHUR,39309,32257,3388,2613,7052,0.82060088,0.17939912,0.066473327
Texas,UPTON,3355,1611,49,1644,1744,0.480178838,0.519821162,0.490014903
Texas,UVALDE,26405,7666,110,18299,18739,0.290323802,0.709676198,0.693012687
Texas,VAL VERDE,48879,8548,563,39199,40331,0.174880828,0.825119172,0.801959942
Texas,VAN ZANDT,52579,45087,1403,4847,7492,0.857509652,0.142490348,0.092185093
Texas,VICTORIA,86793,41564,5190,38113,45229,0.478886546,0.521113454,0.439125275
Texas,WALKER,67861,39671,15098,11389,28190,0.584592034,0.415407966,0.167828355
Texas,WALLER,43205,19260,10537,12536,23945,0.445781738,0.554218262,0.290151603
Texas,WARD,10658,4922,474,5074,5736,0.461812723,0.538187277,0.47607431
Texas,WASHINGTON,33718,22394,5861,4641,11324,0.664155644,0.335844356,0.137641616
Texas,WEBB,250304,8345,487,239653,241959,0.033339459,0.966660541,0.957447744
Texas,WHARTON,41280,19681,5668,15445,21599,0.476768411,0.523231589,0.374152132
Texas,WHEELER,5410,3847,112,1344,1563,0.711090573,0.288909427,0.248428835
Texas,WICHITA,131500,90001,13322,21859,41499,0.684418251,0.315581749,0.166228137
Texas,WILBARGER,13535,8585,1049,3508,4950,0.634281492,0.365718508,0.259179904
Texas,WILLACY,22134,2235,389,19297,19899,0.100975874,0.899024126,0.87182615
Texas,WILLIAMSON,422679,269481,24744,98034,153198,0.63755474,0.36244526,0.231934873
Texas,WILSON,42918,25186,644,16412,17732,0.586840021,0.413159979,0.382403653
Texas,WINKLER,7110,3024,129,3824,4086,0.425316456,0.574683544,0.537834037
Texas,WISE,59127,47122,573,10112,12005,0.796962471,0.203037529,0.171021699
Texas,WOOD,41964,35628,1951,3551,6336,0.84901344,0.15098656,0.084620151
Texas,YOAKUM,7879,3090,55,4622,4789,0.392181749,0.607818251,0.586622668
Texas,YOUNG,18550,14959,220,3045,3591,0.806415094,0.193584906,0.164150943
Texas,ZAPATA,14018,861,11,13084,13157,0.06142103,0.93857897,0.93337138
Texas,ZAVALA,11677,647,35,10961,11030,0.055408067,0.944591933,0.938682881
Utah,BEAVER,6629,5700,14,716,929,0.859858199,0.140141801,0.108010258
Utah,BOX ELDER,49975,44109,139,4152,5866,0.882621311,0.117378689,0.083081541
Utah,CACHE,112656,96283,596,11216,16373,0.854663755,0.145336245,0.099559722
Utah,CARBON,21403,18007,84,2659,3396,0.841330655,0.158669345,0.12423492
Utah,DAGGETT,1059,1000,4,33,59,0.944287063,0.055712937,0.031161473
Utah,DAVIS,306479,263049,3435,25753,43430,0.858293717,0.141706283,0.084028596
Utah,DUCHESNE,18607,16211,31,1117,2396,0.871231257,0.128768743,0.060031171
Utah,EMERY,10976,10108,25,654,868,0.920918367,0.079081633,0.059584548
Utah,GARFIELD,5172,4740,13,234,432,0.916473318,0.083526682,0.045243619
Utah,GRAND,9225,7759,27,881,1466,0.841084011,0.158915989,0.095501355
Utah,IRON,46163,40226,204,3563,5937,0.871390508,0.128609492,0.077183025
Utah,JUAB,10246,9631,21,379,615,0.939976576,0.060023424,0.036990045
Utah,KANE,7125,6639,15,263,486,0.931789474,0.068210526,0.036912281
Utah,MILLARD,12503,10589,10,1603,1914,0.84691674,0.15308326,0.12820923
Utah,MORGAN,9469,9098,15,226,371,0.960819516,0.039180484,0.023867357
Utah,PIUTE,1556,1419,2,109,137,0.911953728,0.088046272,0.070051414
Utah,RICH,2264,2131,0,96,133,0.941254417,0.058745583,0.042402827
Utah,SALT LAKE,1029655,761885,14622,176015,267770,0.739942019,0.260057981,0.170945608
Utah,SAN JUAN,14746,6474,21,649,8272,0.439034314,0.560965686,0.044011935
Utah,SANPETE,27822,24109,209,2619,3713,0.866544461,0.133455539,0.094134138
Utah,SEVIER,20802,19325,34,932,1477,0.928997212,0.071002788,0.044803384
Utah,SUMMIT,36324,31012,110,4190,5312,0.853760599,0.146239401,0.115350732
Utah,TOOELE,58218,49174,372,6661,9044,0.844652857,0.155347143,0.114414786
Utah,UINTAH,32588,26999,96,2330,5589,0.828495152,0.171504848,0.071498711
Utah,UTAH,516564,434708,2421,55793,81856,0.841537544,0.158462456,0.108007914
Utah,WASATCH,23530,19818,49,3184,3712,0.842243944,0.157756056,0.135316617
Utah,WASHINGTON,138115,118282,632,13486,19833,0.856402273,0.143597727,0.097643268
Utah,WAYNE,2778,2596,2,116,182,0.934485241,0.065514759,0.041756659
Utah,WEBER,231236,180638,2748,38711,50598,0.781184591,0.218815409,0.167409054
Vermont,ADDISON,36821,34660,269,685,2161,0.941310665,0.058689335,0.018603514
Vermont,BENNINGTON,37125,35517,291,525,1608,0.956686869,0.043313131,0.014141414
Vermont,CALEDONIA,31227,29909,150,331,1318,0.957792936,0.042207064,0.010599801
Vermont,CHITTENDEN,156545,142848,3172,2856,13697,0.912504392,0.087495608,0.018243955
Vermont,ESSEX,6306,6094,16,59,212,0.966381224,0.033618776,0.009356169
Vermont,FRANKLIN,47746,45290,200,571,2456,0.948561136,0.051438864,0.011959117
Vermont,GRAND ISLE,6970,6600,23,80,370,0.946915352,0.053084648,0.011477762
Vermont,LAMOILLE,24475,23427,142,322,1048,0.957180797,0.042819203,0.013156282
Vermont,ORANGE,28936,27898,107,282,1038,0.96412773,0.03587227,0.009745646
Vermont,ORLEANS,27231,26139,152,305,1092,0.959898645,0.040101355,0.01120047
Vermont,RUTLAND,61642,59369,315,681,2273,0.963125791,0.036874209,0.011047662
Vermont,WASHINGTON,59534,56473,411,995,3061,0.948584002,0.051415998,0.016713139
Vermont,WINDHAM,44513,41906,384,820,2607,0.94143284,0.05856716,0.018421585
Vermont,WINDSOR,56670,54093,311,696,2577,0.954526204,0.045473796,0.01228163
Virginia,ACCOMACK,33164,20266,9253,2850,12898,0.611084308,0.388915692,0.085936558
Virginia,ALBEMARLE,98970,77130,9487,5417,21840,0.779327069,0.220672931,0.054733758
Virginia,ALLEGHANY,16250,15040,751,176,1210,0.925538462,0.074461538,0.010830769
Virginia,AMELIA,12690,9233,2925,290,3457,0.727580772,0.272419228,0.02285264
Virginia,AMHERST,32353,24491,6104,625,7862,0.756993169,0.243006831,0.019318147
Virginia,APPOMATTOX,14973,11483,2998,167,3490,0.766913778,0.233086222,0.011153409
Virginia,ARLINGTON,207627,132961,17088,31382,74666,0.640383958,0.359616042,0.151146046
Virginia,AUGUSTA,73750,68011,2881,1525,5739,0.922183051,0.077816949,0.020677966
Virginia,BATH,4731,4363,213,101,368,0.922215176,0.077784824,0.021348552
Virginia,BEDFORD,68676,62035,3909,1090,6641,0.903299552,0.096700448,0.015871629
Virginia,BLAND,6824,6494,228,39,330,0.951641266,0.048358734,0.005715123
Virginia,BOTETOURT,33148,31212,987,356,1936,0.94159527,0.05840473,0.010739713
Virginia,BRUNSWICK,17434,6943,9944,298,10491,0.398244809,0.601755191,0.017093037
Virginia,BUCHANAN,24098,23205,614,95,893,0.962942983,0.037057017,0.003942236
Virginia,BUCKINGHAM,17146,10494,5979,288,6652,0.612037793,0.387962207,0.016796921
Virginia,CAMPBELL,54842,44595,7737,918,10247,0.813154152,0.186845848,0.016738996
Virginia,CAROLINE,28545,18145,8297,959,10400,0.635662988,0.364337012,0.033596076
Virginia,CARROLL,30042,28820,177,776,1222,0.959323614,0.040676386,0.025830504
Virginia,CHARLES CITY,7256,2939,3511,88,4317,0.405044101,0.594955899,0.012127894
Virginia,CHARLOTTE,12586,8383,3739,240,4203,0.666057524,0.333942476,0.019068807
Virginia,CHESTERFIELD,316236,206792,68196,22864,109444,0.653916695,0.346083305,0.072300434
Virginia,CLARKE,14034,12387,742,490,1647,0.882642155,0.117357845,0.034915206
Virginia,CRAIG,5190,5103,5,36,87,0.983236994,0.016763006,0.006936416
Virginia,CULPEPER,46689,33482,7212,4157,13207,0.717128231,0.282871769,0.089035961
Virginia,CUMBERLAND,10052,6353,3253,181,3699,0.63201353,0.36798647,0.018006367
Virginia,DICKENSON,15903,15650,51,86,253,0.984091052,0.015908948,0.005407785
Virginia,DINWIDDIE,28001,17617,9134,674,10384,0.629156102,0.370843898,0.024070569
Virginia,ESSEX,11151,6239,4224,349,4912,0.55950139,0.44049861,0.031297641
Virginia,FAIRFAX,1081726,590622,96078,168482,491104,0.545999634,0.454000366,0.155752936
Virginia,FAUQUIER,65203,53410,5232,4178,11793,0.819134089,0.180865911,0.064076806
Virginia,FLOYD,15279,14385,270,412,894,0.941488317,0.058511683,0.026965116
Virginia,FLUVANNA,25691,20318,3913,760,5373,0.790860613,0.209139387,0.029582344
Virginia,FRANKLIN,56159,49072,4541,1424,7087,0.873804733,0.126195267,0.025356577
Virginia,FREDERICK,78305,67590,3067,5168,10715,0.863163272,0.136836728,0.06599834
Virginia,GILES,17286,16580,259,209,706,0.9591577,0.0408423,0.012090709
Virginia,GLOUCESTER,36858,31584,3152,935,5274,0.856910304,0.143089696,0.025367627
Virginia,GOOCHLAND,21717,16583,4151,455,5134,0.76359534,0.23640466,0.020951328
Virginia,GRAYSON,15533,14627,317,416,906,0.941672568,0.058327432,0.026781691
Virginia,GREENE,18403,15785,1160,781,2618,0.857740586,0.142259414,0.042438733
Virginia,GREENSVILLE,12243,4628,7294,173,7615,0.378011925,0.621988075,0.014130524
Virginia,HALIFAX,36241,21804,13224,587,14437,0.601639028,0.398360972,0.016197125
Virginia,HANOVER,99863,85391,9202,2116,14472,0.855081462,0.144918538,0.021189029
Virginia,HENRICO,306935,174799,89449,15001,132136,0.569498428,0.430501572,0.04887354
Virginia,HENRY,54151,38737,11786,2545,15414,0.715351517,0.284648483,0.046998209
Virginia,HIGHLAND,2321,2284,6,18,37,0.984058595,0.015941405,0.007755278
Virginia,ISLE OF WIGHT,35270,24969,8656,658,10301,0.707938758,0.292061242,0.018656082
Virginia,JAMES CITY,67009,52049,8662,3024,14960,0.776746407,0.223253593,0.045128266
Virginia,KING AND QUEEN,6945,4547,1970,184,2398,0.654715623,0.345284377,0.02649388
Virginia,KING GEORGE,23584,17603,4177,790,5981,0.746395862,0.253604138,0.033497286
Virginia,KING WILLIAM,15935,12107,2806,324,3828,0.759774082,0.240225918,0.020332601
Virginia,LANCASTER,11391,7925,3166,118,3466,0.695724695,0.304275305,0.010359055
Virginia,LEE,25587,23893,909,406,1694,0.933794505,0.066205495,0.015867433
Virginia,LOUDOUN,312311,194845,21934,38576,117466,0.623881323,0.376118677,0.123517904
Virginia,LOUISA,33153,25562,5832,762,7591,0.771031279,0.228968721,0.022984345
Virginia,LUNENBURG,12914,7730,4451,470,5184,0.59857519,0.40142481,0.036394611
Virginia,MADISON,13308,11394,1292,236,1914,0.856176736,0.143823264,0.017733694
Virginia,MATHEWS,8978,7835,822,104,1143,0.872688795,0.127311205,0.011583872
Virginia,MECKLENBURG,32727,19215,11958,806,13512,0.587129893,0.412870107,0.024627983
Virginia,MIDDLESEX,10959,8604,1956,166,2355,0.78510813,0.21489187,0.015147367
Virginia,MONTGOMERY,94392,81091,3631,2536,13301,0.859087635,0.140912365,0.026866684
Virginia,NELSON,15020,12283,1941,459,2737,0.817776298,0.182223702,0.030559254
Virginia,NEW KENT,18429,14804,2474,390,3625,0.803299148,0.196700852,0.021162299
Virginia,NORTHAMPTON,12389,6755,4491,874,5634,0.545241747,0.454758253,0.070546452
Virginia,NORTHUMBERLAND,12330,8638,3106,382,3692,0.700567721,0.299432279,0.030981346
Virginia,NOTTOWAY,15853,8799,6179,609,7054,0.555036902,0.444963098,0.038415442
Virginia,ORANGE,33481,27033,4206,1139,6448,0.80741316,0.19258684,0.034019295
Virginia,PAGE,24042,22871,456,373,1171,0.95129357,0.04870643,0.015514516
Virginia,PATRICK,18490,16680,1085,444,1810,0.902109248,0.097890752,0.02401298
Virginia,PITTSYLVANIA,63506,47250,13963,1332,16256,0.744024187,0.255975813,0.020974396
Virginia,POWHATAN,28046,23231,3798,502,4815,0.828317764,0.171682236,0.017899166
Virginia,PRINCE EDWARD,23368,14544,7668,525,8824,0.622389593,0.377610407,0.022466621
Virginia,PRINCE GEORGE,35725,20822,11150,2058,14903,0.582841148,0.417158852,0.057606718
Virginia,PRINCE WILLIAM,402002,195656,78492,81460,206346,0.486704046,0.513295954,0.202635808
Virginia,PULASKI,34872,31972,1744,432,2900,0.916838724,0.083161276,0.012388162
Virginia,RAPPAHANNOCK,7373,6653,318,228,720,0.902346399,0.097653601,0.03092364
Virginia,RICHMOND,9254,5755,2793,510,3499,0.621893235,0.378106765,0.055111303
Virginia,ROANOKE,92376,81886,4580,1951,10490,0.886442366,0.113557634,0.021120204
Virginia,ROCKBRIDGE,22307,20915,585,296,1392,0.937598063,0.062401937,0.013269377
Virginia,ROCKINGHAM,76314,69640,1216,4076,6674,0.912545536,0.087454464,0.053410908
Virginia,RUSSELL,28897,28142,227,275,755,0.97387272,0.02612728,0.009516559
Virginia,SCOTT,23177,22585,135,234,592,0.974457436,0.025542564,0.010096216
Virginia,SHENANDOAH,41993,37886,699,2577,4107,0.902197985,0.097802015,0.061367371
Virginia,SMYTH,32208,30642,630,527,1566,0.951378539,0.048621461,0.016362394
Virginia,SOUTHAMPTON,18570,11138,6893,203,7432,0.599784599,0.400215401,0.01093161
Virginia,SPOTSYLVANIA,122397,88077,18298,9278,34320,0.719600971,0.280399029,0.075802511
Virginia,STAFFORD,128961,87434,21259,11875,41527,0.677987919,0.322012081,0.092082102
Virginia,SURRY,7058,3583,3240,86,3475,0.507650893,0.492349107,0.012184755
Virginia,SUSSEX,12087,4663,6996,268,7424,0.385786382,0.614213618,0.022172582
Virginia,TAZEWELL,45078,42692,1330,296,2386,0.947069524,0.052930476,0.006566396
Virginia,WARREN,37575,33345,1709,1318,4230,0.88742515,0.11257485,0.035076514
Virginia,WASHINGTON,54876,52798,686,724,2078,0.962132809,0.037867191,0.013193381
Virginia,WESTMORELAND,17454,11087,4855,1002,6367,0.635212559,0.364787441,0.057408044
Virginia,WISE,41452,38301,2118,471,3151,0.923984367,0.076015633,0.01136254
Virginia,WYTHE,29235,27649,809,280,1586,0.945749957,0.054250043,0.009577561
Virginia,YORK,65464,48470,8599,2892,16994,0.740406941,0.259593059,0.044176952
Virginia,ALEXANDRIA CITY,139966,74878,29778,22524,65088,0.534972779,0.465027221,0.160924796
Virginia,BEDFORD CITY,6222,4671,1245,134,1551,0.75072324,0.24927676,0.021536483
Virginia,BRISTOL CITY,17835,16099,1000,221,1736,0.902663302,0.097336698,0.012391365
Virginia,BUENA VISTA CITY,6650,5982,345,103,668,0.899548872,0.100451128,0.015488722
Virginia,CHARLOTTESVILLE CITY,43475,28827,8344,2223,14648,0.66307073,0.33692927,0.051132835
Virginia,CHESAPEAKE CITY,222209,134251,65204,9706,87958,0.604165448,0.395834552,0.043679599
Virginia,COLONIAL HEIGHTS CITY,17411,14020,1732,674,3391,0.805238068,0.194761932,0.03871116
Virginia,COVINGTON CITY,5961,4955,741,92,1006,0.83123637,0.16876363,0.015433652
Virginia,DANVILLE CITY,43055,20107,20725,1245,22948,0.467007316,0.532992684,0.028916502
Virginia,EMPORIA CITY,5927,1848,3685,262,4079,0.311793487,0.688206513,0.044204488
Virginia,FAIRFAX CITY,22565,13849,1030,3556,8716,0.61373809,0.38626191,0.157589187
Virginia,FALLS CHURCH CITY,12332,9093,523,1109,3239,0.737349984,0.262650016,0.089928641
Virginia,FRANKLIN CITY,8582,3333,4867,141,5249,0.388371009,0.611628991,0.016429737
Virginia,FREDERICKSBURG CITY,24286,14760,5367,2607,9526,0.607757556,0.392242444,0.107345796
Virginia,GALAX CITY,7042,5501,407,989,1541,0.781170122,0.218829878,0.140443056
Virginia,HAMPTON CITY,137436,56283,66878,6241,81153,0.409521523,0.590478477,0.045410227
Virginia,HARRISONBURG CITY,48914,35391,2911,7665,13523,0.723535184,0.276464816,0.156703602
Virginia,HOPEWELL CITY,22591,12005,8216,1480,10586,0.531406312,0.468593688,0.065512815
Virginia,LEXINGTON CITY,7042,5807,668,271,1235,0.824623686,0.175376314,0.038483385
Virginia,LYNCHBURG CITY,75568,47574,21984,2300,27994,0.629552191,0.370447809,0.030436163
Virginia,MANASSAS CITY,37821,17994,4905,11876,19827,0.475767431,0.524232569,0.314005447
Virginia,MANASSAS PARK CITY,14273,6070,1784,4645,8203,0.425278498,0.574721502,0.325439641
Virginia,MARTINSVILLE CITY,13821,6707,6191,552,7114,0.485276029,0.514723971,0.039939223
Virginia,NEWPORT NEWS CITY,180719,83153,71727,13590,97566,0.460123175,0.539876825,0.075199619
Virginia,NORFOLK CITY,242803,107463,102452,16144,135340,0.442593378,0.557406622,0.066490118
Virginia,NORTON CITY,3958,3478,250,68,480,0.87872663,0.12127337,0.017180394
Virginia,PETERSBURG CITY,32420,4902,25419,1216,27518,0.151202961,0.848797039,0.037507711
Virginia,POQUOSON CITY,12150,11398,78,221,752,0.938106996,0.061893004,0.0181893
Virginia,PORTSMOUTH CITY,95535,38526,50327,2919,57009,0.403265819,0.596734181,0.030554247
Virginia,RADFORD CITY,16408,14075,1262,385,2333,0.857813262,0.142186738,0.023464164
Virginia,RICHMOND CITY,204214,79813,102264,12803,124401,0.390830208,0.609169792,0.062694037
Virginia,ROANOKE CITY,97032,60042,27256,5345,36990,0.618785555,0.381214445,0.05508492
Virginia,SALEM CITY,24802,21653,1732,601,3149,0.873034433,0.126965567,0.024231917
Virginia,STAUNTON CITY,23746,19584,2859,513,4162,0.824728375,0.175271625,0.021603639
Virginia,SUFFOLK CITY,84585,43034,35771,2415,41551,0.50876633,0.49123367,0.028551162
Virginia,VIRGINIA BEACH CITY,437994,282470,83210,28987,155524,0.64491751,0.35508249,0.066181272
Virginia,WAYNESBORO CITY,21006,16704,2176,1337,4302,0.795201371,0.204798629,0.063648481
Virginia,WILLIAMSBURG CITY,14068,9952,1918,941,4116,0.707421098,0.292578902,0.066889394
Virginia,WINCHESTER CITY,26203,18085,2783,4041,8118,0.690188146,0.309811854,0.154218983
Washington,ADAMS,18728,7262,47,11099,11466,0.38776164,0.61223836,0.592642033
Washington,ASOTIN,21623,20026,89,643,1597,0.926143458,0.073856542,0.029736854
Washington,BENTON,175177,130437,2031,32696,44740,0.744601175,0.255398825,0.186645507
Washington,CHELAN,72453,51202,177,18713,21251,0.706692615,0.293307385,0.25827778
Washington,CLALLAM,71404,60400,558,3627,11004,0.845890986,0.154109014,0.050795474
Washington,CLARK,425363,347793,8025,32166,77570,0.817638111,0.182361889,0.075620117
Washington,COLUMBIA,4078,3649,12,254,429,0.894801373,0.105198627,0.062285434
Washington,COWLITZ,102410,87825,572,7975,14585,0.857582267,0.142417733,0.077873255
Washington,DOUGLAS,38431,26070,85,11013,12361,0.678358617,0.321641383,0.286565533
Washington,FERRY,7551,5662,18,254,1889,0.749834459,0.250165541,0.033637929
Washington,FRANKLIN,78163,33804,1339,40004,44359,0.432480841,0.567519159,0.511802259
Washington,GARFIELD,2266,2102,0,91,164,0.927625772,0.072374228,0.04015887
Washington,GRANT,89120,51066,710,34163,38054,0.573002693,0.426997307,0.383337074
Washington,GRAYS HARBOR,72797,59282,762,6272,13515,0.814346745,0.185653255,0.086157397
Washington,ISLAND,78506,65209,1641,4295,13297,0.830624411,0.169375589,0.054709194
Washington,JEFFERSON,29872,26681,237,848,3191,0.893177558,0.106822442,0.028387788
Washington,KING,1931249,1251300,116326,172378,679949,0.647922666,0.352077334,0.089257263
Washington,KITSAP,251133,198745,6329,15686,52388,0.791393405,0.208606595,0.062460927
Washington,KITTITAS,40915,35214,339,3121,5701,0.860662349,0.139337651,0.076280093
Washington,KLICKITAT,20318,17022,42,2171,3296,0.837779309,0.162220691,0.106851068
Washington,LEWIS,75455,64881,370,6527,10574,0.859863495,0.140136505,0.086501889
Washington,LINCOLN,10570,9891,25,239,679,0.935761589,0.064238411,0.022611164
Washington,MASON,60699,50349,609,4844,10350,0.829486482,0.170513518,0.079803621
Washington,OKANOGAN,41120,28092,131,7227,13028,0.683171206,0.316828794,0.175753891
Washington,PACIFIC,20920,17699,67,1677,3221,0.846032505,0.153967495,0.080162524
Washington,PEND OREILLE,13001,11677,50,391,1324,0.89816168,0.10183832,0.03007461
Washington,PIERCE,795225,559160,51436,72849,236065,0.703146908,0.296853092,0.091608035
Washington,SAN JUAN,15769,14228,49,857,1541,0.902276619,0.097723381,0.054347137
Washington,SKAGIT,116901,89694,640,19709,27207,0.767264609,0.232735391,0.168595649
Washington,SKAMANIA,11066,9918,44,553,1148,0.896258811,0.103741189,0.04997289
Washington,SNOHOMISH,713335,529814,17299,64249,183521,0.742728171,0.257271829,0.090068481
Washington,SPOKANE,471221,408629,7714,21260,62592,0.867170606,0.132829394,0.045116835
Washington,STEVENS,43531,38261,145,1185,5270,0.87893685,0.12106315,0.02722198
Washington,THURSTON,252264,199019,6420,17787,53245,0.788931437,0.211068563,0.070509466
Washington,WAHKIAKUM,3978,3678,8,108,300,0.924585219,0.075414781,0.027149321
Washington,WALLA WALLA,58781,43604,1004,11593,15177,0.741804325,0.258195675,0.197223593
Washington,WHATCOM,201140,164675,1789,15756,36465,0.818708362,0.181291638,0.078333499
Washington,WHITMAN,44776,36760,721,2040,8016,0.820975523,0.179024477,0.045560121
Washington,YAKIMA,243231,116024,1743,109470,127207,0.477011565,0.522988435,0.450065987
West Virginia,BARBOUR,16589,16005,120,96,584,0.964795949,0.035204051,0.005786967
West Virginia,BERKELEY,104169,89379,7234,3961,14790,0.85801918,0.14198082,0.038024748
West Virginia,BOONE,24629,24220,122,97,409,0.98339356,0.01660644,0.003938447
West Virginia,BRAXTON,14523,14206,59,67,317,0.978172554,0.021827446,0.004613372
West Virginia,BROOKE,24069,23241,273,163,828,0.965598903,0.034401097,0.006772197
West Virginia,CABELL,96319,87520,4717,1046,8799,0.908647307,0.091352693,0.010859747
West Virginia,CALHOUN,7627,7465,15,57,162,0.97875967,0.02124033,0.00747345
West Virginia,CLAY,9386,9243,6,33,143,0.984764543,0.015235457,0.003515875
West Virginia,DODDRIDGE,8202,7926,111,39,276,0.966349671,0.033650329,0.004754938
West Virginia,FAYETTE,46039,42763,2097,402,3276,0.928842938,0.071157062,0.008731727
West Virginia,GILMER,8693,6952,1048,493,1741,0.799723916,0.200276084,0.056712297
West Virginia,GRANT,11937,11618,72,120,319,0.973276368,0.026723632,0.010052777
West Virginia,GREENBRIER,35480,33330,973,422,2150,0.93940248,0.06059752,0.011894025
West Virginia,HAMPSHIRE,23964,23146,225,242,818,0.965865465,0.034134535,0.010098481
West Virginia,HANCOCK,30676,29143,708,314,1533,0.950026079,0.049973921,0.010236015
West Virginia,HARDY,14025,12936,327,478,1089,0.922352941,0.077647059,0.034081996
West Virginia,HARRISON,69099,65629,1111,883,3470,0.949782197,0.050217803,0.012778767
West Virginia,JACKSON,29211,28563,78,185,648,0.977816576,0.022183424,0.006333231
West Virginia,JEFFERSON,53498,45565,3445,2489,7933,0.851714083,0.148285917,0.046525104
West Virginia,KANAWHA,193063,170969,13950,1812,22094,0.885560672,0.114439328,0.009385537
West Virginia,LEWIS,16372,15964,65,104,408,0.975079404,0.024920596,0.006352309
West Virginia,LINCOLN,21720,21433,18,96,287,0.986786372,0.013213628,0.00441989
West Virginia,LOGAN,36743,35285,780,258,1458,0.960318972,0.039681028,0.007021746
West Virginia,MCDOWELL,22113,19637,2098,91,2476,0.888029666,0.111970334,0.004115226
West Virginia,MARION,56418,52874,1838,514,3544,0.937183168,0.062816832,0.009110568
West Virginia,MARSHALL,33107,32243,175,265,864,0.9739028,0.0260972,0.00800435
West Virginia,MASON,27324,26618,171,119,706,0.974161909,0.025838091,0.004355146
West Virginia,MERCER,62264,56711,3740,480,5553,0.910815238,0.089184762,0.00770911
West Virginia,MINERAL,28212,26742,769,202,1470,0.947894513,0.052105487,0.007160074
West Virginia,MINGO,26839,25944,471,119,895,0.966653005,0.033346995,0.004433846
West Virginia,MONONGALIA,96189,86298,3436,1692,9891,0.897171194,0.102828806,0.017590369
West Virginia,MONROE,13502,13110,89,83,392,0.970967264,0.029032736,0.006147237
West Virginia,MORGAN,17541,16949,96,183,592,0.966250499,0.033749501,0.010432701
West Virginia,NICHOLAS,26233,25688,42,146,545,0.979224641,0.020775359,0.005565509
West Virginia,OHIO,44443,41163,1614,362,3280,0.926197601,0.073802399,0.008145265
West Virginia,PENDLETON,7695,7353,149,71,342,0.955555556,0.044444444,0.009226771
West Virginia,PLEASANTS,7605,7354,96,61,251,0.966995398,0.033004602,0.008021039
West Virginia,POCAHONTAS,8719,8480,58,68,239,0.9725886,0.0274114,0.00779906
West Virginia,PRESTON,33520,32557,360,229,963,0.971270883,0.028729117,0.006831742
West Virginia,PUTNAM,55486,53377,478,484,2109,0.961990412,0.038009588,0.008722921
West Virginia,RALEIGH,78859,69246,6390,996,9613,0.878098885,0.121901115,0.012630137
West Virginia,RANDOLPH,29405,28474,343,192,931,0.968338718,0.031661282,0.006529502
West Virginia,RITCHIE,10449,10275,20,55,174,0.983347689,0.016652311,0.005263662
West Virginia,ROANE,14926,14613,19,103,313,0.979029881,0.020970119,0.00690071
West Virginia,SUMMERS,13927,12837,645,189,1090,0.92173476,0.07826524,0.013570762
West Virginia,TAYLOR,16895,16377,125,143,518,0.969340041,0.030659959,0.008464043
West Virginia,TUCKER,7141,7024,11,41,117,0.98361574,0.01638426,0.005741493
West Virginia,TYLER,9208,9071,13,49,137,0.985121633,0.014878367,0.00532146
West Virginia,UPSHUR,24254,23494,145,250,760,0.968664962,0.031335038,0.010307578
West Virginia,WAYNE,42481,41706,74,218,775,0.98175655,0.01824345,0.005131706
West Virginia,WEBSTER,9154,8989,14,48,165,0.981975093,0.018024907,0.005243609
West Virginia,WETZEL,16583,16319,24,83,264,0.984080082,0.015919918,0.005005126
West Virginia,WIRT,5717,5610,9,26,107,0.98128389,0.01871611,0.00454784
West Virginia,WOOD,86956,83352,940,744,3604,0.958553751,0.041446249,0.008556051
West Virginia,WYOMING,23796,23270,116,105,526,0.977895445,0.022104555,0.004412506
Wisconsin,ADAMS,20875,19013,611,783,1862,0.910802395,0.089197605,0.037508982
Wisconsin,ASHLAND,16157,13534,47,302,2623,0.837655505,0.162344495,0.018691589
Wisconsin,BARRON,45870,43567,397,862,2303,0.949792893,0.050207107,0.018792239
Wisconsin,BAYFIELD,15014,12955,44,158,2059,0.862861329,0.137138671,0.010523511
Wisconsin,BROWN,248007,207702,5286,17985,40305,0.837484426,0.162515574,0.072518114
Wisconsin,BUFFALO,13587,13135,35,237,452,0.966732906,0.033267094,0.017443144
Wisconsin,BURNETT,15457,14067,81,194,1390,0.910073106,0.089926894,0.012550948
Wisconsin,CALUMET,48971,45325,236,1690,3646,0.925547773,0.074452227,0.03451022
Wisconsin,CHIPPEWA,62415,59028,961,800,3387,0.945734199,0.054265801,0.012817432
Wisconsin,CLARK,34690,32865,73,1292,1825,0.947391179,0.052608821,0.037244163
Wisconsin,COLUMBIA,56833,53628,697,1444,3205,0.943606707,0.056393293,0.025407774
Wisconsin,CRAWFORD,16644,15991,288,150,653,0.960766643,0.039233357,0.009012257
Wisconsin,DANE,488073,399488,24717,28925,88585,0.818500511,0.181499489,0.059263676
Wisconsin,DODGE,88759,81325,2361,3522,7434,0.916245113,0.083754887,0.039680483
Wisconsin,DOOR,27785,26483,139,671,1302,0.953140184,0.046859816,0.024149721
Wisconsin,DOUGLAS,44159,40854,475,494,3305,0.92515682,0.07484318,0.011186848
Wisconsin,DUNN,43857,41225,215,626,2632,0.939986775,0.060013225,0.014273662
Wisconsin,EAU CLAIRE,98736,90918,837,1804,7818,0.920819154,0.079180846,0.018270945
Wisconsin,FLORENCE,4423,4287,10,37,136,0.969251639,0.030748361,0.008365363
Wisconsin,FOND DU LAC,101633,93398,1226,4368,8235,0.918973168,0.081026832,0.042978167
Wisconsin,FOREST,9304,7646,71,138,1658,0.821797077,0.178202923,0.01483233
Wisconsin,GRANT,51208,49296,573,649,1912,0.962662084,0.037337916,0.012673801
Wisconsin,GREEN,36842,35113,137,1033,1729,0.953069866,0.046930134,0.028038652
Wisconsin,GREEN LAKE,19051,17990,79,743,1061,0.944307385,0.055692615,0.039000577
Wisconsin,IOWA,23687,22904,86,336,783,0.966943893,0.033056107,0.014184996
Wisconsin,IRON,5916,5772,3,35,144,0.975659229,0.024340771,0.00591616
Wisconsin,JACKSON,20449,17987,390,519,2462,0.879602915,0.120397085,0.025380214
Wisconsin,JEFFERSON,83686,75903,628,5555,7783,0.906997586,0.093002414,0.066379084
Wisconsin,JUNEAU,26664,24706,545,687,1958,0.926567657,0.073432343,0.025765077
Wisconsin,KENOSHA,166426,129892,10655,19592,36534,0.780479012,0.219520988,0.117721991
Wisconsin,KEWAUNEE,20574,19724,63,463,850,0.95868572,0.04131428,0.022504131
Wisconsin,LA CROSSE,114638,104417,1553,1741,10221,0.910841082,0.089158918,0.015186936
Wisconsin,LAFAYETTE,16836,16102,39,522,734,0.956402946,0.043597054,0.031004989
Wisconsin,LANGLADE,19977,19109,70,324,868,0.956550033,0.043449967,0.016218651
Wisconsin,LINCOLN,28743,27763,152,340,980,0.965904742,0.034095258,0.011828967
Wisconsin,MANITOWOC,81442,75210,412,2565,6232,0.923479286,0.076520714,0.031494806
Wisconsin,MARATHON,134063,121007,820,2992,13056,0.902612951,0.097387049,0.022317865
Wisconsin,MARINETTE,41749,40260,106,522,1489,0.964334475,0.035665525,0.012503293
Wisconsin,MARQUETTE,15404,14697,75,391,707,0.95410283,0.04589717,0.025383017
Wisconsin,MENOMINEE,4232,447,19,178,3785,0.105623819,0.894376181,0.042060491
Wisconsin,MILWAUKEE,947735,514958,248794,126039,432777,0.543356529,0.456643471,0.132989707
Wisconsin,MONROE,44673,41260,475,1661,3413,0.923600385,0.076399615,0.037181295
Wisconsin,OCONTO,37660,36167,68,519,1493,0.960355815,0.039644185,0.0137812
Wisconsin,ONEIDA,35998,34560,150,385,1438,0.960053336,0.039946664,0.010695039
Wisconsin,OUTAGAMIE,176695,158366,1682,6359,18329,0.89626758,0.10373242,0.035988568
Wisconsin,OZAUKEE,86395,80689,1144,1956,5706,0.933954511,0.066045489,0.022640199
Wisconsin,PEPIN,7469,7305,18,72,164,0.978042576,0.021957424,0.009639845
Wisconsin,PIERCE,41019,39264,223,623,1755,0.957214949,0.042785051,0.015188084
Wisconsin,POLK,44205,42475,91,656,1730,0.960864156,0.039135844,0.01483995
Wisconsin,PORTAGE,70019,64897,362,1853,5122,0.926848427,0.073151573,0.026464245
Wisconsin,PRICE,14159,13661,34,153,498,0.964828025,0.035171975,0.010805848
Wisconsin,RACINE,195408,145414,21212,22546,49994,0.744155818,0.255844182,0.115379104
Wisconsin,RICHLAND,18021,17315,79,360,706,0.960823484,0.039176516,0.019976694
Wisconsin,ROCK,160331,135526,7766,12124,24805,0.845288809,0.154711191,0.075618564
Wisconsin,RUSK,14755,14284,56,173,471,0.968078617,0.031921383,0.011724839
Wisconsin,ST. CROIX,84345,79895,542,1692,4450,0.9472405,0.0527595,0.020060466
Wisconsin,SAUK,61976,57331,330,2675,4645,0.925051633,0.074948367,0.043161869
Wisconsin,SAWYER,16557,13004,76,268,3553,0.785407985,0.214592015,0.016186507
Wisconsin,SHAWANO,41949,36951,131,905,4998,0.880855324,0.119144676,0.021573816
Wisconsin,SHEBOYGAN,115507,100520,1605,6329,14987,0.870250288,0.129749712,0.054793216
Wisconsin,TAYLOR,20689,20110,54,316,579,0.972014114,0.027985886,0.015273817
Wisconsin,TREMPEALEAU,28816,26774,54,1667,2042,0.929136591,0.070863409,0.057849806
Wisconsin,VERNON,29773,28873,106,394,900,0.969771269,0.030228731,0.013233467
Wisconsin,VILAS,21430,18546,31,268,2884,0.865422305,0.134577695,0.012505833
Wisconsin,WALWORTH,102228,88690,904,10578,13538,0.867570529,0.132429471,0.103474586
Wisconsin,WASHBURN,15911,15228,26,208,683,0.957073723,0.042926277,0.013072717
Wisconsin,WASHINGTON,131887,124348,1115,3385,7539,0.942837429,0.057162571,0.025665911
Wisconsin,WAUKESHA,389891,353114,4726,16123,36777,0.905673637,0.094326363,0.041352583
Wisconsin,WAUPACA,52410,50150,149,1307,2260,0.956878458,0.043121542,0.024937989
Wisconsin,WAUSHARA,24496,22317,445,1329,2179,0.911046702,0.088953298,0.054253756
Wisconsin,WINNEBAGO,166994,151509,2856,5784,15485,0.907272118,0.092727882,0.034635975
Wisconsin,WOOD,74749,70177,382,1680,4572,0.938835302,0.061164698,0.022475217
Wyoming,ALBANY,36299,30796,390,3202,5503,0.848398027,0.151601973,0.088211796
Wyoming,BIG HORN,11668,10435,25,984,1233,0.894326363,0.105673637,0.084333219
Wyoming,CAMPBELL,46133,41032,134,3611,5101,0.889428392,0.110571608,0.078273687
Wyoming,CARBON,15885,12683,109,2668,3202,0.798426188,0.201573812,0.167957192
Wyoming,CONVERSE,13833,12632,43,867,1201,0.913178631,0.086821369,0.062676209
Wyoming,CROOK,7083,6794,14,141,289,0.95919808,0.04080192,0.019906819
Wyoming,FREMONT,40123,28677,86,2264,11446,0.714727214,0.285272786,0.056426489
Wyoming,GOSHEN,13249,11651,70,1288,1598,0.879387124,0.120612876,0.097214884
Wyoming,HOT SPRINGS,4812,4550,12,105,262,0.945552785,0.054447215,0.021820449
Wyoming,JOHNSON,8569,8092,14,276,477,0.944334228,0.055665772,0.032209126
Wyoming,LARAMIE,91738,74120,2063,11978,17618,0.807953084,0.192046916,0.130567486
Wyoming,LINCOLN,18106,16930,32,781,1176,0.935049155,0.064950845,0.043134872
Wyoming,NATRONA,75450,67191,621,5231,8259,0.890536779,0.109463221,0.069330683
Wyoming,NIOBRARA,2484,2361,4,52,123,0.950483092,0.049516908,0.020933977
Wyoming,PARK,28205,26090,50,1365,2115,0.925013296,0.074986704,0.048395675
Wyoming,PLATTE,8667,7908,25,580,759,0.912426445,0.087573555,0.066920503
Wyoming,SHERIDAN,29116,27119,94,1013,1997,0.931412282,0.068587718,0.034791867
Wyoming,SUBLETTE,10247,9260,30,712,987,0.903679126,0.096320874,0.069483751
Wyoming,SWEETWATER,43806,35432,415,6689,8374,0.808838972,0.191161028,0.152695978
Wyoming,TETON,21294,17505,32,3191,3789,0.822062553,0.177937447,0.149854419
Wyoming,UINTA,21118,18696,48,1855,2422,0.885311109,0.114688891,0.087839758
Wyoming,WASHAKIE,8533,7158,22,1162,1375,0.838860893,0.161139107,0.136177194
Wyoming,WESTON,7208,6762,18,216,446,0.938124306,0.061875694,0.029966704