state,county,total_pop,white,black,latino,non_white,pct_white,pct_nonwhite,pct_latino
Alabama,AUTAUGA,34222,26997,6806,230,7225,0.788878499,0.211121501,0.006720823
Alabama,BALDWIN,98280,83800,12592,1022,14480,0.852665853,0.147334147,0.01039886
Alabama,BARBOUR,25417,14054,11156,124,11363,0.552937011,0.447062989,0.004878625
Alabama,BIBB,16576,13033,3468,39,3543,0.786257239,0.213742761,0.002352799
Alabama,BLOUNT,39248,38275,519,286,973,0.975208928,0.024791072,0.007286996
Alabama,BULLOCK,11042,3011,7948,65,8031,0.272686108,0.727313892,0.005886615
Alabama,BUTLER,21892,13001,8783,65,8891,0.593869907,0.406130093,0.002969121
Alabama,CALHOUN,116034,92154,21476,1282,23880,0.794198252,0.205801748,0.011048486
Alabama,CHAMBERS,36876,23510,13187,127,13366,0.637542033,0.362457967,0.003443974
Alabama,CHEROKEE,19543,18118,1291,57,1425,0.927083866,0.072916134,0.002916645
Alabama,CHILTON,32458,28577,3664,116,3881,0.880430094,0.119569906,0.003573849
Alabama,CHOCTAW,16018,8889,7052,53,7129,0.554938195,0.445061805,0.003308778
Alabama,CLARKE,27240,15481,11572,103,11759,0.568318649,0.431681351,0.003781204
Alabama,CLAY,13252,11021,2166,27,2231,0.831648053,0.168351947,0.002037428
Alabama,CLEBURNE,12730,12072,587,38,658,0.948311076,0.051688924,0.002985075
Alabama,COFFEE,40240,32396,6903,471,7844,0.805069583,0.194930417,0.011704771
Alabama,COLBERT,51666,42701,8545,187,8965,0.826481632,0.173518368,0.003619402
Alabama,CONECUH,14054,8026,5888,82,6028,0.571082966,0.428917034,0.005834638
Alabama,COOSA,11063,7230,3776,18,3833,0.653529784,0.346470216,0.001627045
Alabama,COVINGTON,36478,31460,4770,130,5018,0.862437634,0.137562366,0.003563792
Alabama,CRENSHAW,13635,10027,3542,30,3608,0.735386872,0.264613128,0.00220022
Alabama,CULLMAN,67613,66540,559,272,1073,0.984130271,0.015869729,0.004022895
Alabama,DALE,49633,38690,8767,1215,10943,0.779521689,0.220478311,0.024479681
Alabama,DALLAS,48130,20054,27768,131,28076,0.416663204,0.583336796,0.002721795
Alabama,DEKALB,54651,52854,1023,215,1797,0.967118625,0.032881375,0.003934054
Alabama,ELMORE,49210,37687,10995,270,11523,0.765840276,0.234159724,0.00548669
Alabama,ESCAMBIA,35518,24227,10015,169,11291,0.682104848,0.317895152,0.004758151
Alabama,ETOWAH,99840,85078,13782,331,14762,0.852143429,0.147856571,0.003315304
Alabama,FAYETTE,17962,15666,2190,78,2296,0.872174591,0.127825409,0.004342501
Alabama,FRANKLIN,27814,26375,1247,101,1439,0.948263464,0.051736536,0.003631265
Alabama,GENEVA,23647,20604,2817,121,3043,0.8713156,0.1286844,0.005116928
Alabama,GREENE,10153,1966,8160,24,8187,0.193637349,0.806362651,0.002363833
Alabama,HALE,15498,6241,9172,57,9257,0.402697122,0.597302878,0.003677894
Alabama,HENRY,15374,9878,5368,92,5496,0.642513334,0.357486666,0.005984129
Alabama,HOUSTON,81331,61233,18900,464,20098,0.752886353,0.247113647,0.005705082
Alabama,JACKSON,47796,44531,1957,208,3265,0.931688844,0.068311156,0.004351829
Alabama,JEFFERSON,651525,416458,228191,2745,235067,0.639204942,0.360795058,0.004213192
Alabama,LAMAR,15715,13748,1862,71,1967,0.874832962,0.125167038,0.004517976
Alabama,LAUDERDALE,79661,71310,7677,313,8351,0.895168276,0.104831724,0.00392915
Alabama,LAWRENCE,31513,24483,4790,102,7030,0.776917463,0.223082537,0.003236759
Alabama,LEE,87146,64527,20359,552,22619,0.740447066,0.259552934,0.006334198
Alabama,LIMESTONE,54135,46468,7106,261,7667,0.858372587,0.141627413,0.00482128
Alabama,LOWNDES,12658,3177,9408,60,9481,0.250987518,0.749012482,0.004740085
Alabama,MACON,24928,3429,21290,103,21499,0.137556162,0.862443838,0.0041319
Alabama,MADISON,238912,182334,47826,2984,56578,0.763184771,0.236815229,0.012489954
Alabama,MARENGO,23084,11279,11707,75,11805,0.488606827,0.511393173,0.003249004
Alabama,MARION,29830,28708,965,65,1122,0.962386859,0.037613141,0.002179014
Alabama,MARSHALL,70832,69118,1086,289,1714,0.975801897,0.024198103,0.004080077
Alabama,MOBILE,378643,252660,117509,3164,125983,0.66727762,0.33272238,0.008356156
Alabama,MONROE,23968,14251,9354,94,9717,0.594584446,0.405415554,0.003921896
Alabama,MONTGOMERY,209085,118480,87050,1624,90605,0.566659493,0.433340507,0.007767176
Alabama,MORGAN,100043,88726,10042,584,11317,0.886878642,0.113121358,0.00583749
Alabama,PERRY,12759,4496,8196,36,8263,0.352378713,0.647621287,0.002821538
Alabama,PICKENS,20699,11973,8625,50,8726,0.578433741,0.421566259,0.002415576
Alabama,PIKE,27595,17760,9513,108,9835,0.643594854,0.356405146,0.003913752
Alabama,RANDOLPH,19881,15104,4672,53,4777,0.759720336,0.240279664,0.002665862
Alabama,RUSSELL,46860,28311,18041,301,18549,0.604161332,0.395838668,0.006423389
Alabama,ST. CLAIR,50009,45038,4545,209,4971,0.900597892,0.099402108,0.004179248
Alabama,SHELBY,99358,90292,7698,525,9066,0.908754202,0.091245798,0.005283923
Alabama,SUMTER,16174,4745,11313,78,11429,0.293372079,0.706627921,0.004822555
Alabama,TALLADEGA,74107,50696,22620,490,23411,0.684091921,0.315908079,0.006612061
Alabama,TALLAPOOSA,38826,28461,10187,71,10365,0.733039716,0.266960284,0.001828672
Alabama,TUSCALOOSA,150522,108801,39272,948,41721,0.72282457,0.27717543,0.006298083
Alabama,WALKER,67670,62863,4397,224,4807,0.92896409,0.07103591,0.003310182
Alabama,WASHINGTON,16694,10958,4612,51,5736,0.656403498,0.343596502,0.00305499
Alabama,WILCOX,13568,4185,9332,40,9383,0.308446344,0.691553656,0.002948113
Alabama,WINSTON,22053,21871,57,59,182,0.991747155,0.008252845,0.002675373
Alaska,ALEUTIANS EAST BOROUGH,2464,801,15,180,1663,0.325081169,0.674918831,0.073051948
Alaska,ALEUTIANS WEST CENSUS AREA,9478,6130,635,742,3348,0.64676092,0.35323908,0.078286558
Alaska,ANCHORAGE BOROUGH,226338,178168,14126,9258,48170,0.7871767,0.2128233,0.040903428
Alaska,BETHEL CENSUS AREA,13656,2074,62,80,11582,0.151874634,0.848125366,0.005858231
Alaska,BRISTOL BAY BOROUGH,1410,881,38,33,529,0.624822695,0.375177305,0.023404255
Alaska,DILLINGHAM CENSUS AREA,4012,1007,8,49,3005,0.250997009,0.749002991,0.01221336
Alaska,FAIRBANKS NORTH STAR BOROUGH,77720,62201,5395,2899,15519,0.800321668,0.199678332,0.037300566
Alaska,HAINES BOROUGH,2117,1793,1,27,324,0.846953236,0.153046764,0.012753897
Alaska,JUNEAU BOROUGH,26751,21257,279,749,5494,0.7946245,0.2053755,0.027998953
Alaska,KENAI PENINSULA BOROUGH,40802,36580,196,726,4222,0.89652468,0.10347532,0.017793245
Alaska,KETCHIKAN GATEWAY BOROUGH,13828,11182,55,285,2646,0.808649118,0.191350882,0.020610356
Alaska,KODIAK ISLAND BOROUGH,13309,9008,133,663,4301,0.676835224,0.323164776,0.049815914
Alaska,LAKE AND PENINSULA BOROUGH,1668,379,0,32,1289,0.227218225,0.772781775,0.019184652
Alaska,MATANUSKA-SUSITNA BOROUGH,39683,36452,294,752,3231,0.918579744,0.081420256,0.01895018
Alaska,NOME CENSUS AREA,8288,1987,9,106,6301,0.239744208,0.760255792,0.012789575
Alaska,NORTH SLOPE BOROUGH,5979,1248,37,124,4731,0.208730557,0.791269443,0.020739254
Alaska,NORTHWEST ARCTIC BOROUGH,6113,824,12,36,5289,0.1347947,0.8652053,0.005889089
Alaska,PRINCE OF WALES-OUTER KETCHIKAN CENSUS AREA,6278,3798,9,121,2480,0.604969736,0.395030264,0.019273654
Alaska,SITKA BOROUGH,8588,6270,39,209,2318,0.730088496,0.269911504,0.024336283
Alaska,SKAGWAY-YAKUTAT-ANGOON CENSUS AREA,4385,2622,6,67,1763,0.597947548,0.402052452,0.015279361
Alaska,SOUTHEAST FAIRBANKS CENSUS AREA,5913,4612,284,177,1301,0.779976323,0.220023677,0.029934044
Alaska,VALDEZ-CORDOVA CENSUS AREA,9952,8096,55,270,1856,0.813504823,0.186495177,0.027130225
Alaska,WADE HAMPTON CENSUS AREA,5791,342,12,17,5449,0.059057158,0.940942842,0.00293559
Alaska,WRANGELL-PETERSBURG CENSUS AREA,7042,5472,11,119,1570,0.777051974,0.222948026,0.016898608
Alaska,YUKON-KOYUKUK CENSUS AREA,8478,3538,88,82,4940,0.417315405,0.582684595,0.009672092
Arizona,APACHE,61591,11354,98,2599,50237,0.184345115,0.815654885,0.042197724
Arizona,COCHISE,97624,61543,4815,28379,36081,0.630408506,0.369591494,0.29069696
Arizona,COCONINO,96591,56938,1339,9696,39653,0.58947521,0.41052479,0.100382023
Arizona,GILA,40216,27377,97,7486,12839,0.680748956,0.319251044,0.186144818
Arizona,GRAHAM,26554,15437,468,6682,11117,0.581343677,0.418656323,0.251638171
Arizona,GREENLEE,8008,4372,27,3456,3636,0.545954046,0.454045954,0.431568432
Arizona,LA PAZ,13844,8495,103,3139,5349,0.61362323,0.38637677,0.226740826
Arizona,MARICOPA,2122101,1637076,70843,345498,485025,0.771441133,0.228558867,0.162809404
Arizona,MOHAVE,93497,85808,291,4919,7689,0.917762067,0.082237933,0.052611314
Arizona,NAVAJO,77658,31256,667,5652,46402,0.40248268,0.59751732,0.072780654
Arizona,PIMA,666880,454919,19455,163262,211961,0.682160209,0.317839791,0.244814659
Arizona,PINAL,116379,68900,3469,34062,47479,0.592031208,0.407968792,0.292681669
Arizona,SANTA CRUZ,29676,6168,56,23221,23508,0.207844723,0.792155277,0.782484162
Arizona,YAVAPAI,107714,98391,305,6899,9323,0.91344672,0.08655328,0.064049242
Arizona,YUMA,106895,58151,2776,43388,48744,0.544001123,0.455998877,0.405893634
Arkansas,ARKANSAS,21653,16779,4724,61,4874,0.77490417,0.22509583,0.002817162
Arkansas,ASHLEY,24319,17406,6607,220,6913,0.715736667,0.284263333,0.009046425
Arkansas,BAXTER,31186,30827,4,171,359,0.988488424,0.011511576,0.00548323
Arkansas,BENTON,97499,94158,118,1359,3341,0.965732982,0.034267018,0.013938604
Arkansas,BOONE,28297,27911,5,171,386,0.986358978,0.013641022,0.006043043
Arkansas,BRADLEY,11793,7936,3641,191,3857,0.672941576,0.327058424,0.016196049
Arkansas,CALHOUN,5826,4346,1437,31,1480,0.745966358,0.254033642,0.005320975
Arkansas,CARROLL,18654,18261,4,194,393,0.978932133,0.021067867,0.010399914
Arkansas,CHICOT,15713,6666,8811,159,9047,0.42423471,0.57576529,0.01011901
Arkansas,CLARK,21437,16267,4898,127,5170,0.758828194,0.241171806,0.005924336
Arkansas,CLAY,18107,17976,5,70,131,0.992765229,0.007234771,0.003865908
Arkansas,CLEBURNE,19411,19213,6,105,198,0.989799598,0.010200402,0.005409304
Arkansas,CLEVELAND,7781,6653,1053,47,1128,0.855031487,0.144968513,0.006040355
Arkansas,COLUMBIA,25691,16516,8982,77,9175,0.642871044,0.357128956,0.002997159
Arkansas,CONWAY,19151,16071,2860,119,3080,0.839172889,0.160827111,0.006213775
Arkansas,CRAIGHEAD,68956,64225,3764,386,4731,0.931391032,0.068608968,0.005597772
Arkansas,CRAWFORD,42493,40654,361,459,1839,0.956722284,0.043277716,0.010801779
Arkansas,CRITTENDEN,49939,27988,21334,336,21951,0.560443741,0.439556259,0.006728208
Arkansas,CROSS,19225,14285,4751,109,4940,0.743042913,0.256957087,0.005669701
Arkansas,DALLAS,9614,5861,3694,32,3753,0.609631787,0.390368213,0.003328479
Arkansas,DESHA,16798,9448,7110,152,7350,0.56244791,0.43755209,0.009048696
Arkansas,DREW,17369,12482,4743,92,4887,0.718636652,0.281363348,0.005296793
Arkansas,FAULKNER,60006,54405,4771,341,5601,0.906659334,0.093340666,0.005682765
Arkansas,FRANKLIN,14897,14506,98,179,391,0.973753105,0.026246895,0.012015842
Arkansas,FULTON,10037,9943,9,28,94,0.990634652,0.009365348,0.002789678
Arkansas,GARLAND,73397,66309,5594,777,7088,0.903429295,0.096570705,0.010586264
Arkansas,GRANT,13948,13432,377,82,516,0.963005449,0.036994551,0.005878979
Arkansas,GREENE,31804,31498,20,167,306,0.990378569,0.009621431,0.005250912
Arkansas,HEMPSTEAD,21621,14779,6450,291,6842,0.683548402,0.316451598,0.013459137
Arkansas,HOT SPRING,26115,22979,2861,115,3136,0.879915757,0.120084243,0.004403599
Arkansas,HOWARD,13569,10460,2906,94,3109,0.770874788,0.229125212,0.006927555
Arkansas,INDEPENDENCE,31192,30239,595,172,953,0.969447294,0.030552706,0.005514234
Arkansas,IZARD,11364,11212,11,71,152,0.986624428,0.013375572,0.0062478
Arkansas,JACKSON,18944,16042,2748,66,2902,0.846811655,0.153188345,0.003483953
Arkansas,JEFFERSON,85487,47706,36771,427,37781,0.558049762,0.441950238,0.004994912
Arkansas,JOHNSON,18221,17509,306,221,712,0.960924208,0.039075792,0.012128862
Arkansas,LAFAYETTE,9643,5867,3699,41,3776,0.608420616,0.391579384,0.004251789
Arkansas,LAWRENCE,17457,17168,88,60,289,0.983445036,0.016554964,0.003437017
Arkansas,LEE,13053,5375,7447,174,7678,0.411782732,0.588217268,0.013330269
Arkansas,LINCOLN,13690,8557,4896,152,5133,0.625054785,0.374945215,0.011102995
Arkansas,LITTLE RIVER,13966,10755,2924,160,3211,0.770084491,0.229915509,0.011456394
Arkansas,LOGAN,20557,19990,272,143,567,0.972418154,0.027581846,0.006956268
Arkansas,LONOKE,39268,35216,3529,246,4052,0.896811653,0.103188347,0.006264643
Arkansas,MADISON,11618,11354,3,111,264,0.97727664,0.02272336,0.00955414
Arkansas,MARION,12001,11865,6,48,136,0.988667611,0.011332389,0.003999667
Arkansas,MILLER,38467,29265,8602,310,9202,0.760781969,0.239218031,0.008058856
Arkansas,MISSISSIPPI,57525,40303,15972,745,17222,0.700617123,0.299382877,0.012950891
Arkansas,MONROE,11333,6855,4403,32,4478,0.604870731,0.395129269,0.002823612
Arkansas,MONTGOMERY,7841,7673,8,56,168,0.978574161,0.021425839,0.007141946
Arkansas,NEVADA,10101,6816,3190,64,3285,0.674784675,0.325215325,0.006336006
Arkansas,NEWTON,7666,7556,0,43,110,0.985650926,0.014349074,0.005609183
Arkansas,OUACHITA,30574,19617,10712,133,10957,0.641623602,0.358376398,0.004350101
Arkansas,PERRY,7969,7748,119,47,221,0.972267537,0.027732463,0.005897854
Arkansas,PHILLIPS,28838,12793,15705,237,16045,0.443616062,0.556383938,0.008218323
Arkansas,PIKE,10086,9598,374,56,488,0.951616102,0.048383898,0.005552251
Arkansas,POINSETT,24664,22700,1770,124,1964,0.92036977,0.07963023,0.005027571
Arkansas,POLK,17347,16832,0,301,515,0.970311869,0.029688131,0.017351703
Arkansas,POPE,45883,43830,1119,423,2053,0.955255759,0.044744241,0.009219101
Arkansas,PRAIRIE,9518,8151,1294,38,1367,0.85637739,0.14362261,0.003992435
Arkansas,PULASKI,349660,250549,91976,3199,99111,0.716550363,0.283449637,0.009148887
Arkansas,RANDOLPH,16558,16265,145,75,293,0.982304626,0.017695374,0.004529533
Arkansas,ST. FRANCIS,28497,14651,13480,202,13846,0.514124294,0.485875706,0.007088465
Arkansas,SALINE,64183,61937,1346,378,2246,0.96500631,0.03499369,0.00588941
Arkansas,SCOTT,10205,10003,1,42,202,0.980205781,0.019794219,0.00411563
Arkansas,SEARCY,7841,7726,2,32,115,0.985333503,0.014666497,0.004081112
Arkansas,SEBASTIAN,99590,87989,5617,1362,11601,0.883512401,0.116487599,0.013676072
Arkansas,SEVIER,13637,11999,784,632,1638,0.879885605,0.120114395,0.046344504
Arkansas,SHARP,14109,13870,64,57,239,0.983060458,0.016939542,0.004039974
Arkansas,STONE,9775,9652,8,42,123,0.98741688,0.01258312,0.004296675
Arkansas,UNION,46719,32296,14038,222,14423,0.69128192,0.30871808,0.004751814
Arkansas,VAN BUREN,14008,13774,41,98,234,0.98329526,0.01670474,0.006996002
Arkansas,WASHINGTON,113409,107724,1656,1526,5685,0.949871703,0.050128297,0.013455722
Arkansas,WHITE,54676,52260,1694,372,2416,0.955812422,0.044187578,0.006803716
Arkansas,WOODRUFF,9520,6496,2982,17,3024,0.682352941,0.317647059,0.001785714
Arkansas,YELL,17759,17059,367,177,700,0.960583366,0.039416634,0.009966777
California,ALAMEDA,1279182,680017,222873,181805,599165,0.531603009,0.468396991,0.142125984
California,ALPINE,1113,772,5,74,341,0.693620845,0.306379155,0.066486972
California,AMADOR,30039,25129,1670,2520,4910,0.836545824,0.163454176,0.083890942
California,BUTTE,182120,158242,2238,13606,23878,0.868888645,0.131111355,0.074708983
California,CALAVERAS,31998,29288,180,1714,2710,0.915307207,0.084692793,0.053565848
California,COLUSA,16275,10105,81,5424,6170,0.620890937,0.379109063,0.333271889
California,CONTRA COSTA,803732,560146,72799,91282,243586,0.696931315,0.303068685,0.113572683
California,DEL NORTE,23460,18302,853,2414,5158,0.780136402,0.219863598,0.102898551
California,EL DORADO,125995,113053,579,8777,12942,0.897281638,0.102718362,0.069661495
California,FRESNO,667490,338595,31311,236634,328895,0.507266026,0.492733974,0.354513176
California,GLENN,24798,18461,131,4958,6337,0.744455198,0.255544802,0.199935479
California,HUMBOLDT,119118,104671,934,4989,14447,0.878716903,0.121283097,0.041882839
California,IMPERIAL,109303,31742,2272,71935,77561,0.29040374,0.70959626,0.658124663
California,INYO,18281,14819,71,1536,3462,0.810623051,0.189376949,0.084021662
California,KERN,543477,340892,28851,151995,202585,0.627242735,0.372757265,0.279671449
California,KINGS,101469,54426,7747,34551,47043,0.536380569,0.463619431,0.340507938
California,LAKE,50631,44603,924,3633,6028,0.880942506,0.119057494,0.071754459
California,LASSEN,27598,21920,1699,2883,5678,0.794260454,0.205739546,0.104464092
California,LOS ANGELES,8863164,3618850,934776,3351242,5244314,0.408302272,0.591697728,0.378108991
California,MADERA,88090,52974,2294,30400,35116,0.601362243,0.398637757,0.345101601
California,MARIN,230096,194665,7529,17930,35431,0.846016445,0.153983555,0.077923997
California,MARIPOSA,14302,12771,120,697,1531,0.892952035,0.107047965,0.048734443
California,MENDOCINO,80345,67775,482,8248,12570,0.843549692,0.156450308,0.10265729
California,MERCED,178403,96701,7889,58107,81702,0.542036849,0.457963151,0.325706406
California,MODOC,9678,8479,78,701,1199,0.876110767,0.123889233,0.072432321
California,MONO,9956,8329,41,1126,1627,0.836580956,0.163419044,0.11309763
California,MONTEREY,355660,186166,21506,119570,169494,0.523438115,0.476561885,0.336191869
California,NAPA,110765,89453,1167,15941,21312,0.807592651,0.192407349,0.143917302
California,NEVADA,78510,73697,172,3269,4813,0.938695708,0.061304292,0.041638008
California,ORANGE,2410556,1554501,39159,564828,856055,0.644872386,0.355127614,0.234314407
California,PLACER,172796,152601,987,13871,20195,0.883128082,0.116871918,0.080273849
California,PLUMAS,19739,17996,151,907,1743,0.911697654,0.088302346,0.045949643
California,RIVERSIDE,1170413,754140,59966,307514,416273,0.644336657,0.355663343,0.262739734
California,SACRAMENTO,1041219,721932,93970,121544,319287,0.693352695,0.306647305,0.116732407
California,SAN BENITO,36697,18793,167,16800,17904,0.512112707,0.487887293,0.45780309
California,SAN BERNARDINO,1418380,862113,109162,378582,556267,0.607815254,0.392184746,0.266911547
California,SAN DIEGO,2498016,1633281,149898,510781,864735,0.653831281,0.346168719,0.204474671
California,SAN FRANCISCO,723959,337118,76343,100717,386841,0.465658967,0.534341033,0.139119757
California,SAN JOAQUIN,480628,282766,24791,112673,197862,0.588326107,0.411673893,0.234428706
California,SAN LUIS OBISPO,217162,176246,4325,28923,40916,0.811587663,0.188412337,0.133186285
California,SAN MATEO,649623,392131,34000,114627,257492,0.603628566,0.396371434,0.176451573
California,SANTA BARBARA,369608,244309,9379,98199,125299,0.660994892,0.339005108,0.265684184
California,SANTA CLARA,1497577,869874,52583,314564,627703,0.580854273,0.419145727,0.210048632
California,SANTA CRUZ,229734,171203,2330,46797,58531,0.745222736,0.254777264,0.203700802
California,SHASTA,147036,134001,1045,5652,13035,0.911348241,0.088651759,0.038439566
California,SIERRA,3318,3060,6,184,258,0.922242315,0.077757685,0.055455093
California,SISKIYOU,43531,38246,682,2549,5285,0.878592268,0.121407732,0.058555972
California,SOLANO,340421,207476,43858,45517,132945,0.609468864,0.390531136,0.133707967
California,SONOMA,388222,327429,5268,41223,60793,0.843406608,0.156593392,0.106184091
California,STANISLAUS,370522,261323,6109,80897,109199,0.705283357,0.294716643,0.218332515
California,SUTTER,64415,46140,987,10592,18275,0.716292789,0.283707211,0.16443375
California,TEHAMA,49625,43049,246,5124,6576,0.867486146,0.132513854,0.103254408
California,TRINITY,13063,11881,53,431,1182,0.909515425,0.090484575,0.032993952
California,TULARE,311921,170283,4305,120893,141638,0.545917075,0.454082925,0.3875757
California,TUOLUMNE,48456,41887,1529,3726,6569,0.864433713,0.135566287,0.076894502
California,VENTURA,669016,440555,14559,176952,228461,0.658511904,0.341488096,0.264495916
California,YOLO,141092,96825,2975,28182,44267,0.686254359,0.313745641,0.199742012
California,YUBA,58228,42924,2341,6728,15304,0.73717112,0.26282888,0.115545786
Colorado,ADAMS,265038,198710,8445,49179,66328,0.749741546,0.250258454,0.185554524
Colorado,ALAMOSA,13617,8068,61,5254,5549,0.592494676,0.407505324,0.385841228
Colorado,ARAPAHOE,391511,334225,22653,21743,57286,0.853679718,0.146320282,0.055536115
Colorado,ARCHULETA,5345,3976,5,1244,1369,0.743872778,0.256127222,0.232740879
Colorado,BACA,4556,4229,1,255,327,0.928226514,0.071773486,0.055970149
Colorado,BENT,5048,3588,32,1371,1460,0.710776545,0.289223455,0.27159271
Colorado,BOULDER,225339,201617,1879,15195,23722,0.894727499,0.105272501,0.067431736
Colorado,CHAFFEE,12684,11148,198,1200,1536,0.878902554,0.121097446,0.094607379
Colorado,CHEYENNE,2397,2307,0,83,90,0.962453066,0.037546934,0.034626617
Colorado,CLEAR CREEK,7619,7280,17,254,339,0.955505972,0.044494028,0.033337708
Colorado,CONEJOS,7453,2933,9,4463,4520,0.393532806,0.606467194,0.598819267
Colorado,COSTILLA,3190,688,7,2452,2502,0.215673981,0.784326019,0.768652038
Colorado,CROWLEY,3946,2694,254,912,1252,0.682716675,0.317283325,0.231120122
Colorado,CUSTER,1926,1842,0,55,84,0.956386293,0.043613707,0.028556594
Colorado,DELTA,20980,18836,59,1915,2144,0.897807436,0.102192564,0.091277407
Colorado,DENVER,467610,287162,57793,107382,180448,0.614105772,0.385894228,0.229640085
Colorado,DOLORES,1504,1416,0,48,88,0.941489362,0.058510638,0.031914894
Colorado,DOUGLAS,60391,57346,391,1910,3045,0.94957858,0.05042142,0.031627229
Colorado,EAGLE,21928,18762,40,2917,3166,0.855618387,0.144381613,0.133026268
Colorado,ELBERT,9646,9289,46,211,357,0.96298984,0.03701016,0.021874352
Colorado,EL PASO,397014,322461,27599,34473,74553,0.81221569,0.18778431,0.086830691
Colorado,FREMONT,32273,28292,834,2759,3981,0.876646113,0.123353887,0.085489418
Colorado,GARFIELD,29974,27908,77,1673,2066,0.931073597,0.068926403,0.05581504
Colorado,GILPIN,3070,2900,14,109,170,0.944625407,0.055374593,0.035504886
Colorado,GRAND,7966,7641,16,243,325,0.959201607,0.040798393,0.030504645
Colorado,GUNNISON,10273,9746,59,366,527,0.948700477,0.051299523,0.035627373
Colorado,HINSDALE,467,460,1,4,7,0.985010707,0.014989293,0.00856531
Colorado,HUERFANO,6009,3498,20,2428,2511,0.58212681,0.41787319,0.404060576
Colorado,JACKSON,1605,1460,0,118,145,0.909657321,0.090342679,0.073520249
Colorado,JEFFERSON,438430,394946,3014,30791,43484,0.900818831,0.099181169,0.070230139
Colorado,KIOWA,1688,1621,0,55,67,0.960308057,0.039691943,0.032582938
Colorado,KIT CARSON,7140,6636,8,468,504,0.929411765,0.070588235,0.065546218
Colorado,LAKE,6007,4497,11,1434,1510,0.748626602,0.251373398,0.238721492
Colorado,LA PLATA,32284,27091,58,3586,5193,0.839146326,0.160853674,0.111076694
Colorado,LARIMER,186136,169213,1043,12227,16923,0.909082606,0.090917394,0.065688529
Colorado,LAS ANIMAS,13765,7507,31,6080,6258,0.545368689,0.454631311,0.441699964
Colorado,LINCOLN,4529,4413,4,75,116,0.974387282,0.025612718,0.016559947
Colorado,LOGAN,17567,16073,19,1393,1494,0.914954175,0.085045825,0.079296408
Colorado,MESA,93145,84035,368,7563,9110,0.902195502,0.097804498,0.081195985
Colorado,MINERAL,558,528,0,27,30,0.946236559,0.053763441,0.048387097
Colorado,MOFFAT,11357,10524,10,698,833,0.926653165,0.073346835,0.061459893
Colorado,MONTEZUMA,18672,14936,12,1612,3736,0.79991431,0.20008569,0.086332476
Colorado,MONTROSE,24423,21447,61,2736,2976,0.878147648,0.121852352,0.11202555
Colorado,MORGAN,21939,17667,45,4034,4272,0.805278272,0.194721728,0.183873467
Colorado,OTERO,20185,12698,109,7104,7487,0.629081001,0.370918999,0.351944513
Colorado,OURAY,2295,2187,0,103,108,0.952941176,0.047058824,0.044880174
Colorado,PARK,7174,6863,39,206,311,0.95664901,0.04335099,0.028714803
Colorado,PHILLIPS,4189,4006,0,170,183,0.956314156,0.043685844,0.040582478
Colorado,PITKIN,12661,11955,38,475,706,0.944238212,0.055761788,0.037516784
Colorado,PROWERS,13347,10071,38,3102,3276,0.754551585,0.245448415,0.232411778
Colorado,PUEBLO,123051,75382,2029,44090,47669,0.612607781,0.387392219,0.358306718
Colorado,RIO BLANCO,5972,5672,9,236,300,0.949765573,0.050234427,0.039517749
Colorado,RIO GRANDE,10770,6352,5,4342,4418,0.589786444,0.410213556,0.403156917
Colorado,ROUTT,14088,13630,8,353,458,0.967490062,0.032509938,0.025056786
Colorado,SAGUACHE,4619,2371,11,2106,2248,0.51331457,0.48668543,0.455942845
Colorado,SAN JUAN,745,620,1,118,125,0.832214765,0.167785235,0.158389262
Colorado,SAN MIGUEL,3653,3523,5,102,130,0.964412811,0.035587189,0.027922256
Colorado,SEDGWICK,2690,2411,5,230,279,0.896282528,0.103717472,0.085501859
Colorado,SUMMIT,12881,12359,31,323,522,0.959475196,0.040524804,0.025075693
Colorado,TELLER,12468,11980,23,322,488,0.960859801,0.039140199,0.025826115
Colorado,WASHINGTON,4812,4652,1,139,160,0.966749792,0.033250208,0.028886118
Colorado,WELD,131821,101977,509,27502,29844,0.773602082,0.226397918,0.208631402
Colorado,YUMA,8954,8620,2,284,334,0.962698235,0.037301765,0.031717668
Connecticut,FAIRFIELD,827645,660337,77472,70818,167308,0.797850528,0.202149472,0.085565671
Connecticut,HARTFORD,851783,683004,81884,71575,168779,0.801852115,0.198147885,0.084029618
Connecticut,LITCHFIELD,174092,168876,1561,1907,5216,0.97003883,0.02996117,0.010953978
Connecticut,MIDDLESEX,143196,132667,5846,2881,10529,0.92647141,0.07352859,0.020119277
Connecticut,NEW HAVEN,804219,661754,78935,51003,142465,0.822852979,0.177147021,0.063419293
Connecticut,NEW LONDON,254957,230179,11587,8455,24778,0.902814984,0.097185016,0.033162455
Connecticut,TOLLAND,128699,121269,2533,2216,7430,0.942268394,0.057731606,0.017218471
Connecticut,WINDHAM,102525,96098,1022,4261,6427,0.937312851,0.062687149,0.041560595
Delaware,KENT,110993,86071,20316,2540,24922,0.775463318,0.224536682,0.022884326
Delaware,NEW CASTLE,441946,350312,71895,11804,91634,0.792657927,0.207342073,0.026709145
Delaware,SUSSEX,113229,91709,18800,1476,21520,0.809942683,0.190057317,0.01303553
District of Columbia,DISTRICT OF COLUMBIA,606900,166131,395213,32710,440769,0.273737024,0.726262976,0.053896853
Florida,ALACHUA,181596,135690,34116,6779,45906,0.747208088,0.252791912,0.037330117
Florida,BAKER,18486,15444,2738,200,3042,0.835443038,0.164556962,0.010818998
Florida,BAY,126994,108004,13612,2256,18990,0.850465376,0.149534624,0.017764619
Florida,BRADFORD,22515,17406,4505,426,5109,0.77308461,0.22691539,0.01892072
Florida,BREVARD,398978,349276,30824,12261,49702,0.875426715,0.124573285,0.030731018
Florida,BROWARD,1255488,940345,186670,108439,315143,0.748987645,0.251012355,0.086371992
Florida,CALHOUN,11011,9094,1654,118,1917,0.825901371,0.174098629,0.010716556
Florida,CHARLOTTE,110975,103437,3857,2764,7538,0.932074792,0.067925208,0.02490651
Florida,CITRUS,93515,88963,2170,1702,4552,0.951323317,0.048676683,0.018200289
Florida,CLAY,105986,95794,5405,2764,10192,0.903836356,0.096163644,0.026078916
Florida,COLLIER,152099,124700,5770,20734,27399,0.819860749,0.180139251,0.136319108
Florida,COLUMBIA,42613,33978,7644,619,8635,0.797362307,0.202637693,0.014526084
Florida,DADE,1937094,585607,369621,953407,1351487,0.302312123,0.697687877,0.492184169
Florida,DESOTO,23865,17724,3672,2282,6141,0.742677561,0.257322439,0.095621203
Florida,DIXIE,10585,9524,918,96,1061,0.899763817,0.100236183,0.009069438
Florida,DUVAL,672971,478981,162420,17333,193990,0.711740922,0.288259078,0.025755939
Florida,ESCAMBIA,262798,198083,52333,5013,64715,0.753746223,0.246253777,0.019075488
Florida,FLAGLER,28701,24841,2270,1260,3860,0.865509913,0.134490087,0.043900909
Florida,FRANKLIN,8967,7727,1107,65,1240,0.861715178,0.138284822,0.007248801
Florida,GADSDEN,41105,16357,23620,964,24748,0.397932125,0.602067875,0.023452135
Florida,GILCHRIST,9667,8656,811,150,1011,0.895417399,0.104582601,0.015516706
Florida,GLADES,7591,5634,916,605,1957,0.742194704,0.257805296,0.079699644
Florida,GULF,11504,9193,2149,86,2311,0.799113352,0.200886648,0.007475661
Florida,HAMILTON,10930,6356,4219,295,4574,0.581518756,0.418481244,0.026989936
Florida,HARDEE,19499,13804,1008,4562,5695,0.70793374,0.29206626,0.233960716
Florida,HENDRY,25773,15184,4185,5757,10589,0.589143677,0.410856323,0.223373298
Florida,HERNANDO,101115,93701,3812,2962,7414,0.926677545,0.073322455,0.029293379
Florida,HIGHLANDS,68432,57592,6721,3500,10840,0.841594576,0.158405424,0.051145663
Florida,HILLSBOROUGH,834054,606466,107111,106908,227588,0.727130378,0.272869622,0.128178751
Florida,HOLMES,15778,14619,768,176,1159,0.926543288,0.073456712,0.011154772
Florida,INDIAN RIVER,90208,79349,7552,2704,10859,0.87962265,0.12037735,0.029975168
Florida,JACKSON,41375,29376,10721,974,11999,0.709993958,0.290006042,0.023540785
Florida,JEFFERSON,11296,6233,4883,130,5063,0.551788244,0.448211756,0.011508499
Florida,LAFAYETTE,5578,4554,772,226,1024,0.816421657,0.183578343,0.040516314
Florida,LAKE,152104,133071,13774,4305,19033,0.874868511,0.125131489,0.028303003
Florida,LEE,335113,296005,21515,15094,39108,0.883299066,0.116700934,0.045041523
Florida,LEON,192493,138396,46191,4715,54097,0.718966404,0.281033596,0.024494397
Florida,LEVY,25923,22014,3204,490,3909,0.849207268,0.150792732,0.018902133
Florida,LIBERTY,5569,4465,965,108,1104,0.801759741,0.198240259,0.019393069
Florida,MADISON,16569,9409,6867,231,7160,0.567867705,0.432132295,0.013941698
Florida,MANATEE,211707,184568,15971,9424,27139,0.871808679,0.128191321,0.044514352
Florida,MARION,194833,162861,24542,5860,31972,0.835900489,0.164099511,0.03007704
Florida,MARTIN,100900,89596,5887,4728,11304,0.887968285,0.112031715,0.046858276
Florida,MONROE,78024,63686,3896,9580,14338,0.81623603,0.18376397,0.122782734
Florida,NASSAU,43941,38697,4509,480,5244,0.880658155,0.119341845,0.010923739
Florida,OKALOOSA,143776,122233,12835,4427,21543,0.850162753,0.149837247,0.030790953
Florida,OKEECHOBEE,29627,23940,1875,3493,5687,0.808046714,0.191953286,0.117899214
Florida,ORANGE,677491,496544,100185,64946,180947,0.732916009,0.267083991,0.095862528
Florida,OSCEOLA,107728,87439,5452,12866,20289,0.811664563,0.188335437,0.119430417
Florida,PALM BEACH,863518,683402,103309,66613,180116,0.791416045,0.208583955,0.077141415
Florida,PASCO,281131,264308,5303,9309,16823,0.94015957,0.05984043,0.033112677
Florida,PINELLAS,851659,754802,65046,20069,96857,0.886272557,0.113727443,0.023564596
Florida,POLK,405382,331732,53500,16600,73650,0.818319511,0.181680489,0.040949031
Florida,PUTNAM,65070,51150,11874,1688,13920,0.786076533,0.213923467,0.025941294
Florida,ST. JOHNS,83829,73992,7261,1902,9837,0.882653974,0.117346026,0.022689046
Florida,ST. LUCIE,150171,118646,24200,5952,31525,0.790072651,0.209927349,0.039634816
Florida,SANTA ROSA,81608,75519,3231,1223,6089,0.925387217,0.074612783,0.014986276
Florida,SARASOTA,277776,258095,11855,5882,19681,0.929147947,0.070852053,0.021175336
Florida,SEMINOLE,287529,239612,23801,18606,47917,0.833348984,0.166651016,0.064709994
Florida,SUMTER,31577,25526,5064,762,6051,0.808373183,0.191626817,0.024131488
Florida,SUWANNEE,26780,22277,3915,417,4503,0.831852128,0.168147872,0.015571322
Florida,TAYLOR,17111,13682,3068,174,3429,0.799602595,0.200397405,0.010168897
Florida,UNION,10252,7499,2320,335,2753,0.731467031,0.268532969,0.032676551
Florida,VOLUSIA,370712,319259,32985,14840,51453,0.861204925,0.138795075,0.040031075
Florida,WAKULLA,14202,12162,1830,83,2040,0.856358259,0.143641741,0.005844247
Florida,WALTON,27760,25114,1870,244,2646,0.904682997,0.095317003,0.008789625
Florida,WASHINGTON,16919,13933,2449,180,2986,0.823512028,0.176487972,0.010638927
Georgia,APPLING,15744,12286,3266,138,3458,0.780360772,0.219639228,0.008765244
Georgia,ATKINSON,6213,4400,1654,154,1813,0.7081925,0.2918075,0.024786737
Georgia,BACON,9566,7992,1469,83,1574,0.835458917,0.164541083,0.008676563
Georgia,BAKER,3615,1745,1846,21,1870,0.482710927,0.517289073,0.005809129
Georgia,BALDWIN,39530,22209,16668,349,17321,0.561826461,0.438173539,0.008828738
Georgia,BANKS,10308,9844,364,52,464,0.954986418,0.045013582,0.005044626
Georgia,BARROW,29721,25834,3348,253,3887,0.869217052,0.130782948,0.0085125
Georgia,BARTOW,55911,50116,5013,521,5795,0.896353133,0.103646867,0.009318381
Georgia,BEN HILL,16245,11047,5068,78,5198,0.680024623,0.319975377,0.004801477
Georgia,BERRIEN,14153,12178,1642,277,1975,0.860453614,0.139546386,0.019571822
Georgia,BIBB,149967,85744,62330,916,64223,0.571752452,0.428247548,0.00610801
Georgia,BLECKLEY,10430,7975,2328,43,2455,0.764621285,0.235378715,0.004122723
Georgia,BRANTLEY,11077,10408,596,36,669,0.939604586,0.060395414,0.003249977
Georgia,BROOKS,15398,8725,6365,253,6673,0.56663203,0.43336797,0.016430705
Georgia,BRYAN,15438,12932,2289,136,2506,0.837673274,0.162326726,0.008809431
Georgia,BULLOCH,43125,31281,11195,360,11844,0.725356522,0.274643478,0.008347826
Georgia,BURKE,20579,9719,10750,67,10860,0.472277565,0.527722435,0.003255746
Georgia,BUTTS,15326,9711,5421,113,5615,0.633629127,0.366370873,0.007373091
Georgia,CALHOUN,5013,2047,2945,8,2966,0.40833832,0.59166168,0.001595851
Georgia,CAMDEN,30167,22945,6056,622,7222,0.76059933,0.23940067,0.020618557
Georgia,CANDLER,7744,5187,2403,138,2557,0.669808884,0.330191116,0.017820248
Georgia,CARROLL,71422,59260,11186,592,12162,0.829716334,0.170283666,0.008288763
Georgia,CATOOSA,42464,41664,354,205,800,0.981160512,0.018839488,0.004827619
Georgia,CHARLTON,8496,6070,2352,35,2426,0.714453861,0.285546139,0.004119586
Georgia,CHATHAM,216935,129145,82179,2782,87790,0.595316569,0.404683431,0.012824118
Georgia,CHATTAHOOCHEE,16934,9422,5140,1793,7512,0.556395418,0.443604582,0.105881658
Georgia,CHATTOOGA,22242,20180,1929,75,2062,0.90729251,0.09270749,0.003371999
Georgia,CHEROKEE,90204,86890,1688,1059,3314,0.963261053,0.036738947,0.011740056
Georgia,CLARKE,87594,60980,22850,1491,26614,0.696166404,0.303833596,0.017021714
Georgia,CLAY,3364,1306,2031,19,2058,0.3882283,0.6117717,0.005648038
Georgia,CLAYTON,182052,129798,43053,3746,52254,0.712972118,0.287027882,0.020576539
Georgia,CLINCH,6160,4410,1676,60,1750,0.715909091,0.284090909,0.00974026
Georgia,COBB,447745,385831,43655,9403,61914,0.861720399,0.138279601,0.021000793
Georgia,COFFEE,29592,21406,7484,557,8186,0.723371181,0.276628819,0.018822655
Georgia,COLQUITT,36645,26155,8791,1588,10490,0.713739937,0.286260063,0.043334698
Georgia,COLUMBIA,66031,56141,7239,962,9890,0.850221865,0.149778135,0.014568915
Georgia,COOK,13456,9155,4027,217,4301,0.680365636,0.319634364,0.016126635
Georgia,COWETA,53853,41044,12162,385,12809,0.762148813,0.237851187,0.007149091
Georgia,CRAWFORD,8991,6045,2751,149,2946,0.672339006,0.327660994,0.016572128
Georgia,CRISP,20011,11742,8137,62,8269,0.586777273,0.413222727,0.003098296
Georgia,DADE,13147,12915,101,64,232,0.982353389,0.017646611,0.004868031
Georgia,DAWSON,9429,9301,4,39,128,0.986424859,0.013575141,0.004136176
Georgia,DECATUR,25511,15012,9917,472,10499,0.58845204,0.41154796,0.018501823
Georgia,DEKALB,545837,284025,228922,15619,261812,0.52034765,0.47965235,0.02861477
Georgia,DODGE,17607,12564,4843,148,5043,0.713579826,0.286420174,0.008405748
Georgia,DOOLY,9901,4959,4832,77,4942,0.500858499,0.499141501,0.007776992
Georgia,DOUGHERTY,96311,46607,48216,816,49704,0.483921878,0.516078122,0.008472552
Georgia,DOUGLAS,71120,64251,5553,749,6869,0.90341676,0.09658324,0.010531496
Georgia,EARLY,11854,6570,5194,45,5284,0.554243293,0.445756707,0.003796187
Georgia,ECHOLS,2334,1990,257,45,344,0.852613539,0.147386461,0.019280206
Georgia,EFFINGHAM,25687,21794,3601,169,3893,0.848444739,0.151555261,0.006579203
Georgia,ELBERT,18949,13058,5702,134,5891,0.689112882,0.310887118,0.007071613
Georgia,EMANUEL,20546,13738,6665,82,6808,0.668645965,0.331354035,0.003991044
Georgia,EVANS,8724,5644,2952,109,3080,0.64695094,0.35304906,0.012494269
Georgia,FANNIN,15992,15872,5,62,120,0.992496248,0.007503752,0.003876938
Georgia,FAYETTE,62415,56958,3334,994,5457,0.912569094,0.087430906,0.015925659
Georgia,FLOYD,81251,68858,11027,831,12393,0.847472646,0.152527354,0.010227566
Georgia,FORSYTH,44083,43257,9,635,826,0.981262618,0.018737382,0.014404646
Georgia,FRANKLIN,16650,14845,1674,77,1805,0.891591592,0.108408408,0.004624625
Georgia,FULTON,648951,303724,322428,13373,345227,0.468023009,0.531976991,0.020607103
Georgia,GILMER,13368,13193,37,102,175,0.986909037,0.013090963,0.007630162
Georgia,GLASCOCK,2357,2052,297,6,305,0.870598218,0.129401782,0.002545609
Georgia,GLYNN,62496,45620,15874,585,16876,0.729966718,0.270033282,0.009360599
Georgia,GORDON,35072,33350,1314,200,1722,0.950901004,0.049098996,0.005702555
Georgia,GRADY,20279,13538,6356,289,6741,0.667587159,0.332412841,0.014251196
Georgia,GREENE,11793,5816,5867,96,5977,0.493173917,0.506826083,0.008140422
Georgia,GWINNETT,352910,315548,17971,8470,37362,0.894131648,0.105868352,0.024000453
Georgia,HABERSHAM,27621,25176,1532,342,2445,0.911480395,0.088519605,0.012381883
Georgia,HALL,95428,81860,8173,4558,13568,0.857819508,0.142180492,0.047763759
Georgia,HANCOCK,8908,1789,7038,63,7119,0.200830714,0.799169286,0.007072295
Georgia,HARALSON,21966,20381,1426,84,1585,0.92784303,0.07215697,0.003824092
Georgia,HARRIS,17788,13041,4559,97,4747,0.733134698,0.266865302,0.005453114
Georgia,HART,19712,15603,3985,76,4109,0.791548295,0.208451705,0.003855519
Georgia,HEARD,8628,7378,1150,68,1250,0.855122856,0.144877144,0.007881317
Georgia,HENRY,58741,51807,6041,463,6934,0.881956385,0.118043615,0.007882059
Georgia,HOUSTON,89208,67175,19279,1459,22033,0.753015425,0.246984575,0.016355035
Georgia,IRWIN,8649,5973,2604,53,2676,0.690600069,0.309399931,0.006127876
Georgia,JACKSON,30005,26830,2900,160,3175,0.894184303,0.105815697,0.005332445
Georgia,JASPER,8453,5434,2936,57,3019,0.642848693,0.357151307,0.006743168
Georgia,JEFF DAVIS,12032,10025,1826,144,2007,0.833194814,0.166805186,0.011968085
Georgia,JEFFERSON,17408,7647,9688,41,9761,0.43928079,0.56071921,0.002355239
Georgia,JENKINS,8247,4802,3411,13,3445,0.582272341,0.417727659,0.001576331
Georgia,JOHNSON,8329,5457,2825,35,2872,0.655180694,0.344819306,0.004202185
Georgia,JONES,20739,15271,5308,79,5468,0.736342157,0.263657843,0.003809248
Georgia,LAMAR,13038,8517,4442,49,4521,0.653244363,0.346755637,0.003758245
Georgia,LANIER,5531,3957,1455,68,1574,0.715422166,0.284577834,0.012294341
Georgia,LAURENS,39988,26395,13235,180,13593,0.660073022,0.339926978,0.00450135
Georgia,LEE,16250,12949,3112,112,3301,0.796861538,0.203138462,0.006892308
Georgia,LIBERTY,52745,27778,20285,3236,24967,0.526647076,0.473352924,0.061351787
Georgia,LINCOLN,7442,4573,2801,56,2869,0.614485353,0.385514647,0.007524859
Georgia,LONG,6202,4608,1337,189,1594,0.742986134,0.257013866,0.030474041
Georgia,LOWNDES,75981,50013,24151,991,25968,0.658230347,0.341769653,0.013042734
Georgia,LUMPKIN,14573,13844,237,213,729,0.949975983,0.050024017,0.014616071
Georgia,MCDUFFIE,20119,12662,7307,84,7457,0.629355336,0.370644664,0.004175158
Georgia,MCINTOSH,8634,4852,3707,63,3782,0.561964327,0.438035673,0.007296734
Georgia,MACON,13114,5340,7671,57,7774,0.407198414,0.592801586,0.0043465
Georgia,MADISON,21050,18945,1845,182,2105,0.9,0.1,0.008646081
Georgia,MARION,5590,3238,2300,23,2352,0.579248658,0.420751342,0.00411449
Georgia,MERIWETHER,22411,12308,9940,121,10103,0.549194592,0.450805408,0.005399134
Georgia,MILLER,6280,4524,1725,20,1756,0.720382166,0.279617834,0.003184713
Georgia,MITCHELL,20275,10338,9611,260,9937,0.509889026,0.490110974,0.012823674
Georgia,MONROE,17113,11554,5390,96,5559,0.675159236,0.324840764,0.00560977
Georgia,MONTGOMERY,7163,4981,2023,142,2182,0.695379031,0.304620969,0.019824096
Georgia,MORGAN,12883,8293,4436,117,4590,0.643716526,0.356283474,0.009081736
Georgia,MURRAY,26147,25872,41,136,275,0.989482541,0.010517459,0.005201362
Georgia,MUSCOGEE,179278,103395,67529,5294,75883,0.576729995,0.423270005,0.029529557
Georgia,NEWTON,41808,31936,9286,390,9872,0.763872943,0.236127057,0.009328358
Georgia,OCONEE,17618,16015,1309,178,1603,0.909013509,0.090986491,0.010103303
Georgia,OGLETHORPE,9763,7267,2398,66,2496,0.744340879,0.255659121,0.006760217
Georgia,PAULDING,41611,39515,1642,269,2096,0.949628704,0.050371296,0.006464637
Georgia,PEACH,21189,10642,10017,378,10547,0.502241729,0.497758271,0.017839445
Georgia,PICKENS,14432,14091,245,46,341,0.976371951,0.023628049,0.003187361
Georgia,PIERCE,13328,11628,1566,104,1700,0.87244898,0.12755102,0.007803121
Georgia,PIKE,10224,8095,2042,54,2129,0.791764476,0.208235524,0.00528169
Georgia,POLK,33815,28413,4772,483,5402,0.84024841,0.15975159,0.014283602
Georgia,PULASKI,8108,5381,2623,83,2727,0.663665516,0.336334484,0.010236803
Georgia,PUTNAM,14137,9253,4719,97,4884,0.654523591,0.345476409,0.006861427
Georgia,QUITMAN,2209,1092,1107,1,1117,0.494341331,0.505658669,0.000452694
Georgia,RABUN,11648,11488,41,67,160,0.986263736,0.013736264,0.00575206
Georgia,RANDOLPH,8023,3303,4629,39,4720,0.411691387,0.588308613,0.004861025
Georgia,RICHMOND,189719,103009,79221,3707,86710,0.542955634,0.457044366,0.019539424
Georgia,ROCKDALE,54091,48539,4330,594,5552,0.897358156,0.102641844,0.010981494
Georgia,SCHLEY,3588,2308,1221,55,1280,0.643255295,0.356744705,0.015328874
Georgia,SCREVEN,13842,7569,6197,51,6273,0.546814044,0.453185956,0.003684439
Georgia,SEMINOLE,9010,5517,2934,530,3493,0.612319645,0.387680355,0.058823529
Georgia,SPALDING,54457,38057,15750,316,16400,0.69884496,0.30115504,0.005802743
Georgia,STEPHENS,23257,20208,2768,144,3049,0.868899686,0.131100314,0.006191684
Georgia,STEWART,5654,2036,3567,26,3618,0.360099045,0.639900955,0.004598514
Georgia,SUMTER,30228,15816,14010,189,14412,0.523223501,0.476776499,0.006252481
Georgia,TALBOT,6524,2412,4045,51,4112,0.369711833,0.630288167,0.00781729
Georgia,TALIAFERRO,1915,736,1152,21,1179,0.384334204,0.615665796,0.010966057
Georgia,TATTNALL,17722,11950,5155,547,5772,0.674303126,0.325696874,0.030865591
Georgia,TAYLOR,7642,4289,3289,58,3353,0.561240513,0.438759487,0.007589636
Georgia,TELFAIR,11000,7190,3754,41,3810,0.653636364,0.346363636,0.003727273
Georgia,TERRELL,10653,4241,6356,40,6412,0.398103821,0.601896179,0.003754811
Georgia,THOMAS,38986,23816,14719,289,15170,0.610885959,0.389114041,0.007412917
Georgia,TIFT,34998,24246,9288,1233,10752,0.692782445,0.307217555,0.035230585
Georgia,TOOMBS,24072,17446,5621,824,6626,0.724742439,0.275257561,0.034230641
Georgia,TOWNS,6754,6719,0,18,35,0.994817886,0.005182114,0.002665087
Georgia,TREUTLEN,5994,3993,1982,16,2001,0.666166166,0.333833834,0.002669336
Georgia,TROUP,55536,38284,16614,289,17252,0.689354653,0.310645347,0.005203832
Georgia,TURNER,8703,5118,3525,35,3585,0.588073078,0.411926922,0.004021602
Georgia,TWIGGS,9806,5266,4480,46,4540,0.537018152,0.462981848,0.004691006
Georgia,UNION,11993,11884,19,49,109,0.990911365,0.009088635,0.004085717
Georgia,UPSON,26300,18833,7266,98,7467,0.71608365,0.28391635,0.003726236
Georgia,WALKER,58340,55624,2241,214,2716,0.953445321,0.046554679,0.003668152
Georgia,WALTON,38586,30960,7062,338,7626,0.802363552,0.197636448,0.008759654
Georgia,WARE,35471,25912,9193,190,9559,0.730512249,0.269487751,0.005356488
Georgia,WARREN,6078,2411,3656,2,3667,0.396676538,0.603323462,0.000329056
Georgia,WASHINGTON,19112,9179,9831,65,9933,0.480274173,0.519725827,0.003401005
Georgia,WAYNE,22356,17765,4331,177,4591,0.79464126,0.20535874,0.007917338
Georgia,WEBSTER,2263,1126,1132,1,1137,0.497569598,0.502430402,0.000441891
Georgia,WHEELER,4903,3319,1473,101,1584,0.67693249,0.32306751,0.020599633
Georgia,WHITE,13006,12453,359,98,553,0.957481163,0.042518837,0.007534984
Georgia,WHITFIELD,72462,66794,2869,2321,5668,0.921779691,0.078220309,0.032030582
Georgia,WILCOX,7008,4745,2222,30,2263,0.677083333,0.322916667,0.004280822
Georgia,WILKES,10597,5633,4895,44,4964,0.531565537,0.468434463,0.004152119
Georgia,WILKINSON,10228,5886,4300,30,4342,0.575479077,0.424520923,0.002933125
Georgia,WORTH,19745,13404,6029,222,6341,0.678855406,0.321144594,0.011243353
Hawaii,HAWAII,120317,44421,566,11134,75896,0.369199697,0.630800303,0.092538876
Hawaii,HONOLULU,836231,249616,24717,56884,586615,0.298501251,0.701498749,0.068024266
Hawaii,KALAWAO,130,24,0,11,106,0.184615385,0.815384615,0.084615385
Hawaii,KAUAI,51177,16235,193,5580,34942,0.31723235,0.68276765,0.109033355
Hawaii,MAUI,100374,37348,440,7781,63026,0.372088389,0.627911611,0.077520075
Idaho,ADA,205775,195120,924,5556,10655,0.948220143,0.051779857,0.027000364
Idaho,ADAMS,3254,3172,2,38,82,0.974800246,0.025199754,0.011677935
Idaho,BANNOCK,66026,60626,415,2740,5400,0.918214037,0.081785963,0.041498804
Idaho,BEAR LAKE,6084,5928,0,136,156,0.974358974,0.025641026,0.022353715
Idaho,BENEWAH,7937,7194,3,124,743,0.906387804,0.093612196,0.015623031
Idaho,BINGHAM,37583,31432,31,3614,6151,0.836335577,0.163664423,0.096160498
Idaho,BLAINE,13552,12999,10,397,553,0.959194215,0.040805785,0.029294569
Idaho,BOISE,3509,3372,2,84,137,0.960957538,0.039042462,0.023938444
Idaho,BONNER,26622,25964,34,352,658,0.9752836,0.0247164,0.013222147
Idaho,BONNEVILLE,72207,67879,286,3010,4328,0.940061213,0.059938787,0.041685709
Idaho,BOUNDARY,8332,7847,3,310,485,0.941790687,0.058209313,0.037205953
Idaho,BUTTE,2918,2791,0,101,127,0.956477039,0.043522961,0.034612748
Idaho,CAMAS,727,710,2,4,17,0.976616231,0.023383769,0.005502063
Idaho,CANYON,90076,76470,165,11838,13606,0.848949776,0.151050224,0.131422354
Idaho,CARIBOU,6963,6733,2,192,230,0.966968261,0.033031739,0.027574321
Idaho,CASSIA,19532,16659,3,2623,2873,0.852908048,0.147091952,0.134292443
Idaho,CLARK,762,678,0,79,84,0.88976378,0.11023622,0.103674541
Idaho,CLEARWATER,8505,8191,8,112,314,0.963080541,0.036919459,0.013168724
Idaho,CUSTER,4133,3993,2,90,140,0.966126301,0.033873699,0.02177595
Idaho,ELMORE,21205,18250,763,1597,2955,0.860646074,0.139353926,0.075312426
Idaho,FRANKLIN,9232,8947,5,237,285,0.969129116,0.030870884,0.025671577
Idaho,FREMONT,10937,10064,8,762,873,0.920179208,0.079820792,0.069671756
Idaho,GEM,11844,11056,11,615,788,0.933468423,0.066531577,0.051925025
Idaho,GOODING,11633,10535,7,1021,1098,0.905613341,0.094386659,0.087767558
Idaho,IDAHO,13783,13286,3,124,497,0.963941087,0.036058913,0.00899659
Idaho,JEFFERSON,16543,15219,3,1155,1324,0.919966149,0.080033851,0.06981805
Idaho,JEROME,15138,13951,9,1018,1187,0.921588057,0.078411943,0.067247985
Idaho,KOOTENAI,69795,67717,91,1052,2078,0.970227094,0.029772906,0.015072713
Idaho,LATAH,30617,29096,169,449,1521,0.950321717,0.049678283,0.014665055
Idaho,LEMHI,6899,6692,0,140,207,0.969995652,0.030004348,0.020292796
Idaho,LEWIS,3516,3287,4,42,229,0.93486917,0.06513083,0.011945392
Idaho,LINCOLN,3308,3075,3,195,233,0.929564692,0.070435308,0.058948005
Idaho,MADISON,23674,22500,35,753,1174,0.950409732,0.049590268,0.031807046
Idaho,MINIDOKA,19361,15312,29,3735,4049,0.79086824,0.20913176,0.192913589
Idaho,NEZ PERCE,33754,31456,45,419,2298,0.93191918,0.06808082,0.012413344
Idaho,ONEIDA,3492,3407,4,56,85,0.975658648,0.024341352,0.016036655
Idaho,OWYHEE,8392,6644,22,1408,1748,0.791706387,0.208293613,0.167778837
Idaho,PAYETTE,16434,14884,11,1200,1550,0.905683339,0.094316661,0.07301935
Idaho,POWER,7086,5908,6,937,1178,0.833756703,0.166243297,0.132232571
Idaho,SHOSHONE,13931,13461,14,247,470,0.966262293,0.033737707,0.017730242
Idaho,TETON,3439,3185,2,237,254,0.92614132,0.07385868,0.068915382
Idaho,TWIN FALLS,53580,49606,62,3106,3974,0.925830534,0.074169466,0.057969392
Idaho,VALLEY,6109,5911,7,107,198,0.967588803,0.032411197,0.017515142
Idaho,WASHINGTON,8550,7454,6,915,1096,0.871812865,0.128187135,0.107017544
Illinois,ADAMS,66090,63729,1684,265,2361,0.964275987,0.035724013,0.004009684
Illinois,ALEXANDER,10626,7025,3480,54,3601,0.661114248,0.338885752,0.005081875
Illinois,BOND,14991,14432,419,80,559,0.96271096,0.03728904,0.005336535
Illinois,BOONE,30806,28421,121,2065,2385,0.922580017,0.077419983,0.067032396
Illinois,BROWN,5836,5174,540,104,662,0.886566141,0.113433859,0.017820425
Illinois,BUREAU,35688,34389,50,1003,1299,0.96360121,0.03639879,0.028104685
Illinois,CALHOUN,5322,5286,1,12,36,0.993235626,0.006764374,0.002254791
Illinois,CARROLL,16805,16303,110,296,502,0.970127938,0.029872062,0.017613805
Illinois,CASS,13437,13334,16,56,103,0.992334598,0.007665402,0.004167597
Illinois,CHAMPAIGN,173025,144760,16415,3485,28265,0.836642104,0.163357896,0.020141598
Illinois,CHRISTIAN,34418,34095,81,103,323,0.990615376,0.009384624,0.00299262
Illinois,CLARK,15921,15808,10,42,113,0.992902456,0.007097544,0.002638025
Illinois,CLAY,14460,14353,4,57,107,0.992600277,0.007399723,0.003941909
Illinois,CLINTON,33944,32447,1013,336,1497,0.95589795,0.04410205,0.009898657
Illinois,COLES,51644,49901,910,405,1743,0.96624971,0.03375029,0.00784215
Illinois,COOK,5105067,2915634,1301196,694194,2189433,0.571125511,0.428874489,0.135981369
Illinois,CRAWFORD,19464,19235,62,80,229,0.98823469,0.01176531,0.004110152
Illinois,CUMBERLAND,10670,10597,5,39,73,0.993158388,0.006841612,0.003655108
Illinois,DEKALB,77932,71693,2036,2329,6239,0.919943027,0.080056973,0.029885028
Illinois,DE WITT,16516,16332,25,80,184,0.988859288,0.011140712,0.004843788
Illinois,DOUGLAS,19464,19102,15,292,362,0.981401562,0.018598438,0.015002055
Illinois,DUPAGE,781666,691833,15119,34567,89833,0.885074955,0.114925045,0.044222213
Illinois,EDGAR,19595,19427,68,52,168,0.991426384,0.008573616,0.002653738
Illinois,EDWARDS,7440,7381,6,30,59,0.992069892,0.007930108,0.004032258
Illinois,EFFINGHAM,31704,31437,12,121,267,0.99157835,0.00842165,0.003816553
Illinois,FAYETTE,20893,20089,581,154,804,0.961518212,0.038481788,0.00737089
Illinois,FORD,14275,14096,42,81,179,0.987460595,0.012539405,0.005674256
Illinois,FRANKLIN,40319,39979,36,110,340,0.991567251,0.008432749,0.002728242
Illinois,FULTON,38080,36988,663,244,1092,0.971323529,0.028676471,0.006407563
Illinois,GALLATIN,6909,6830,42,16,79,0.988565639,0.011434361,0.00231582
Illinois,GREENE,15317,15201,14,44,116,0.992426715,0.007573285,0.002872625
Illinois,GRUNDY,32337,31433,15,748,904,0.972044407,0.027955593,0.023131397
Illinois,HAMILTON,8499,8440,3,29,59,0.993058007,0.006941993,0.003412166
Illinois,HANCOCK,21373,21230,26,58,143,0.993309315,0.006690685,0.002713704
Illinois,HARDIN,5189,5044,84,30,145,0.972056273,0.027943727,0.005781461
Illinois,HENDERSON,8096,7998,8,56,98,0.987895257,0.012104743,0.006916996
Illinois,HENRY,51159,49527,645,797,1632,0.968099455,0.031900545,0.015578882
Illinois,IROQUOIS,30787,29866,163,660,921,0.970084776,0.029915224,0.02143762
Illinois,JACKSON,61067,51409,6259,1082,9658,0.841845841,0.158154159,0.017718244
Illinois,JASPER,10609,10548,1,32,61,0.994250165,0.005749835,0.003016307
Illinois,JEFFERSON,37020,34756,1917,157,2264,0.938843868,0.061156132,0.004240951
Illinois,JERSEY,20539,20267,94,103,272,0.986756902,0.013243098,0.00501485
Illinois,JO DAVIESS,21821,21670,13,94,151,0.99308006,0.00691994,0.004307777
Illinois,JOHNSON,11347,10076,1042,189,1271,0.887988014,0.112011986,0.016656385
Illinois,KANE,317471,250551,18353,43535,66920,0.789209093,0.210790907,0.137130636
Illinois,KANKAKEE,96255,79208,14293,1946,17047,0.822897512,0.177102488,0.020217132
Illinois,KENDALL,39413,37134,205,1805,2279,0.942176439,0.057823561,0.045797072
Illinois,KNOX,56393,51744,2804,1416,4649,0.91756069,0.08243931,0.025109499
Illinois,LAKE,516418,430566,33736,38570,85852,0.833754827,0.166245173,0.074687559
Illinois,LA SALLE,106913,101790,1135,3249,5123,0.952082534,0.047917466,0.030389195
Illinois,LAWRENCE,15972,15709,151,56,263,0.983533684,0.016466316,0.003506136
Illinois,LEE,34392,32191,1212,727,2201,0.936002559,0.063997441,0.021138637
Illinois,LIVINGSTON,39301,36171,2091,826,3130,0.920358261,0.079641739,0.021017277
Illinois,LOGAN,30798,28984,1281,348,1814,0.941100071,0.058899929,0.011299435
Illinois,MCDONOUGH,35244,32810,1226,358,2434,0.930938599,0.069061401,0.010157757
Illinois,MCHENRY,183241,175299,287,6066,7942,0.956658171,0.043341829,0.033103945
Illinois,MCLEAN,129180,120156,5485,1671,9024,0.930143985,0.069856015,0.012935439
Illinois,MACON,117206,101838,14095,540,15368,0.868880433,0.131119567,0.004607273
Illinois,MACOUPIN,47679,46933,378,184,746,0.984353699,0.015646301,0.003859141
Illinois,MADISON,249238,228315,16074,2713,20923,0.916052127,0.083947873,0.010885178
Illinois,MARION,41561,39477,1507,232,2084,0.949856837,0.050143163,0.005582156
Illinois,MARSHALL,12846,12693,17,79,153,0.988089678,0.011910322,0.006149774
Illinois,MASON,16269,16137,8,58,132,0.99188641,0.00811359,0.003565062
Illinois,MASSAC,14752,13763,869,44,989,0.932958243,0.067041757,0.002982646
Illinois,MENARD,11164,11075,9,37,89,0.992027947,0.007972053,0.003314224
Illinois,MERCER,17290,17082,30,109,208,0.987969925,0.012030075,0.006304222
Illinois,MONROE,22422,22132,9,166,290,0.987066274,0.012933726,0.007403443
Illinois,MONTGOMERY,30728,29826,553,235,902,0.970645665,0.029354335,0.007647748
Illinois,MORGAN,36397,34382,1499,286,2015,0.944638294,0.055361706,0.00785779
Illinois,MOULTRIE,13930,13849,8,38,81,0.994185212,0.005814788,0.002727925
Illinois,OGLE,45957,44275,66,1379,1682,0.96340057,0.03659943,0.03000631
Illinois,PEORIA,182827,152801,24746,2596,30026,0.83576824,0.16423176,0.014199216
Illinois,PERRY,21412,20812,387,120,600,0.97197833,0.02802167,0.005604334
Illinois,PIATT,15548,15478,8,35,70,0.995497813,0.004502187,0.002251093
Illinois,PIKE,17577,17444,8,69,133,0.992433294,0.007566706,0.003925585
Illinois,POPE,4373,4036,260,57,337,0.922936199,0.077063801,0.01303453
Illinois,PULASKI,7523,5020,2459,29,2503,0.667286987,0.332713013,0.003854845
Illinois,PUTNAM,5730,5569,9,138,161,0.971902269,0.028097731,0.02408377
Illinois,RANDOLPH,34583,31243,2844,345,3340,0.903420756,0.096579244,0.009976
Illinois,RICHLAND,16545,16392,17,74,153,0.990752493,0.009247507,0.00447265
Illinois,ROCK ISLAND,148723,128986,10290,8084,19737,0.867290197,0.132709803,0.054356085
Illinois,ST. CLAIR,262852,185410,70971,3861,77442,0.705377931,0.294622069,0.014688874
Illinois,SALINE,26551,25355,925,135,1196,0.954954616,0.045045384,0.005084554
Illinois,SANGAMON,178386,161060,14297,1274,17326,0.902873544,0.097126456,0.007141816
Illinois,SCHUYLER,7498,7474,2,7,24,0.996799146,0.003200854,0.000933582
Illinois,SCOTT,5644,5619,1,15,25,0.995570517,0.004429483,0.00265769
Illinois,SHELBY,22261,22152,14,45,109,0.995103544,0.004896456,0.002021473
Illinois,STARK,6534,6470,5,30,64,0.990205081,0.009794919,0.004591368
Illinois,STEPHENSON,48052,44320,3069,283,3732,0.922334138,0.077665862,0.005889453
Illinois,TAZEWELL,123692,122037,183,825,1655,0.986619992,0.013380008,0.006669793
Illinois,UNION,17619,17243,122,182,376,0.978659402,0.021340598,0.010329758
Illinois,VERMILION,88257,78345,7799,1405,9912,0.887691628,0.112308372,0.015919417
Illinois,WABASH,13111,12911,35,73,200,0.984745633,0.015254367,0.005567844
Illinois,WARREN,19181,18518,355,207,663,0.965434545,0.034565455,0.01079193
Illinois,WASHINGTON,14965,14816,46,48,149,0.990043435,0.009956565,0.003207484
Illinois,WAYNE,17241,17087,8,72,154,0.991067803,0.008932197,0.004176092
Illinois,WHITE,16522,16352,41,58,170,0.989710689,0.010289311,0.003510471
Illinois,WHITESIDE,60186,55058,379,4462,5128,0.914797461,0.085202539,0.074136842
Illinois,WILL,357313,294103,37752,19973,63210,0.823096277,0.176903723,0.05589777
Illinois,WILLIAMSON,57733,55802,1130,448,1931,0.966552925,0.033447075,0.00775986
Illinois,WINNEBAGO,252913,218403,23053,7771,34510,0.863549916,0.136450084,0.030725981
Illinois,WOODFORD,32653,32227,61,221,426,0.986953726,0.013046274,0.006768138
Indiana,ADAMS,31095,30152,35,810,943,0.969673581,0.030326419,0.026049204
Indiana,ALLEN,300836,261247,30045,5821,39589,0.868403383,0.131596617,0.019349413
Indiana,BARTHOLOMEW,63657,61479,996,435,2178,0.965785381,0.034214619,0.006833498
Indiana,BENTON,9441,9310,6,108,131,0.986124351,0.013875649,0.011439466
Indiana,BLACKFORD,14067,13911,6,90,156,0.988910215,0.011089785,0.006397953
Indiana,BOONE,38147,37628,83,250,519,0.986394736,0.013605264,0.006553595
Indiana,BROWN,14080,13900,13,94,180,0.987215909,0.012784091,0.006676136
Indiana,CARROLL,18809,18640,19,121,169,0.99101494,0.00898506,0.006433091
Indiana,CASS,38413,37608,324,230,805,0.979043553,0.020956447,0.005987556
Indiana,CLARK,87777,81952,4663,560,5825,0.933638652,0.066361348,0.006379803
Indiana,CLAY,24705,24468,113,66,237,0.9904068,0.0095932,0.002671524
Indiana,CLINTON,30974,30378,33,453,596,0.980758055,0.019241945,0.014625169
Indiana,CRAWFORD,9914,9852,9,16,62,0.993746217,0.006253783,0.001613879
Indiana,DAVIESS,27533,27302,98,86,231,0.991610068,0.008389932,0.003123524
Indiana,DEARBORN,38835,38339,250,125,496,0.987228016,0.012771984,0.003218746
Indiana,DECATUR,23645,23371,39,92,274,0.988411926,0.011588074,0.003890886
Indiana,DE KALB,35324,34792,37,321,532,0.984939418,0.015060582,0.009087306
Indiana,DELAWARE,119659,110733,7113,853,8926,0.925404692,0.074595308,0.00712859
Indiana,DUBOIS,36616,36258,33,244,358,0.990222853,0.009777147,0.006663754
Indiana,ELKHART,156198,144701,7046,2932,11497,0.926394704,0.073605296,0.018771047
Indiana,FAYETTE,26015,25392,434,83,623,0.976052278,0.023947722,0.003190467
Indiana,FLOYD,64404,61217,2640,254,3187,0.950515496,0.049484504,0.003943854
Indiana,FOUNTAIN,17808,17667,3,88,141,0.99208221,0.00791779,0.004941599
Indiana,FRANKLIN,19580,19460,10,52,120,0.993871297,0.006128703,0.002655771
Indiana,FULTON,18840,18469,151,135,371,0.980307856,0.019692144,0.007165605
Indiana,GIBSON,31913,31047,588,133,866,0.972863723,0.027136277,0.004167581
Indiana,GRANT,74169,66980,5002,1514,7189,0.903072712,0.096927288,0.020412841
Indiana,GREENE,30410,30147,10,146,263,0.991351529,0.008648471,0.004801052
Indiana,HAMILTON,108936,106193,660,725,2743,0.974820078,0.025179922,0.006655284
Indiana,HANCOCK,45527,44933,41,333,594,0.986952797,0.013047203,0.007314341
Indiana,HARRISON,29890,29547,123,126,343,0.98852459,0.01147541,0.004215457
Indiana,HENDRICKS,75717,74256,679,353,1461,0.980704465,0.019295535,0.004662097
Indiana,HENRY,48139,47291,471,214,848,0.982384345,0.017615655,0.00444546
Indiana,HOWARD,80827,74706,4365,1057,6121,0.924270355,0.075729645,0.013077313
Indiana,HUNTINGTON,35427,34817,50,281,610,0.982781494,0.017218506,0.007931803
Indiana,JACKSON,37730,37216,132,122,514,0.986376888,0.013623112,0.003233501
Indiana,JASPER,24960,24440,109,317,520,0.979166667,0.020833333,0.012700321
Indiana,JAY,21512,21228,28,151,284,0.986798066,0.013201934,0.007019338
Indiana,JEFFERSON,29797,29107,358,123,690,0.976843306,0.023156694,0.004127932
Indiana,JENNINGS,23661,23279,207,90,382,0.983855289,0.016144711,0.003803728
Indiana,JOHNSON,88109,85966,835,627,2143,0.975677854,0.024322146,0.007116186
Indiana,KNOX,39884,38950,478,205,934,0.976582088,0.023417912,0.005139906
Indiana,KOSCIUSKO,65294,63295,298,1258,1999,0.96938463,0.03061537,0.019266701
Indiana,LAGRANGE,29477,28931,37,362,546,0.981477084,0.018522916,0.012280761
Indiana,LAKE,475594,312113,115340,44526,163481,0.65625933,0.34374067,0.093621871
Indiana,LA PORTE,107066,95229,9522,1576,11837,0.889442026,0.110557974,0.014719892
Indiana,LAWRENCE,42836,42418,108,145,418,0.990241853,0.009758147,0.003385003
Indiana,MADISON,130669,119207,9823,885,11462,0.912282179,0.087717821,0.006772838
Indiana,MARION,797159,610180,168852,8450,186979,0.76544328,0.23455672,0.010600144
Indiana,MARSHALL,42182,41050,74,830,1132,0.973163909,0.026836091,0.019676639
Indiana,MARTIN,10369,10316,11,14,53,0.99488861,0.00511139,0.001350178
Indiana,MIAMI,36897,34467,1089,544,2430,0.934140987,0.065859013,0.014743746
Indiana,MONROE,108978,101814,2789,1367,7164,0.934261961,0.065738039,0.012543816
Indiana,MONTGOMERY,34436,33873,200,159,563,0.983650831,0.016349169,0.004617261
Indiana,MORGAN,55920,55452,9,228,468,0.991630901,0.008369099,0.004077253
Indiana,NEWTON,13551,13305,9,177,246,0.981846358,0.018153642,0.013061767
Indiana,NOBLE,37877,37010,58,625,867,0.97711012,0.02288988,0.016500779
Indiana,OHIO,5315,5250,41,7,65,0.987770461,0.012229539,0.001317027
Indiana,ORANGE,18409,18164,127,59,245,0.986691292,0.013308708,0.003204954
Indiana,OWEN,17281,17120,44,55,161,0.99068341,0.00931659,0.003182686
Indiana,PARKE,15410,15142,117,95,268,0.982608696,0.017391304,0.006164828
Indiana,PERRY,19107,18773,202,66,334,0.982519495,0.017480505,0.003454231
Indiana,PIKE,12509,12433,2,40,76,0.993924374,0.006075626,0.003197698
Indiana,PORTER,128932,123444,446,3858,5488,0.957434927,0.042565073,0.02992275
Indiana,POSEY,25968,25506,283,104,462,0.982208872,0.017791128,0.004004929
Indiana,PULASKI,12643,12431,65,106,212,0.983231828,0.016768172,0.008384086
Indiana,PUTNAM,30315,29089,813,182,1226,0.959557975,0.040442025,0.006003629
Indiana,RANDOLPH,27148,26811,56,192,337,0.987586563,0.012413437,0.007072344
Indiana,RIPLEY,24616,24453,16,62,163,0.993378291,0.006621709,0.002518687
Indiana,RUSH,18129,17855,137,61,274,0.984886094,0.015113906,0.003364775
Indiana,ST. JOSEPH,247052,214455,23953,5201,32597,0.868056118,0.131943882,0.021052248
Indiana,SCOTT,20991,20752,16,148,239,0.988614168,0.011385832,0.007050641
Indiana,SHELBY,40307,39655,329,118,652,0.98382415,0.01617585,0.002927531
Indiana,SPENCER,19490,19221,111,89,269,0.98619805,0.01380195,0.004566444
Indiana,STARKE,22747,22195,72,367,552,0.975733064,0.024266936,0.016133996
Indiana,STEUBEN,27446,27010,51,193,436,0.984114261,0.015885739,0.00703199
Indiana,SULLIVAN,18993,18864,15,59,129,0.993208024,0.006791976,0.003106408
Indiana,SWITZERLAND,7738,7675,15,22,63,0.991858361,0.008141639,0.002843112
Indiana,TIPPECANOE,130598,120724,2636,2078,9874,0.924393942,0.075606058,0.015911423
Indiana,TIPTON,16119,15912,10,121,207,0.987158012,0.012841988,0.007506669
Indiana,UNION,6976,6895,20,25,81,0.988388761,0.011611239,0.003583716
Indiana,VANDERBURGH,165058,150576,12354,883,14482,0.912261145,0.087738855,0.005349635
Indiana,VERMILLION,16773,16639,15,61,134,0.99201097,0.00798903,0.003636797
Indiana,VIGO,106107,97818,5792,997,8289,0.921880743,0.078119257,0.009396176
Indiana,WABASH,35069,34261,130,321,808,0.976959708,0.023040292,0.009153383
Indiana,WARREN,8176,8121,1,23,55,0.993272994,0.006727006,0.002813112
Indiana,WARRICK,44920,44154,371,168,766,0.982947462,0.017052538,0.003739982
Indiana,WASHINGTON,23717,23548,22,108,169,0.99287431,0.00712569,0.004553696
Indiana,WAYNE,71951,67335,3756,374,4616,0.935845228,0.064154772,0.005197982
Indiana,WELLS,25948,25591,10,262,357,0.986241714,0.013758286,0.010097117
Indiana,WHITE,23265,22998,2,175,267,0.988523533,0.011476467,0.007522029
Indiana,WHITLEY,27651,27383,28,126,268,0.990307765,0.009692235,0.004556797
Iowa,ADAIR,8409,8356,1,35,53,0.993697229,0.006302771,0.004162207
Iowa,ADAMS,4866,4836,3,18,30,0.993834772,0.006165228,0.003699137
Iowa,ALLAMAKEE,13855,13765,3,42,90,0.99350415,0.00649585,0.003031397
Iowa,APPANOOSE,13743,13525,79,72,218,0.984137379,0.015862621,0.005239031
Iowa,AUDUBON,7334,7303,0,22,31,0.995773112,0.004226888,0.002999727
Iowa,BENTON,22429,22252,18,93,177,0.992108431,0.007891569,0.004146418
Iowa,BLACK HAWK,123798,113101,8487,912,10697,0.913593111,0.086406889,0.00736684
Iowa,BOONE,25186,24927,62,99,259,0.989716509,0.010283491,0.003930755
Iowa,BREMER,22813,22532,70,72,281,0.987682462,0.012317538,0.003156095
Iowa,BUCHANAN,20844,20624,38,112,220,0.989445404,0.010554596,0.005373249
Iowa,BUENA VISTA,19965,19363,53,160,602,0.969847233,0.030152767,0.008014025
Iowa,BUTLER,15731,15651,4,37,80,0.9949145,0.0050855,0.002352044
Iowa,CALHOUN,11508,11404,30,40,104,0.990962808,0.009037192,0.003475843
Iowa,CARROLL,21423,21289,7,57,134,0.99374504,0.00625496,0.002660692
Iowa,CASS,15128,15041,9,46,87,0.994249075,0.005750925,0.003040719
Iowa,CEDAR,17381,17194,16,109,187,0.989241125,0.010758875,0.006271216
Iowa,CERRO GORDO,46733,45155,292,994,1578,0.966233711,0.033766289,0.021269767
Iowa,CHEROKEE,14098,13965,18,51,133,0.990566038,0.009433962,0.003617534
Iowa,CHICKASAW,13295,13227,4,40,68,0.994885295,0.005114705,0.00300865
Iowa,CLARKE,8287,8236,3,19,51,0.993845783,0.006154217,0.002292748
Iowa,CLAY,17585,17421,8,44,164,0.99067387,0.00932613,0.002502132
Iowa,CLAYTON,19054,18943,6,61,111,0.994174452,0.005825548,0.003201428
Iowa,CLINTON,51040,49691,724,294,1349,0.973569749,0.026430251,0.005760188
Iowa,CRAWFORD,16775,16499,59,98,276,0.983546945,0.016453055,0.005842027
Iowa,DALLAS,29755,29406,62,176,349,0.988270879,0.011729121,0.005914972
Iowa,DAVIS,8312,8224,2,41,88,0.989412897,0.010587103,0.004932628
Iowa,DECATUR,8338,8169,35,45,169,0.97973135,0.02026865,0.005396978
Iowa,DELAWARE,18035,17905,11,68,130,0.992791794,0.007208206,0.003770446
Iowa,DES MOINES,42614,40506,1310,492,2108,0.950532689,0.049467311,0.011545501
Iowa,DICKINSON,14909,14791,14,52,118,0.992085318,0.007914682,0.003487826
Iowa,DUBUQUE,86403,85077,351,437,1326,0.984653311,0.015346689,0.005057695
Iowa,EMMET,11569,11444,17,63,125,0.989195263,0.010804737,0.005445587
Iowa,FAYETTE,21843,21538,46,195,305,0.986036717,0.013963283,0.008927345
Iowa,FLOYD,17058,16906,8,92,152,0.991089225,0.008910775,0.005393364
Iowa,FRANKLIN,11364,11184,6,152,180,0.984160507,0.015839493,0.013375572
Iowa,FREMONT,8226,8144,4,53,82,0.990031607,0.009968393,0.006442986
Iowa,GREENE,10045,9971,5,30,74,0.992633151,0.007366849,0.00298656
Iowa,GRUNDY,12029,11960,7,34,69,0.994263862,0.005736138,0.002826503
Iowa,GUTHRIE,10935,10862,7,35,73,0.993324188,0.006675812,0.003200732
Iowa,HAMILTON,16071,15843,9,116,228,0.985812955,0.014187045,0.00721797
Iowa,HANCOCK,12638,12468,1,129,170,0.986548505,0.013451495,0.010207311
Iowa,HARDIN,19094,18795,117,106,299,0.984340631,0.015659369,0.005551482
Iowa,HARRISON,14730,14603,10,50,127,0.99137814,0.00862186,0.003394433
Iowa,HENRY,19226,18630,210,127,596,0.969000312,0.030999688,0.006605638
Iowa,HOWARD,9809,9751,4,24,58,0.994087063,0.005912937,0.002446733
Iowa,HUMBOLDT,10756,10670,9,37,86,0.992004463,0.007995537,0.00343994
Iowa,IDA,8365,8316,1,23,49,0.994142259,0.005857741,0.002749552
Iowa,IOWA,14630,14539,7,39,91,0.993779904,0.006220096,0.002665755
Iowa,JACKSON,19950,19790,16,96,160,0.99197995,0.00802005,0.00481203
Iowa,JASPER,34795,34302,64,194,493,0.985831298,0.014168702,0.005575514
Iowa,JEFFERSON,16310,15915,93,141,395,0.975781729,0.024218271,0.008645003
Iowa,JOHNSON,96119,88705,1941,1435,7414,0.922866447,0.077133553,0.01492941
Iowa,JONES,19444,18998,293,95,446,0.977062333,0.022937667,0.004885826
Iowa,KEOKUK,11624,11549,6,19,75,0.993547832,0.006452168,0.001634549
Iowa,KOSSUTH,18591,18432,7,94,159,0.991447475,0.008552525,0.00505621
Iowa,LEE,38687,36656,1090,732,2031,0.947501745,0.052498255,0.018921085
Iowa,LINN,168767,162087,3288,1591,6680,0.960418802,0.039581198,0.009427198
Iowa,LOUISA,11592,11035,86,425,557,0.95194962,0.04805038,0.036663216
Iowa,LUCAS,9070,8970,3,53,100,0.988974642,0.011025358,0.00584344
Iowa,LYON,11952,11890,2,11,62,0.994812584,0.005187416,0.000920348
Iowa,MADISON,12483,12367,5,67,116,0.990707362,0.009292638,0.0053673
Iowa,MAHASKA,21522,21191,41,92,331,0.984620388,0.015379612,0.004274696
Iowa,MARION,30001,29413,102,162,588,0.980400653,0.019599347,0.00539982
Iowa,MARSHALL,38276,37308,278,292,968,0.974710001,0.025289999,0.007628801
Iowa,MILLS,13202,13062,22,72,140,0.989395546,0.010604454,0.005453719
Iowa,MITCHELL,10928,10859,2,45,69,0.993685944,0.006314056,0.004117862
Iowa,MONONA,10034,9960,5,30,74,0.992625075,0.007374925,0.002989835
Iowa,MONROE,8114,8028,19,18,86,0.989401035,0.010598965,0.002218388
Iowa,MONTGOMERY,12076,11994,5,52,82,0.993209672,0.006790328,0.004306062
Iowa,MUSCATINE,39907,36428,186,2900,3479,0.912822312,0.087177688,0.072668955
Iowa,O'BRIEN,15444,15314,8,39,130,0.991582492,0.008417508,0.002525253
Iowa,OSCEOLA,7267,7220,3,16,47,0.993532407,0.006467593,0.002201734
Iowa,PAGE,16870,16457,82,197,413,0.975518672,0.024481328,0.011677534
Iowa,PALO ALTO,10669,10596,8,24,73,0.993157747,0.006842253,0.002249508
Iowa,PLYMOUTH,23388,23215,47,58,173,0.992603044,0.007396956,0.002479904
Iowa,POCAHONTAS,9525,9460,4,32,65,0.993175853,0.006824147,0.00335958
Iowa,POLK,327140,299469,14618,6161,27671,0.915415418,0.084584582,0.018832916
Iowa,POTTAWATTAMIE,82628,80148,453,1516,2480,0.969985961,0.030014039,0.018347291
Iowa,POWESHIEK,19033,18672,86,68,361,0.981032943,0.018967057,0.003572742
Iowa,RINGGOLD,5420,5374,1,16,46,0.991512915,0.008487085,0.00295203
Iowa,SAC,12324,12243,4,44,81,0.993427459,0.006572541,0.003570269
Iowa,SCOTT,150979,136942,7861,4253,14037,0.907026805,0.092973195,0.028169481
Iowa,SHELBY,13230,13137,5,44,93,0.992970522,0.007029478,0.003325775
Iowa,SIOUX,29903,29564,25,66,339,0.988663345,0.011336655,0.002207136
Iowa,STORY,74252,68666,1170,840,5586,0.924769703,0.075230297,0.011312827
Iowa,TAMA,17419,16388,30,128,1031,0.940811757,0.059188243,0.007348298
Iowa,TAYLOR,7114,7042,1,46,72,0.989879112,0.010120888,0.006466123
Iowa,UNION,12750,12624,10,42,126,0.990117647,0.009882353,0.003294118
Iowa,VAN BUREN,7676,7616,10,29,60,0.992183429,0.007816571,0.003778009
Iowa,WAPELLO,35687,34930,270,224,757,0.978787794,0.021212206,0.006276795
Iowa,WARREN,36033,35485,89,277,548,0.984791719,0.015208281,0.007687398
Iowa,WASHINGTON,19612,19257,90,196,355,0.981898837,0.018101163,0.009993881
Iowa,WAYNE,7067,7010,1,29,57,0.991934343,0.008065657,0.00410358
Iowa,WEBSTER,40342,38690,882,490,1652,0.959050121,0.040949879,0.01214615
Iowa,WINNEBAGO,12122,11910,31,97,212,0.982511137,0.017488863,0.00800198
Iowa,WINNESHIEK,20847,20546,42,61,301,0.985561472,0.014438528,0.00292608
Iowa,WOODBURY,98276,90943,1836,2712,7333,0.925383613,0.074616387,0.027595751
Iowa,WORTH,7991,7869,15,91,122,0.984732824,0.015267176,0.011387811
Iowa,WRIGHT,14269,14112,10,92,157,0.988997127,0.011002873,0.006447544
Kansas,ALLEN,14638,13969,265,258,669,0.954297035,0.045702965,0.017625359
Kansas,ANDERSON,7803,7645,37,51,158,0.979751378,0.020248622,0.006535948
Kansas,ATCHISON,16932,15426,931,370,1506,0.911055989,0.088944011,0.021852114
Kansas,BARBER,5874,5755,13,73,119,0.979741233,0.020258767,0.012427647
Kansas,BARTON,29382,27973,341,816,1409,0.95204547,0.04795453,0.027772105
Kansas,BOURBON,14966,14391,412,79,575,0.96157958,0.03842042,0.005278632
Kansas,BROWN,11128,10108,131,192,1020,0.908339324,0.091660676,0.017253774
Kansas,BUTLER,50580,48861,361,742,1719,0.966014235,0.033985765,0.01466983
Kansas,CHASE,3021,2964,5,40,57,0.981132075,0.018867925,0.013240649
Kansas,CHAUTAUQUA,4407,4183,23,44,224,0.949171772,0.050828228,0.009984116
Kansas,CHEROKEE,21374,20311,115,175,1063,0.950266679,0.049733321,0.008187518
Kansas,CHEYENNE,3243,3208,5,20,35,0.989207524,0.010792476,0.006167129
Kansas,CLARK,2418,2344,0,42,74,0.969396195,0.030603805,0.017369727
Kansas,CLAY,9158,9056,18,38,102,0.988862197,0.011137803,0.004149378
Kansas,CLOUD,11023,10888,36,76,135,0.98775288,0.01224712,0.006894675
Kansas,COFFEY,8404,8272,9,61,132,0.984293194,0.015706806,0.007258448
Kansas,COMANCHE,2313,2283,6,13,30,0.987029831,0.012970169,0.005620406
Kansas,COWLEY,36915,33789,1040,1097,3126,0.915318976,0.084681024,0.029716917
Kansas,CRAWFORD,35568,34043,475,325,1525,0.957124381,0.042875619,0.009137427
Kansas,DECATUR,4021,3996,2,13,25,0.993782641,0.006217359,0.003233027
Kansas,DICKINSON,18958,18374,122,341,584,0.969195063,0.030804937,0.017987129
Kansas,DONIPHAN,8134,7814,155,48,320,0.960658962,0.039341038,0.005901156
Kansas,DOUGLAS,81798,71747,3274,2138,10051,0.877124135,0.122875865,0.026137558
Kansas,EDWARDS,3787,3566,4,197,221,0.941642461,0.058357539,0.052020069
Kansas,ELK,3327,3205,5,59,122,0.963330328,0.036669672,0.017733694
Kansas,ELLIS,26004,25491,107,205,513,0.980272266,0.019727734,0.007883403
Kansas,ELLSWORTH,6586,6233,134,186,353,0.946401458,0.053598542,0.028241725
Kansas,FINNEY,33070,22914,401,8353,10156,0.692893862,0.307106138,0.252585425
Kansas,FORD,27463,22121,448,4083,5342,0.805483742,0.194516258,0.14867276
Kansas,FRANKLIN,21994,20979,278,471,1015,0.95385105,0.04614895,0.021414931
Kansas,GEARY,30453,20213,6982,1853,10240,0.66374413,0.33625587,0.060847864
Kansas,GOVE,3231,3211,4,9,20,0.993809966,0.006190034,0.002785515
Kansas,GRAHAM,3543,3393,102,23,150,0.957662997,0.042337003,0.006491674
Kansas,GRANT,7159,5500,2,1543,1659,0.768263724,0.231736276,0.215532896
Kansas,GRAY,5396,5133,7,229,263,0.951260193,0.048739807,0.042438844
Kansas,GREELEY,1774,1659,3,107,115,0.935174746,0.064825254,0.060315671
Kansas,GREENWOOD,7847,7673,9,91,174,0.977825921,0.022174079,0.011596789
Kansas,HAMILTON,2388,2212,5,139,176,0.926298157,0.073701843,0.058207705
Kansas,HARPER,7124,6955,13,105,169,0.976277372,0.023722628,0.014738911
Kansas,HARVEY,31028,28516,524,1616,2512,0.919040866,0.080959134,0.05208199
Kansas,HASKELL,3886,3305,2,557,581,0.850488935,0.149511065,0.143335049
Kansas,HODGEMAN,2177,2120,22,32,57,0.97381718,0.02618282,0.014699127
Kansas,JACKSON,11525,10668,39,126,857,0.925639913,0.074360087,0.010932755
Kansas,JEFFERSON,15905,15510,73,132,395,0.975165042,0.024834958,0.008299277
Kansas,JEWELL,4251,4227,0,8,24,0.99435427,0.00564573,0.00188191
Kansas,JOHNSON,355054,334167,6809,7005,20887,0.941172329,0.058827671,0.019729393
Kansas,KEARNY,4027,3323,3,671,704,0.825180035,0.174819965,0.166625279
Kansas,KINGMAN,8292,8172,9,77,120,0.98552822,0.01447178,0.009286059
Kansas,KIOWA,3660,3584,7,39,76,0.979234973,0.020765027,0.010655738
Kansas,LABETTE,23693,21654,1025,516,2039,0.913940826,0.086059174,0.021778584
Kansas,LANE,2375,2325,1,44,50,0.978947368,0.021052632,0.018526316
Kansas,LEAVENWORTH,64371,53928,6894,2192,10443,0.83776856,0.16223144,0.034052601
Kansas,LINCOLN,3653,3624,1,15,29,0.992061319,0.007938681,0.004106214
Kansas,LINN,8254,8133,37,34,121,0.985340441,0.014659559,0.004119215
Kansas,LOGAN,3081,3036,11,26,45,0.985394352,0.014605648,0.008438819
Kansas,LYON,34732,31067,706,2114,3665,0.894477715,0.105522285,0.06086606
Kansas,MCPHERSON,27268,26504,203,325,764,0.97198181,0.02801819,0.011918733
Kansas,MARION,12888,12620,82,118,268,0.979205462,0.020794538,0.009155804
Kansas,MARSHALL,11705,11601,9,49,104,0.991114908,0.008885092,0.004186245
Kansas,MEADE,4247,4021,0,198,226,0.946785967,0.053214033,0.046621144
Kansas,MIAMI,23466,22464,562,276,1002,0.957299923,0.042700077,0.011761698
Kansas,MITCHELL,7203,7105,43,29,98,0.986394558,0.013605442,0.0040261
Kansas,MONTGOMERY,38816,34614,2400,751,4202,0.891745672,0.108254328,0.019347692
Kansas,MORRIS,6198,6050,18,90,148,0.976121329,0.023878671,0.014520813
Kansas,MORTON,3480,3062,1,352,418,0.879885057,0.120114943,0.101149425
Kansas,NEMAHA,10446,10365,37,14,81,0.992245836,0.007754164,0.001340226
Kansas,NEOSHO,17035,16325,182,361,710,0.958321104,0.041678896,0.021191664
Kansas,NESS,4033,4001,0,23,32,0.99206546,0.00793454,0.005702951
Kansas,NORTON,5947,5693,134,82,254,0.95728939,0.04271061,0.013788465
Kansas,OSAGE,15248,14911,29,187,337,0.977898741,0.022101259,0.012263903
Kansas,OSBORNE,4867,4822,4,17,45,0.990754058,0.009245942,0.003492911
Kansas,OTTAWA,5634,5573,4,34,61,0.989172879,0.010827121,0.006034789
Kansas,PAWNEE,7555,6976,233,256,579,0.923362012,0.076637988,0.033884844
Kansas,PHILLIPS,6590,6506,16,32,84,0.987253414,0.012746586,0.004855842
Kansas,POTTAWATOMIE,16128,15632,93,239,496,0.969246032,0.030753968,0.014818948
Kansas,PRATT,9702,9296,114,183,406,0.958152958,0.041847042,0.01886209
Kansas,RAWLINS,3404,3361,3,27,43,0.987367803,0.012632197,0.007931845
Kansas,RENO,62389,57643,1677,2478,4746,0.923928898,0.076071102,0.03971854
Kansas,REPUBLIC,6482,6440,3,15,42,0.993520518,0.006479482,0.002314101
Kansas,RICE,10610,10141,116,279,469,0.955796418,0.044203582,0.026295947
Kansas,RILEY,67139,54787,6682,2799,12352,0.816023474,0.183976526,0.041689629
Kansas,ROOKS,6039,5963,34,25,76,0.987415135,0.012584865,0.004139758
Kansas,RUSH,3842,3796,0,35,46,0.988027069,0.011972931,0.009109839
Kansas,RUSSELL,7835,7706,43,45,129,0.983535418,0.016464582,0.005743459
Kansas,SALINE,49301,45826,1487,1222,3475,0.929514614,0.070485386,0.024786515
Kansas,SCOTT,5289,5119,5,138,170,0.967857818,0.032142182,0.026091889
Kansas,SEDGWICK,403662,337788,35516,17435,65874,0.836809013,0.163190987,0.043192077
Kansas,SEWARD,18743,13415,1084,3660,5328,0.715733874,0.284266126,0.195272902
Kansas,SHAWNEE,160976,137250,13058,7785,23726,0.852611569,0.147388431,0.048361246
Kansas,SHERIDAN,3043,3010,0,26,33,0.989155439,0.010844561,0.0085442
Kansas,SHERMAN,6926,6415,17,474,511,0.92622004,0.07377996,0.068437771
Kansas,SMITH,5078,5057,4,7,21,0.995864514,0.004135486,0.001378495
Kansas,STAFFORD,5365,5210,10,112,155,0.97110904,0.02889096,0.020876048
Kansas,STANTON,2333,1915,2,392,418,0.820831547,0.179168453,0.168024003
Kansas,STEVENS,5048,4423,26,552,625,0.87618859,0.12381141,0.109350238
Kansas,SUMNER,25841,24455,138,888,1386,0.946364305,0.053635695,0.034363995
Kansas,THOMAS,8258,8073,29,101,185,0.977597481,0.022402519,0.012230564
Kansas,TREGO,3694,3660,2,9,34,0.990795885,0.009204115,0.002436383
Kansas,WABAUNSEE,6603,6415,41,116,188,0.971528093,0.028471907,0.017567772
Kansas,WALLACE,1821,1729,6,79,92,0.949478309,0.050521691,0.043382757
Kansas,WASHINGTON,7073,7040,4,22,33,0.99533437,0.00466563,0.00311042
Kansas,WICHITA,2758,2414,1,326,344,0.875271936,0.124728064,0.118201595
Kansas,WILSON,10289,10119,20,76,170,0.9834775,0.0165225,0.007386529
Kansas,WOODSON,4116,4041,15,25,75,0.981778426,0.018221574,0.006073858
Kansas,WYANDOTTE,161993,103955,44131,10997,58038,0.64172526,0.35827474,0.067885649
Kentucky,ADAIR,15360,14773,459,89,587,0.961783854,0.038216146,0.005794271
Kentucky,ALLEN,14628,14413,165,24,215,0.98530216,0.01469784,0.001640689
Kentucky,ANDERSON,14571,14047,432,68,524,0.964038158,0.035961842,0.004666804
Kentucky,BALLARD,7902,7602,240,41,300,0.962034928,0.037965072,0.00518856
Kentucky,BARREN,34001,32128,1678,94,1873,0.944913385,0.055086615,0.002764625
Kentucky,BATH,9692,9369,274,31,323,0.966673545,0.033326455,0.003198514
Kentucky,BELL,31506,30505,804,77,1001,0.968228274,0.031771726,0.002443979
Kentucky,BOONE,57589,56465,356,318,1124,0.980482384,0.019517616,0.005521888
Kentucky,BOURBON,19236,17445,1658,81,1791,0.906893325,0.093106675,0.004210855
Kentucky,BOYD,51150,49522,977,443,1628,0.968172043,0.031827957,0.008660802
Kentucky,BOYLE,25641,22992,2441,108,2649,0.896688897,0.103311103,0.004212004
Kentucky,BRACKEN,7766,7698,47,12,68,0.991243884,0.008756116,0.001545197
Kentucky,BREATHITT,15703,15612,33,26,91,0.994204929,0.005795071,0.001655735
Kentucky,BRECKINRIDGE,16312,15642,583,44,670,0.958925944,0.041074056,0.002697401
Kentucky,BULLITT,47567,47020,206,164,547,0.988500431,0.011499569,0.003447768
Kentucky,BUTLER,11245,11120,55,38,125,0.988883948,0.011116052,0.00337928
Kentucky,CALDWELL,13232,12392,765,30,840,0.936517533,0.063482467,0.002267231
Kentucky,CALLOWAY,30735,29445,958,160,1290,0.958028306,0.041971694,0.005205791
Kentucky,CAMPBELL,83866,82343,847,319,1523,0.981840078,0.018159922,0.003803687
Kentucky,CARLISLE,5238,5147,55,21,91,0.982626957,0.017373043,0.004009164
Kentucky,CARROLL,9292,9044,199,22,248,0.973310375,0.026689625,0.002367628
Kentucky,CARTER,24340,24218,19,60,122,0.994987675,0.005012325,0.002465078
Kentucky,CASEY,14211,14064,37,47,147,0.9896559,0.0103441,0.003307297
Kentucky,CHRISTIAN,68941,48759,16704,2339,20182,0.70725693,0.29274307,0.033927561
Kentucky,CLARK,29496,27668,1608,98,1828,0.938025495,0.061974505,0.003322484
Kentucky,CLAY,21746,21296,335,46,450,0.979306539,0.020693461,0.002115332
Kentucky,CLINTON,9135,9081,6,37,54,0.99408867,0.00591133,0.004050356
Kentucky,CRITTENDEN,9196,9073,78,24,123,0.986624619,0.013375381,0.00260983
Kentucky,CUMBERLAND,6784,6440,307,23,344,0.949292453,0.050707547,0.00339033
Kentucky,DAVIESS,87189,82917,3606,312,4272,0.951002993,0.048997007,0.003578433
Kentucky,EDMONSON,10357,10146,168,25,211,0.979627305,0.020372695,0.002413826
Kentucky,ELLIOTT,6455,6436,1,15,19,0.997056545,0.002943455,0.00232378
Kentucky,ESTILL,14614,14550,8,46,64,0.995620638,0.004379362,0.003147667
Kentucky,FAYETTE,225366,188754,29906,2556,36612,0.837544261,0.162455739,0.011341551
Kentucky,FLEMING,12292,12004,216,56,288,0.976570127,0.023429873,0.004555809
Kentucky,FLOYD,43586,43052,304,129,534,0.98774836,0.01225164,0.002959666
Kentucky,FRANKLIN,43781,40021,3268,178,3760,0.914117996,0.085882004,0.004065691
Kentucky,FULTON,8271,6686,1533,25,1585,0.808366582,0.191633418,0.003022609
Kentucky,GALLATIN,5393,5276,93,8,117,0.97830521,0.02169479,0.001483404
Kentucky,GARRARD,11579,11069,452,31,510,0.955954746,0.044045254,0.002677261
Kentucky,GRANT,15737,15645,27,36,92,0.994153905,0.005846095,0.002287602
Kentucky,GRAVES,33550,31859,1518,93,1691,0.949597615,0.050402385,0.002771982
Kentucky,GRAYSON,21050,20827,70,89,223,0.989406176,0.010593824,0.004228029
Kentucky,GREEN,10371,9940,349,60,431,0.958441809,0.041558191,0.005785363
Kentucky,GREENUP,36742,36368,147,76,374,0.989820913,0.010179087,0.002068477
Kentucky,HANCOCK,7864,7709,94,30,155,0.980289929,0.019710071,0.003814852
Kentucky,HARDIN,89240,74835,9749,2506,14405,0.838581354,0.161418646,0.028081578
Kentucky,HARLAN,36574,35172,1208,109,1402,0.961666758,0.038333242,0.002980259
Kentucky,HARRISON,16248,15685,478,42,563,0.965349581,0.034650419,0.002584934
Kentucky,HART,14890,13731,1062,65,1159,0.922162525,0.077837475,0.004365346
Kentucky,HENDERSON,43044,39637,3037,166,3407,0.920848434,0.079151566,0.003856519
Kentucky,HENRY,12823,12233,533,29,590,0.953988926,0.046011074,0.002261561
Kentucky,HICKMAN,5566,5037,503,19,529,0.904958678,0.095041322,0.003413582
Kentucky,HOPKINS,46126,42707,3046,188,3419,0.925876946,0.074123054,0.004075792
Kentucky,JACKSON,11955,11908,2,31,47,0.996068591,0.003931409,0.002593057
Kentucky,JEFFERSON,664937,541602,112951,4365,123335,0.814516262,0.185483738,0.006564532
Kentucky,JESSAMINE,30508,29140,983,184,1368,0.955159302,0.044840698,0.006031205
Kentucky,JOHNSON,23248,23081,33,38,167,0.992816586,0.007183414,0.001634549
Kentucky,KENTON,142031,136333,4147,704,5698,0.959881998,0.040118002,0.004956664
Kentucky,KNOTT,17906,17734,113,34,172,0.990394281,0.009605719,0.001898805
Kentucky,KNOX,29676,29210,290,78,466,0.984297075,0.015702925,0.002628387
Kentucky,LARUE,11679,11103,489,55,576,0.950680709,0.049319291,0.004709307
Kentucky,LAUREL,43438,42829,243,166,609,0.985980017,0.014019983,0.003821539
Kentucky,LAWRENCE,13998,13907,22,24,91,0.993499071,0.006500929,0.001714531
Kentucky,LEE,7422,7379,26,10,43,0.994206413,0.005793587,0.001347346
Kentucky,LESLIE,13642,13573,12,40,69,0.994942091,0.005057909,0.002932121
Kentucky,LETCHER,27000,26677,190,64,323,0.988037037,0.011962963,0.00237037
Kentucky,LEWIS,13029,12953,25,25,76,0.994166859,0.005833141,0.001918797
Kentucky,LINCOLN,20045,19316,621,43,729,0.963631828,0.036368172,0.002145173
Kentucky,LIVINGSTON,9062,8994,14,30,68,0.992496138,0.007503862,0.003310527
Kentucky,LOGAN,24416,22177,2080,79,2239,0.908297837,0.091702163,0.003235583
Kentucky,LYON,6624,6133,430,28,491,0.925875604,0.074124396,0.004227053
Kentucky,MCCRACKEN,62879,55968,6293,324,6911,0.890090491,0.109909509,0.005152754
Kentucky,MCCREARY,15603,15394,124,24,209,0.98660514,0.01339486,0.001538166
Kentucky,MCLEAN,9628,9556,46,15,72,0.992521811,0.007478189,0.001557956
Kentucky,MADISON,57508,53978,2915,191,3530,0.938617236,0.061382764,0.003321277
Kentucky,MAGOFFIN,13077,13035,4,15,42,0.996788254,0.003211746,0.001147052
Kentucky,MARION,16499,14952,1465,42,1547,0.906236742,0.093763258,0.002545609
Kentucky,MARSHALL,27205,26998,10,118,207,0.992391105,0.007608895,0.004337438
Kentucky,MARTIN,12526,12481,8,21,45,0.996407472,0.003592528,0.001676513
Kentucky,MASON,16666,15287,1265,76,1379,0.91725669,0.08274331,0.004560182
Kentucky,MEADE,24170,20897,2351,578,3273,0.864584195,0.135415805,0.023913943
Kentucky,MENIFEE,5092,4970,87,27,122,0.976040848,0.023959152,0.005302435
Kentucky,MERCER,19148,18148,808,87,1000,0.947775225,0.052224775,0.004543555
Kentucky,METCALFE,8963,8687,223,27,276,0.969206739,0.030793261,0.003012384
Kentucky,MONROE,11401,10971,346,64,430,0.96228401,0.03771599,0.005613543
Kentucky,MONTGOMERY,19561,18653,811,56,908,0.953581105,0.046418895,0.002862839
Kentucky,MORGAN,11648,11491,100,42,157,0.986521291,0.013478709,0.003605769
Kentucky,MUHLENBERG,31318,29870,1283,82,1448,0.953764608,0.046235392,0.002618303
Kentucky,NELSON,29710,27699,1794,131,2011,0.932312353,0.067687647,0.00440929
Kentucky,NICHOLAS,6725,6598,88,16,127,0.981115242,0.018884758,0.002379182
Kentucky,OHIO,21105,20776,179,80,329,0.984411277,0.015588723,0.003790571
Kentucky,OLDHAM,33263,31670,1191,206,1593,0.95210895,0.04789105,0.006193067
Kentucky,OWEN,9035,8845,158,14,190,0.97897067,0.02102933,0.00154953
Kentucky,OWSLEY,5036,5005,14,13,31,0.993844321,0.006155679,0.002581414
Kentucky,PENDLETON,12036,11933,43,29,103,0.99144234,0.00855766,0.002409438
Kentucky,PERRY,30283,29615,521,53,668,0.977941419,0.022058581,0.001750157
Kentucky,PIKE,72583,71898,282,184,685,0.990562528,0.009437472,0.002535029
Kentucky,POWELL,11686,11546,82,41,140,0.988019853,0.011980147,0.003508472
Kentucky,PULASKI,49489,48491,597,205,998,0.979833902,0.020166098,0.004142335
Kentucky,ROBERTSON,2124,2116,4,4,8,0.996233522,0.003766478,0.001883239
Kentucky,ROCKCASTLE,14803,14719,3,52,84,0.994325475,0.005674525,0.003512801
Kentucky,ROWAN,20353,19835,305,74,518,0.974549207,0.025450793,0.003635828
Kentucky,RUSSELL,14716,14569,92,40,147,0.990010873,0.009989127,0.00271813
Kentucky,SCOTT,23867,22127,1503,100,1740,0.92709599,0.07290401,0.004189886
Kentucky,SHELBY,24824,22159,2446,90,2665,0.892644215,0.107355785,0.003625524
Kentucky,SIMPSON,15145,13376,1666,48,1769,0.883195774,0.116804226,0.003169363
Kentucky,SPENCER,6801,6668,113,6,133,0.980444052,0.019555948,0.000882223
Kentucky,TAYLOR,21146,19980,1075,45,1166,0.944859548,0.055140452,0.002128062
Kentucky,TODD,10940,9665,1194,55,1275,0.88345521,0.11654479,0.005027422
Kentucky,TRIGG,10361,9077,1226,28,1284,0.876073738,0.123926262,0.002702442
Kentucky,TRIMBLE,6090,6037,2,29,53,0.991297209,0.008702791,0.004761905
Kentucky,UNION,16557,13847,2518,122,2710,0.836323005,0.163676995,0.007368485
Kentucky,WARREN,76673,69277,6226,429,7396,0.903538403,0.096461597,0.00559519
Kentucky,WASHINGTON,10441,9442,913,56,999,0.90431951,0.09568049,0.005363471
Kentucky,WAYNE,17468,17057,315,53,411,0.976471262,0.023528738,0.00303412
Kentucky,WEBSTER,13955,13090,786,28,865,0.938015048,0.061984952,0.002006449
Kentucky,WHITLEY,33326,32912,212,90,414,0.987577267,0.012422733,0.002700594
Kentucky,WOLFE,6503,6482,8,5,21,0.996770721,0.003229279,0.000768876
Kentucky,WOODFORD,19955,18507,1292,98,1448,0.927436733,0.072563267,0.00491105
Louisiana,ACADIA PARISH,55882,45240,10140,372,10642,0.809563008,0.190436992,0.006656884
Louisiana,ALLEN PARISH,21226,15824,4402,671,5402,0.745500801,0.254499199,0.031612174
Louisiana,ASCENSION PARISH,58214,43818,13204,923,14396,0.752705535,0.247294465,0.015855293
Louisiana,ASSUMPTION PARISH,22753,15033,7308,292,7720,0.660704083,0.339295917,0.012833473
Louisiana,AVOYELLES PARISH,39159,27893,10485,621,11266,0.712301131,0.287698869,0.015858423
Louisiana,BEAUREGARD PARISH,30083,24965,4449,417,5118,0.829870691,0.170129309,0.013861649
Louisiana,BIENVILLE PARISH,15979,8935,6929,81,7044,0.559171412,0.440828588,0.005069153
Louisiana,BOSSIER PARISH,86088,65812,17301,1799,20276,0.764473562,0.235526438,0.020897221
Louisiana,CADDO PARISH,248253,144885,99101,2595,103368,0.583618325,0.416381675,0.010453046
Louisiana,CALCASIEU PARISH,168134,126922,38265,1847,41212,0.754885984,0.245114016,0.010985286
Louisiana,CALDWELL PARISH,9810,7868,1760,160,1942,0.802038736,0.197961264,0.016309888
Louisiana,CAMERON PARISH,9260,8581,498,143,679,0.926673866,0.073326134,0.015442765
Louisiana,CATAHOULA PARISH,11065,8103,2870,71,2962,0.732309083,0.267690917,0.006416629
Louisiana,CLAIBORNE PARISH,17405,9300,8022,40,8105,0.534329216,0.465670784,0.00229819
Louisiana,CONCORDIA PARISH,20828,13082,7564,130,7746,0.628096793,0.371903207,0.006241598
Louisiana,DE SOTO PARISH,25346,13798,11105,377,11548,0.544385702,0.455614298,0.014874142
Louisiana,EAST BATON ROUGE PARISH,380105,236479,131856,5761,143626,0.62214125,0.37785875,0.015156338
Louisiana,EAST CARROLL PARISH,9709,3296,6269,120,6413,0.339478834,0.660521166,0.012359666
Louisiana,EAST FELICIANA PARISH,19211,9957,9025,186,9254,0.518296809,0.481703191,0.009681953
Louisiana,EVANGELINE PARISH,33274,24235,8645,270,9039,0.728346457,0.271653543,0.008114444
Louisiana,FRANKLIN PARISH,22387,15197,7015,120,7190,0.678831465,0.321168535,0.005360254
Louisiana,GRANT PARISH,17526,14739,2521,153,2787,0.840979117,0.159020883,0.008729887
Louisiana,IBERIA PARISH,68297,46078,19966,1320,22219,0.674670923,0.325329077,0.01932735
Louisiana,IBERVILLE PARISH,31049,16034,14307,598,15015,0.516409546,0.483590454,0.01925988
Louisiana,JACKSON PARISH,15705,11029,4580,50,4676,0.702260427,0.297739573,0.003183699
Louisiana,JEFFERSON PARISH,448306,331894,78263,26611,116412,0.74032915,0.25967085,0.059359009
Louisiana,JEFFERSON DAVIS PARISH,30722,24591,5809,201,6131,0.80043617,0.19956383,0.006542543
Louisiana,LAFAYETTE PARISH,164762,123436,36652,2613,41326,0.749177602,0.250822398,0.015859239
Louisiana,LAFOURCHE PARISH,85860,71402,10667,1249,14458,0.831609597,0.168390403,0.014546937
Louisiana,LA SALLE PARISH,13662,12247,1256,46,1415,0.896428049,0.103571951,0.003367003
Louisiana,LINCOLN PARISH,41745,24425,16546,381,17320,0.585100012,0.414899988,0.009126842
Louisiana,LIVINGSTON PARISH,70526,65689,3914,642,4837,0.931415365,0.068584635,0.009103026
Louisiana,MADISON PARISH,12463,4917,7390,126,7546,0.394527802,0.605472198,0.010109925
Louisiana,MOREHOUSE PARISH,31938,18528,13209,136,13410,0.58012399,0.41987601,0.00425825
Louisiana,NATCHITOCHES PARISH,36689,22053,13706,487,14636,0.601079343,0.398920657,0.013273733
Louisiana,ORLEANS PARISH,496938,164526,305047,17238,332412,0.331079531,0.668920469,0.034688432
Louisiana,OUACHITA PARISH,142191,96045,43996,1194,46146,0.675464692,0.324535308,0.008397156
Louisiana,PLAQUEMINES PARISH,25575,18091,5898,590,7484,0.707370479,0.292629521,0.023069404
Louisiana,POINTE COUPEE PARISH,22540,13074,9244,166,9466,0.580035492,0.419964508,0.007364685
Louisiana,RAPIDES PARISH,131556,91932,36667,1526,39624,0.698805072,0.301194928,0.011599623
Louisiana,RED RIVER PARISH,9387,5720,3583,61,3667,0.609353361,0.390646639,0.006498349
Louisiana,RICHLAND PARISH,20629,12910,7492,199,7719,0.625818023,0.374181977,0.009646614
Louisiana,SABINE PARISH,22646,17143,3966,1031,5503,0.756999029,0.243000971,0.045526804
Louisiana,ST. BERNARD PARISH,66631,58424,3091,4183,8207,0.876829104,0.123170896,0.062778587
Louisiana,ST. CHARLES PARISH,42437,30913,10164,1070,11524,0.728444518,0.271555482,0.025213846
Louisiana,ST. HELENA PARISH,9874,4699,5108,46,5175,0.475896293,0.524103707,0.0046587
Louisiana,ST. JAMES PARISH,20879,10420,10329,107,10459,0.499066047,0.500933953,0.005124767
Louisiana,ST. JOHN THE BAPTIST PARISH,39996,24399,14369,954,15597,0.610036004,0.389963996,0.023852385
Louisiana,ST. LANDRY PARISH,80331,47185,32183,639,33146,0.587382206,0.412617794,0.007954588
Louisiana,ST. MARTIN PARISH,43978,28460,14443,502,15518,0.647141753,0.352858247,0.011414798
Louisiana,ST. MARY PARISH,58086,36883,18262,1128,21203,0.634972282,0.365027718,0.019419481
Louisiana,ST. TAMMANY PARISH,144508,124191,15778,3170,20317,0.859405708,0.140594292,0.021936502
Louisiana,TANGIPAHOA PARISH,85709,59895,24446,951,25814,0.698818094,0.301181906,0.011095684
Louisiana,TENSAS PARISH,7103,3279,3763,43,3824,0.461635928,0.538364072,0.00605378
Louisiana,TERREBONNE PARISH,96982,74152,15940,1376,22830,0.764595492,0.235404508,0.0141882
Louisiana,UNION PARISH,20690,14775,5742,133,5915,0.714113098,0.285886902,0.006428226
Louisiana,VERMILION PARISH,50055,41765,6930,592,8290,0.83438218,0.16561782,0.01182699
Louisiana,VERNON PARISH,61961,44012,12626,3405,17949,0.710317781,0.289682219,0.054953923
Louisiana,WASHINGTON PARISH,43185,29526,13314,239,13659,0.683709621,0.316290379,0.005534329
Louisiana,WEBSTER PARISH,41989,28389,13243,229,13600,0.676105647,0.323894353,0.005453809
Louisiana,WEST BATON ROUGE PARISH,19419,12170,6972,206,7249,0.626705804,0.373294196,0.010608167
Louisiana,WEST CARROLL PARISH,12093,9927,2010,115,2166,0.820888117,0.179111883,0.009509634
Louisiana,WEST FELICIANA PARISH,12915,5562,7090,203,7353,0.430662021,0.569337979,0.015718157
Louisiana,WINN PARISH,16269,11270,4775,139,4999,0.692728502,0.307271498,0.008543856
Maine,ANDROSCOGGIN,105259,103192,463,780,2067,0.980362724,0.019637276,0.007410293
Maine,AROOSTOOK,86936,84269,909,554,2667,0.96932226,0.03067774,0.006372504
Maine,CUMBERLAND,243135,237255,1491,1560,5880,0.975815905,0.024184095,0.006416189
Maine,FRANKLIN,29008,28699,30,110,309,0.989347766,0.010652234,0.003792057
Maine,HANCOCK,46948,46275,95,266,673,0.985664991,0.014335009,0.005665843
Maine,KENNEBEC,115904,114239,256,516,1665,0.985634663,0.014365337,0.00445196
Maine,KNOX,36310,35918,54,142,392,0.989204076,0.010795924,0.003910768
Maine,LINCOLN,30357,30082,23,126,275,0.990941134,0.009058866,0.004150608
Maine,OXFORD,52602,52092,64,206,510,0.990304551,0.009695449,0.003916201
Maine,PENOBSCOT,146601,143163,522,701,3438,0.976548591,0.023451409,0.004781686
Maine,PISCATAQUIS,18653,18435,18,69,218,0.988312872,0.011687128,0.003699137
Maine,SAGADAHOC,33535,32553,322,337,982,0.970717161,0.029282839,0.010049202
Maine,SOMERSET,49767,49257,59,172,510,0.989752245,0.010247755,0.003456105
Maine,WALDO,33018,32662,38,170,356,0.989218002,0.010781998,0.005148707
Maine,WASHINGTON,35308,33626,64,127,1682,0.952362071,0.047637929,0.003596919
Maine,YORK,164587,161640,529,993,2947,0.982094576,0.017905424,0.006033283
Maryland,ALLEGANY,74946,72715,1522,319,2231,0.9702319,0.0297681,0.004256398
Maryland,ANNE ARUNDEL,427239,361609,49954,6815,65630,0.846385747,0.153614253,0.015951259
Maryland,BALTIMORE,692134,582397,84648,8131,109737,0.841451222,0.158548778,0.011747725
Maryland,CALVERT,51372,42450,8002,502,8922,0.826325625,0.173674375,0.00977186
Maryland,CAROLINE,27035,22225,4435,231,4810,0.822082486,0.177917514,0.008544479
Maryland,CARROLL,123372,118660,2881,903,4712,0.961806569,0.038193431,0.007319327
Maryland,CECIL,71347,67053,3193,635,4294,0.939815269,0.060184731,0.008900164
Maryland,CHARLES,101154,79115,18264,1705,22039,0.782124286,0.217875714,0.016855488
Maryland,DORCHESTER,30236,21478,8382,177,8758,0.710345284,0.289654716,0.005853949
Maryland,FREDERICK,150208,138751,7922,1713,11457,0.923725767,0.076274233,0.011404186
Maryland,GARRETT,28138,27862,102,110,276,0.990191201,0.009808799,0.003909304
Maryland,HARFORD,182132,160988,15335,2821,21144,0.883908374,0.116091626,0.015488766
Maryland,HOWARD,187328,153417,21652,3699,33911,0.818975273,0.181024727,0.019746114
Maryland,KENT,17842,13775,3515,467,4067,0.772054702,0.227945298,0.026174196
Maryland,MONTGOMERY,757027,548453,89184,55684,208574,0.724482746,0.275517254,0.073556161
Maryland,PRINCE GEORGE'S,729268,303090,365705,29983,426178,0.415608528,0.584391472,0.041113829
Maryland,QUEEN ANNE'S,33953,29781,3815,189,4172,0.87712426,0.12287574,0.005566518
Maryland,ST. MARY'S,75974,63380,10194,1230,12594,0.834232764,0.165767236,0.016189749
Maryland,SOMERSET,23440,14177,8880,229,9263,0.604820819,0.395179181,0.009769625
Maryland,TALBOT,30549,24754,5468,167,5795,0.810304756,0.189695244,0.005466627
Maryland,WASHINGTON,121393,112325,7124,905,9068,0.92530047,0.07469953,0.007455125
Maryland,WICOMICO,74339,56404,16493,610,17935,0.758740365,0.241259635,0.008205652
Maryland,WORCESTER,35028,27063,7448,275,7965,0.772610483,0.227389517,0.007850862
Maryland,BALTIMORE CITY,736014,284187,433705,7602,451827,0.386116297,0.613883703,0.010328608
Massachusetts,BARNSTABLE,186605,177956,2727,2287,8649,0.95365076,0.04634924,0.012255835
Massachusetts,BERKSHIRE,139352,134177,2454,1407,5175,0.962863827,0.037136173,0.010096733
Massachusetts,BRISTOL,506325,474032,7203,13578,32293,0.936220807,0.063779193,0.026816768
Massachusetts,DUKES,11639,10896,323,121,743,0.936162901,0.063837099,0.010396082
Massachusetts,ESSEX,670080,600518,10242,48440,69562,0.896188515,0.103811485,0.072289876
Massachusetts,FRANKLIN,70092,68074,457,842,2018,0.971209268,0.028790732,0.012012783
Massachusetts,HAMPDEN,456310,373426,32105,45785,82884,0.818360325,0.181639675,0.10033749
Massachusetts,HAMPSHIRE,146568,135451,2428,3887,11117,0.924151247,0.075848753,0.026520114
Massachusetts,MIDDLESEX,1398468,1258602,37677,47383,139866,0.899986271,0.100013729,0.033882077
Massachusetts,NANTUCKET,6012,5759,140,50,253,0.957917498,0.042082502,0.0083167
Massachusetts,NORFOLK,616087,577079,11532,8414,39008,0.936684267,0.063315733,0.013657162
Massachusetts,PLYMOUTH,435276,401847,15003,9571,33429,0.923200452,0.076799548,0.021988348
Massachusetts,SUFFOLK,663906,412210,138695,72844,251696,0.620886089,0.379113911,0.109720352
Massachusetts,WORCESTER,709705,650265,13478,32940,59440,0.916246891,0.083753109,0.046413651
Michigan,ALCONA,10145,9987,23,55,158,0.984425826,0.015574174,0.00542139
Michigan,ALGER,8972,8392,211,43,580,0.935354436,0.064645564,0.004792688
Michigan,ALLEGAN,90509,85241,1419,2895,5268,0.941795844,0.058204156,0.031985769
Michigan,ALPENA,30605,30249,35,145,356,0.988367914,0.011632086,0.004737788
Michigan,ANTRIM,18185,17829,23,96,356,0.980423426,0.019576574,0.005279076
Michigan,ARENAC,14931,14577,10,167,354,0.976290938,0.023709062,0.011184783
Michigan,BARAGA,7954,6950,48,34,1004,0.873774202,0.126225798,0.004274579
Michigan,BARRY,50057,49095,103,521,962,0.980781909,0.019218091,0.010408135
Michigan,BAY,111723,105909,1228,3494,5814,0.947960581,0.052039419,0.031273775
Michigan,BENZIE,12200,11770,30,129,430,0.964754098,0.035245902,0.01057377
Michigan,BERRIEN,161378,131798,24688,2683,29580,0.81670364,0.18329636,0.016625562
Michigan,BRANCH,41502,39975,686,468,1527,0.963206592,0.036793408,0.011276565
Michigan,CALHOUN,135982,117299,14258,2583,18683,0.862606816,0.137393184,0.018995161
Michigan,CASS,49477,44423,3684,651,5054,0.897851527,0.102148473,0.013157629
Michigan,CHARLEVOIX,21468,20925,17,112,543,0.97470654,0.02529346,0.005217067
Michigan,CHEBOYGAN,21398,20768,15,80,630,0.970557996,0.029442004,0.003738667
Michigan,CHIPPEWA,34604,28206,2157,278,6398,0.81510808,0.18489192,0.008033753
Michigan,CLARE,24952,24569,39,132,383,0.984650529,0.015349471,0.005290157
Michigan,CLINTON,57883,55924,215,1286,1959,0.966155866,0.033844134,0.022217231
Michigan,CRAWFORD,12260,11737,260,79,523,0.957340946,0.042659054,0.006443719
Michigan,DELTA,37780,36729,15,136,1051,0.972181048,0.027818952,0.003599788
Michigan,DICKINSON,26831,26459,23,116,372,0.98613544,0.01386456,0.004323357
Michigan,EATON,92879,86410,3271,2199,6469,0.930350241,0.069649759,0.023675966
Michigan,EMMET,25040,24043,131,118,997,0.960183706,0.039816294,0.00471246
Michigan,GENESEE,430459,331833,83707,8877,98626,0.77088178,0.22911822,0.020622173
Michigan,GLADWIN,21896,21590,17,136,306,0.986024845,0.013975155,0.00621118
Michigan,GOGEBIC,18052,17435,240,67,617,0.965820962,0.034179038,0.0037115
Michigan,GRAND TRAVERSE,64273,62654,251,503,1619,0.974810574,0.025189426,0.007825992
Michigan,GRATIOT,38982,36956,316,1467,2026,0.948027295,0.051972705,0.037632754
Michigan,HILLSDALE,43431,42665,113,395,766,0.982362828,0.017637172,0.009094886
Michigan,HOUGHTON,35446,34364,156,164,1082,0.969474694,0.030525306,0.004626756
Michigan,HURON,34951,34405,20,372,546,0.984378129,0.015621871,0.010643472
Michigan,INGHAM,281912,231489,27315,13478,50423,0.821139221,0.178860779,0.047809245
Michigan,IONIA,57024,52553,2954,1176,4471,0.921594416,0.078405584,0.020622896
Michigan,IOSCO,30209,28739,622,357,1470,0.951339005,0.048660995,0.01181767
Michigan,IRON,13175,12974,4,67,201,0.984743833,0.015256167,0.005085389
Michigan,ISABELLA,54624,51814,628,714,2810,0.948557411,0.051442589,0.013071178
Michigan,JACKSON,149756,134283,11822,2303,15473,0.896678597,0.103321403,0.015378349
Michigan,KALAMAZOO,223411,195481,19668,3950,27930,0.874983774,0.125016226,0.017680419
Michigan,KALKASKA,13497,13263,10,87,234,0.982662814,0.017337186,0.006445877
Michigan,KENT,500631,438294,39432,14684,62337,0.87548314,0.12451686,0.029330984
Michigan,KEWEENAW,1701,1683,1,6,18,0.989417989,0.010582011,0.003527337
Michigan,LAKE,8583,7297,1142,60,1286,0.850168939,0.149831061,0.006990563
Michigan,LAPEER,74768,72225,473,1493,2543,0.965988123,0.034011877,0.019968436
Michigan,LEELANAU,16527,15836,16,188,691,0.958189629,0.041810371,0.011375325
Michigan,LENAWEE,91476,83805,1367,5515,7671,0.916141939,0.083858061,0.060289038
Michigan,LIVINGSTON,115645,112827,668,974,2818,0.975632323,0.024367677,0.008422327
Michigan,LUCE,5763,5401,2,27,362,0.937185494,0.062814506,0.00468506
Michigan,MACKINAC,10674,8933,5,33,1741,0.836893386,0.163106614,0.003091625
Michigan,MACOMB,717400,687480,10313,7978,29920,0.958293839,0.041706161,0.011120714
Michigan,MANISTEE,21265,20647,54,323,618,0.970938161,0.029061839,0.015189278
Michigan,MARQUETTE,70887,67687,1149,566,3200,0.954857731,0.045142269,0.007984539
Michigan,MASON,25537,24731,152,399,806,0.968437953,0.031562047,0.015624388
Michigan,MECOSTA,37308,35497,968,389,1811,0.951458132,0.048541868,0.010426718
Michigan,MENOMINEE,24920,24413,7,59,507,0.979654896,0.020345104,0.002367576
Michigan,MIDLAND,75651,72788,706,1035,2863,0.96215516,0.03784484,0.013681247
Michigan,MISSAUKEE,12147,11978,3,67,169,0.9860871,0.0139129,0.005515765
Michigan,MONROE,133600,128188,2308,2077,5412,0.959491018,0.040508982,0.015546407
Michigan,MONTCALM,53059,50714,949,888,2345,0.955803916,0.044196084,0.016736086
Michigan,MONTMORENCY,8936,8815,1,60,121,0.986459266,0.013540734,0.006714414
Michigan,MUSKEGON,158983,132045,21444,3623,26938,0.8305605,0.1694395,0.0227886
Michigan,NEWAYGO,38202,36433,465,968,1769,0.953693524,0.046306476,0.025338987
Michigan,OAKLAND,1083592,958300,76801,19630,125292,0.884373454,0.115626546,0.018115675
Michigan,OCEANA,22454,20729,58,1390,1725,0.923176271,0.076823729,0.061904338
Michigan,OGEMAW,18681,18405,18,104,276,0.98522563,0.01477437,0.005567154
Michigan,ONTONAGON,8854,8695,4,35,159,0.982042015,0.017957985,0.003953016
Michigan,OSCEOLA,20146,19785,54,143,361,0.98208081,0.01791919,0.007098183
Michigan,OSCODA,7842,7741,2,50,101,0.987120632,0.012879368,0.006375925
Michigan,OTSEGO,17957,17682,18,67,275,0.984685638,0.015314362,0.003731135
Michigan,OTTAWA,187768,175857,937,7947,11911,0.936565336,0.063434664,0.042323506
Michigan,PRESQUE ISLE,13743,13622,11,37,121,0.991195518,0.008804482,0.00269228
Michigan,ROSCOMMON,19776,19521,37,94,255,0.987105583,0.012894417,0.004753236
Michigan,SAGINAW,211946,160331,36273,13186,51615,0.756470988,0.243529012,0.06221396
Michigan,ST. CLAIR,145607,138894,2942,2558,6713,0.953896447,0.046103553,0.017567837
Michigan,ST. JOSEPH,58913,56296,1592,546,2617,0.955578565,0.044421435,0.009267904
Michigan,SANILAC,39928,38725,38,905,1203,0.969870767,0.030129233,0.022665798
Michigan,SCHOOLCRAFT,8302,7732,7,32,570,0.931341845,0.068658155,0.003854493
Michigan,SHIAWASSEE,69770,68041,92,1053,1729,0.975218575,0.024781425,0.015092447
Michigan,TUSCOLA,55498,53344,469,1150,2154,0.961187791,0.038812209,0.020721467
Michigan,VAN BUREN,70060,62337,4643,2254,7723,0.889765915,0.110234085,0.032172424
Michigan,WASHTENAW,282937,232938,31334,5731,49999,0.823285749,0.176714251,0.020255393
Michigan,WAYNE,2111687,1185576,845324,50506,926111,0.561435478,0.438564522,0.02391737
Michigan,WEXFORD,26360,25921,33,153,439,0.983345979,0.016654021,0.005804249
Minnesota,AITKIN,12425,12176,13,35,249,0.979959759,0.020040241,0.002816901
Minnesota,ANOKA,243641,235340,1266,2269,8301,0.96592938,0.03407062,0.009312882
Minnesota,BECKER,27881,25786,20,120,2095,0.924859223,0.075140777,0.004304006
Minnesota,BELTRAMI,34384,28337,98,146,6047,0.824133318,0.175866682,0.004246161
Minnesota,BENTON,30185,29729,61,139,456,0.984893159,0.015106841,0.004604936
Minnesota,BIG STONE,6285,6217,4,23,68,0.989180589,0.010819411,0.003659507
Minnesota,BLUE EARTH,54044,52384,248,480,1660,0.969284287,0.030715713,0.008881652
Minnesota,BROWN,26984,26711,11,151,273,0.989882894,0.010117106,0.005595909
Minnesota,CARLTON,29259,27750,43,99,1509,0.948426125,0.051573875,0.003383574
Minnesota,CARVER,47915,47008,103,252,907,0.981070646,0.018929354,0.005259313
Minnesota,CASS,21791,19251,38,94,2540,0.883438117,0.116561883,0.004313707
Minnesota,CHIPPEWA,13228,13063,5,94,165,0.987526459,0.012473541,0.007106138
Minnesota,CHISAGO,30521,30099,63,137,422,0.986173454,0.013826546,0.004488713
Minnesota,CLAY,50422,48111,164,1179,2311,0.954166832,0.045833168,0.02338265
Minnesota,CLEARWATER,8309,7653,2,16,656,0.921049464,0.078950536,0.001925623
Minnesota,COOK,3868,3558,5,14,310,0.919855222,0.080144778,0.003619442
Minnesota,COTTONWOOD,12694,12520,8,63,174,0.986292737,0.013707263,0.004962975
Minnesota,CROW WING,44249,43546,94,174,703,0.984112635,0.015887365,0.003932292
Minnesota,DAKOTA,275227,262332,3363,4025,12895,0.953147765,0.046852235,0.014624292
Minnesota,DODGE,15731,15464,11,164,267,0.983027144,0.016972856,0.010425275
Minnesota,DOUGLAS,28674,28409,14,78,265,0.990758178,0.009241822,0.002720234
Minnesota,FARIBAULT,16937,16528,10,322,409,0.975851686,0.024148314,0.019011631
Minnesota,FILLMORE,20777,20618,7,71,159,0.992347307,0.007652693,0.00341724
Minnesota,FREEBORN,33060,31771,11,1076,1289,0.961010284,0.038989716,0.032546884
Minnesota,GOODHUE,40690,39982,81,173,708,0.982600147,0.017399853,0.004251659
Minnesota,GRANT,6246,6209,3,7,37,0.994076209,0.005923791,0.001120717
Minnesota,HENNEPIN,1032431,914870,59109,13978,117561,0.886131858,0.113868142,0.013538919
Minnesota,HOUSTON,18497,18337,24,37,160,0.991349949,0.008650051,0.002000324
Minnesota,HUBBARD,14939,14609,4,37,330,0.977910168,0.022089832,0.002476739
Minnesota,ISANTI,25921,25492,67,119,429,0.983449713,0.016550287,0.004590872
Minnesota,ITASCA,40863,39263,39,143,1600,0.960844774,0.039155226,0.003499498
Minnesota,JACKSON,11677,11387,2,113,290,0.975164854,0.024835146,0.009677143
Minnesota,KANABEC,12802,12622,16,61,180,0.985939697,0.014060303,0.00476488
Minnesota,KANDIYOHI,38761,37057,75,1363,1704,0.956038286,0.043961714,0.035164211
Minnesota,KITTSON,5767,5706,0,46,61,0.989422577,0.010577423,0.007976418
Minnesota,KOOCHICHING,16299,15570,43,185,729,0.95527333,0.04472667,0.01135039
Minnesota,LAC QUI PARLE,8924,8851,9,23,73,0.991819812,0.008180188,0.00257732
Minnesota,LAKE,10415,10305,1,32,110,0.98943831,0.01056169,0.003072492
Minnesota,LAKE OF THE WOODS,4076,4027,1,25,49,0.98797841,0.01202159,0.006133464
Minnesota,LE SUEUR,23239,22987,13,123,252,0.98915616,0.01084384,0.005292827
Minnesota,LINCOLN,6890,6844,2,26,46,0.993323657,0.006676343,0.003773585
Minnesota,LYON,24789,24328,59,214,461,0.981403042,0.018596958,0.008632861
Minnesota,MCLEOD,32030,31543,30,284,487,0.984795504,0.015204496,0.008866687
Minnesota,MAHNOMEN,5044,3827,1,27,1217,0.758723236,0.241276764,0.005352895
Minnesota,MARSHALL,10993,10814,2,113,179,0.983716911,0.016283089,0.010279269
Minnesota,MARTIN,22914,22651,9,137,263,0.988522301,0.011477699,0.005978878
Minnesota,MEEKER,20846,20467,23,231,379,0.981819054,0.018180946,0.011081263
Minnesota,MILLE LACS,18670,17906,26,87,764,0.959078736,0.040921264,0.004659882
Minnesota,MORRISON,29604,29343,33,98,261,0.991183624,0.008816376,0.003310363
Minnesota,MOWER,37385,36728,67,248,657,0.982426107,0.017573893,0.006633677
Minnesota,MURRAY,9660,9619,0,21,41,0.995755694,0.004244306,0.002173913
Minnesota,NICOLLET,28076,27529,84,203,547,0.980517168,0.019482832,0.007230375
Minnesota,NOBLES,20098,19318,49,262,780,0.961190168,0.038809832,0.013036123
Minnesota,NORMAN,7975,7816,4,72,159,0.980062696,0.019937304,0.009028213
Minnesota,OLMSTED,106470,101255,767,970,5215,0.951019066,0.048980934,0.009110548
Minnesota,OTTER TAIL,50714,50052,27,224,662,0.986946405,0.013053595,0.004416926
Minnesota,PENNINGTON,13306,13042,10,106,264,0.980159327,0.019840673,0.007966331
Minnesota,PINE,21264,20137,324,348,1127,0.946999624,0.053000376,0.016365688
Minnesota,PIPESTONE,10491,10221,6,42,270,0.974263655,0.025736345,0.004003432
Minnesota,POLK,32498,30824,53,1146,1674,0.948489138,0.051510862,0.035263709
Minnesota,POPE,10745,10694,5,7,51,0.995253606,0.004746394,0.000651466
Minnesota,RAMSEY,485765,420949,22096,13890,64816,0.866569226,0.133430774,0.028594073
Minnesota,RED LAKE,4525,4469,0,46,56,0.987624309,0.012375691,0.010165746
Minnesota,REDWOOD,17254,16832,27,91,422,0.975541903,0.024458097,0.005274139
Minnesota,RENVILLE,17673,17345,6,216,328,0.981440616,0.018559384,0.012222034
Minnesota,RICE,49183,47770,166,530,1413,0.971270561,0.028729439,0.010776081
Minnesota,ROCK,9806,9713,12,29,93,0.990516011,0.009483989,0.002957373
Minnesota,ROSEAU,15026,14755,4,26,271,0.981964595,0.018035405,0.001730334
Minnesota,ST. LOUIS,198213,191447,1083,952,6766,0.965865004,0.034134996,0.004802914
Minnesota,SCOTT,57846,56312,259,407,1534,0.973481312,0.026518688,0.007035923
Minnesota,SHERBURNE,41945,41031,262,259,914,0.97820956,0.02179044,0.006174753
Minnesota,SIBLEY,14366,14187,5,127,179,0.987540025,0.012459975,0.008840317
Minnesota,STEARNS,118791,116726,408,512,2065,0.982616528,0.017383472,0.004310091
Minnesota,STEELE,30729,29934,51,544,795,0.974128673,0.025871327,0.017703147
Minnesota,STEVENS,10634,10343,56,56,291,0.972634945,0.027365055,0.005266128
Minnesota,SWIFT,10724,10566,4,79,158,0.985266692,0.014733308,0.007366654
Minnesota,TODD,23363,23189,8,58,174,0.992552326,0.007447674,0.002482558
Minnesota,TRAVERSE,4463,4314,0,8,149,0.966614385,0.033385615,0.001792516
Minnesota,WABASHA,19744,19518,11,79,226,0.988553485,0.011446515,0.004001216
Minnesota,WADENA,13154,12986,8,47,168,0.98722822,0.01277178,0.003573058
Minnesota,WASECA,18079,17814,26,129,265,0.98534211,0.01465789,0.00713535
Minnesota,WASHINGTON,145896,140127,1548,1895,5769,0.960458135,0.039541865,0.012988704
Minnesota,WATONWAN,11682,10990,8,593,692,0.940763568,0.059236432,0.050761856
Minnesota,WILKIN,7516,7405,2,43,111,0.985231506,0.014768494,0.005721128
Minnesota,WINONA,47828,46655,183,350,1173,0.975474617,0.024525383,0.007317889
Minnesota,WRIGHT,68710,67831,74,284,879,0.987207102,0.012792898,0.004133314
Minnesota,YELLOW MEDICINE,11684,11465,3,82,219,0.981256419,0.018743581,0.007018144
Mississippi,ADAMS,35356,17938,17162,152,17418,0.507353773,0.492646227,0.004299129
Mississippi,ALCORN,31722,27988,3529,127,3734,0.882289893,0.117710107,0.004003531
Mississippi,AMITE,13328,7252,6026,33,6076,0.544117647,0.455882353,0.00247599
Mississippi,ATTALA,18481,11103,7260,58,7378,0.600779179,0.399220821,0.003138358
Mississippi,BENTON,8046,4849,3153,37,3197,0.602659707,0.397340293,0.004598558
Mississippi,BOLIVAR,41875,15123,26214,377,26752,0.361146269,0.638853731,0.009002985
Mississippi,CALHOUN,14908,10788,4024,78,4120,0.723638315,0.276361685,0.00523209
Mississippi,CARROLL,9237,5541,3633,42,3696,0.599870088,0.400129912,0.004546931
Mississippi,CHICKASAW,18085,11022,6944,85,7063,0.60945535,0.39054465,0.004700028
Mississippi,CHOCTAW,9071,6294,2726,31,2777,0.693859552,0.306140448,0.003417484
Mississippi,CLAIBORNE,11370,1976,9302,56,9394,0.173790677,0.826209323,0.004925242
Mississippi,CLARKE,17313,11271,5963,64,6042,0.651013689,0.348986311,0.003696644
Mississippi,CLAY,21120,9745,11245,80,11375,0.461410985,0.538589015,0.003787879
Mississippi,COAHOMA,31665,10933,20335,271,20732,0.345270804,0.654729196,0.008558345
Mississippi,COPIAH,27592,13553,13885,108,14039,0.491193099,0.508806901,0.003914178
Mississippi,COVINGTON,16527,10671,5779,49,5856,0.645670721,0.354329279,0.002964845
Mississippi,DESOTO,67910,58686,8646,306,9224,0.86417317,0.13582683,0.004505964
Mississippi,FORREST,68314,46315,20947,499,21999,0.677972304,0.322027696,0.007304506
Mississippi,FRANKLIN,8377,5277,3074,21,3100,0.629939119,0.370060881,0.002506864
Mississippi,GEORGE,16673,14989,1581,48,1684,0.898998381,0.101001619,0.002878906
Mississippi,GREENE,10220,7954,2185,65,2266,0.778277886,0.221722114,0.006360078
Mississippi,GRENADA,21555,12522,8886,86,9033,0.580932498,0.419067502,0.003989794
Mississippi,HANCOCK,31760,28172,2758,549,3588,0.887027708,0.112972292,0.017285894
Mississippi,HARRISON,165365,125635,32083,2939,39730,0.759743597,0.240256403,0.017772806
Mississippi,HINDS,254441,122614,129216,1148,131827,0.481895606,0.518104394,0.004511851
Mississippi,HOLMES,21604,5161,16336,62,16443,0.238890946,0.761109054,0.002869839
Mississippi,HUMPHREYS,12134,3837,8177,69,8297,0.316218889,0.683781111,0.005686501
Mississippi,ISSAQUENA,1909,833,1066,6,1076,0.436354112,0.563645888,0.003143007
Mississippi,ITAWAMBA,20017,18514,1357,99,1503,0.924913823,0.075086177,0.004945796
Mississippi,JACKSON,115243,89315,23512,1060,25928,0.775014535,0.224985465,0.009197956
Mississippi,JASPER,17114,8378,8680,41,8736,0.489540727,0.510459273,0.002395699
Mississippi,JEFFERSON,8653,1174,7430,43,7479,0.135675488,0.864324512,0.004969375
Mississippi,JEFFERSON DAVIS,14051,6324,7640,44,7727,0.450074728,0.549925272,0.00313145
Mississippi,JONES,62031,46064,15457,205,15967,0.742596444,0.257403556,0.003304799
Mississippi,KEMPER,10356,4395,5721,32,5961,0.424391657,0.575608343,0.003089996
Mississippi,LAFAYETTE,31826,22999,7955,203,8827,0.722648149,0.277351851,0.006378433
Mississippi,LAMAR,30424,26477,3628,168,3947,0.870266895,0.129733105,0.005521956
Mississippi,LAUDERDALE,75555,48444,26204,501,27111,0.641175303,0.358824697,0.006630931
Mississippi,LAWRENCE,12458,8275,4109,51,4183,0.664231819,0.335768181,0.004093755
Mississippi,LEAKE,18436,11073,6530,49,7363,0.600618355,0.399381645,0.002657843
Mississippi,LEE,65581,51059,13972,360,14522,0.778563913,0.221436087,0.005489395
Mississippi,LEFLORE,37341,14471,22572,146,22870,0.387536488,0.612463512,0.003909911
Mississippi,LINCOLN,30278,21132,9021,60,9146,0.697932492,0.302067508,0.001981637
Mississippi,LOWNDES,59308,36442,21990,491,22866,0.614453362,0.385546638,0.008278816
Mississippi,MADISON,53794,29635,23656,276,24159,0.55089787,0.44910213,0.005130684
Mississippi,MARION,25544,17651,7683,137,7893,0.691003758,0.308996242,0.005363295
Mississippi,MARSHALL,30361,14797,15331,133,15564,0.487368664,0.512631336,0.00438062
Mississippi,MONROE,36582,25321,11021,186,11261,0.692171013,0.307828987,0.005084468
Mississippi,MONTGOMERY,12388,6903,5408,50,5485,0.557232806,0.442767194,0.004036164
Mississippi,NESHOBA,24800,16888,4602,104,7912,0.680967742,0.319032258,0.004193548
Mississippi,NEWTON,20291,13643,5826,85,6648,0.672367059,0.327632941,0.004189049
Mississippi,NOXUBEE,12604,3952,8575,27,8652,0.313551254,0.686448746,0.002142177
Mississippi,OKTIBBEHA,38375,23871,13131,330,14504,0.622045603,0.377954397,0.008599349
Mississippi,PANOLA,29996,15326,14452,153,14670,0.510934791,0.489065209,0.00510068
Mississippi,PEARL RIVER,38714,32670,5522,300,6044,0.843880767,0.156119233,0.007749135
Mississippi,PERRY,10865,8300,2447,46,2565,0.763920847,0.236079153,0.004233778
Mississippi,PIKE,36882,19826,16810,173,17056,0.537552193,0.462447807,0.004690635
Mississippi,PONTOTOC,22237,18873,3235,65,3364,0.848720601,0.151279399,0.002923056
Mississippi,PRENTISS,23278,20397,2739,94,2881,0.876235072,0.123764928,0.004038148
Mississippi,QUITMAN,10490,4219,6189,48,6271,0.402192564,0.597807436,0.004575786
Mississippi,RANKIN,87161,71683,14573,520,15478,0.822420578,0.177579422,0.005965971
Mississippi,SCOTT,24137,14767,9149,141,9370,0.611799312,0.388200688,0.005841654
Mississippi,SHARKEY,7066,2337,4653,48,4729,0.330738749,0.669261251,0.006793094
Mississippi,SIMPSON,23953,16086,7732,67,7867,0.671565148,0.328434852,0.002797144
Mississippi,SMITH,14798,11456,3237,81,3342,0.77415867,0.22584133,0.005473713
Mississippi,STONE,10750,8326,2335,54,2424,0.774511628,0.225488372,0.005023256
Mississippi,SUNFLOWER,32867,11556,21001,184,21311,0.351598868,0.648401132,0.005598321
Mississippi,TALLAHATCHIE,15210,6235,8836,82,8975,0.409927679,0.590072321,0.00539119
Mississippi,TATE,21432,13888,7361,121,7544,0.648002986,0.351997014,0.005645763
Mississippi,TIPPAH,19523,16206,3221,64,3317,0.830097833,0.169902167,0.003278185
Mississippi,TISHOMINGO,17683,16967,628,56,716,0.959509133,0.040490867,0.003166883
Mississippi,TUNICA,8164,1986,6089,81,6178,0.243263106,0.756736894,0.009921607
Mississippi,UNION,22085,18744,3202,103,3341,0.848720851,0.151279149,0.004663799
Mississippi,WALTHALL,14352,8216,6044,50,6136,0.572463768,0.427536232,0.003483835
Mississippi,WARREN,47880,28743,18609,254,19137,0.600313283,0.399686717,0.005304929
Mississippi,WASHINGTON,67935,28174,39035,416,39761,0.414719953,0.585280047,0.0061235
Mississippi,WAYNE,19517,12469,6920,75,7048,0.638878926,0.361121074,0.003842804
Mississippi,WEBSTER,10222,7914,2238,57,2308,0.774212483,0.225787517,0.005576208
Mississippi,WILKINSON,9678,3103,6511,45,6575,0.320624096,0.679375904,0.004649721
Mississippi,WINSTON,19433,11121,8064,70,8312,0.572273967,0.427726033,0.00360212
Mississippi,YALOBUSHA,12033,7448,4512,53,4585,0.618964514,0.381035486,0.004404554
Mississippi,YAZOO,25506,11923,13401,103,13583,0.467458637,0.532541363,0.004038266
Missouri,ADAIR,24577,23919,213,182,658,0.973227001,0.026772999,0.007405298
Missouri,ANDREW,14632,14437,30,103,195,0.986673045,0.013326955,0.007039366
Missouri,ATCHISON,7457,7238,82,104,219,0.970631621,0.029368379,0.013946627
Missouri,AUDRAIN,23599,21976,1417,81,1623,0.931225899,0.068774101,0.003432349
Missouri,BARRY,27547,27030,24,152,517,0.981232076,0.018767924,0.005517842
Missouri,BARTON,11312,11113,11,57,199,0.982408062,0.017591938,0.005038897
Missouri,BATES,15025,14756,107,82,269,0.982096506,0.017903494,0.005457571
Missouri,BENTON,13859,13677,13,78,182,0.986867739,0.013132261,0.005628112
Missouri,BOLLINGER,10619,10479,12,70,140,0.986816084,0.013183916,0.006591958
Missouri,BOONE,112379,99275,8306,1226,13104,0.883394584,0.116605416,0.010909512
Missouri,BUCHANAN,83083,78233,2615,1709,4850,0.94162464,0.05837536,0.020569792
Missouri,BUTLER,38765,36329,1971,217,2436,0.937159809,0.062840191,0.005597833
Missouri,CALDWELL,8380,8293,14,50,87,0.989618138,0.010381862,0.005966587
Missouri,CALLAWAY,32809,30832,1579,171,1977,0.939742144,0.060257856,0.005211985
Missouri,CAMDEN,27495,27120,57,170,375,0.986361157,0.013638843,0.006182942
Missouri,CAPE GIRARDEAU,61633,57761,2979,313,3872,0.937176513,0.062823487,0.005078448
Missouri,CARROLL,10748,10460,219,40,288,0.973204317,0.026795683,0.003721623
Missouri,CARTER,5515,5443,1,33,72,0.986944696,0.013055304,0.005983681
Missouri,CASS,63808,61689,672,829,2119,0.966790998,0.033209002,0.012992101
Missouri,CEDAR,12093,11935,3,58,158,0.98693459,0.01306541,0.004796163
Missouri,CHARITON,9202,8820,337,19,382,0.958487285,0.041512715,0.002064769
Missouri,CHRISTIAN,32644,32126,35,216,518,0.984131847,0.015868153,0.006616836
Missouri,CLARK,7547,7506,3,26,41,0.994567378,0.005432622,0.003445078
Missouri,CLAY,153411,145334,2649,3539,8077,0.947350581,0.052649419,0.02306875
Missouri,CLINTON,16595,16033,326,139,562,0.966134378,0.033865622,0.008376017
Missouri,COLE,63579,57837,4776,447,5742,0.909687161,0.090312839,0.007030623
Missouri,COOPER,14835,13491,1143,96,1344,0.909403438,0.090596562,0.006471183
Missouri,CRAWFORD,19173,18995,3,114,178,0.990716111,0.009283889,0.005945861
Missouri,DADE,7449,7279,20,76,170,0.977178145,0.022821855,0.010202712
Missouri,DALLAS,12646,12462,16,65,184,0.985449945,0.014550055,0.005139965
Missouri,DAVIESS,7865,7781,2,46,84,0.989319771,0.010680229,0.005848697
Missouri,DEKALB,9967,8934,729,200,1033,0.896357981,0.103642019,0.020066219
Missouri,DENT,13702,13513,9,89,189,0.986206393,0.013793607,0.006495402
Missouri,DOUGLAS,11876,11680,3,90,196,0.983496127,0.016503873,0.007578309
Missouri,DUNKLIN,33112,30155,2624,169,2957,0.910697028,0.089302972,0.00510389
Missouri,FRANKLIN,80603,79069,737,441,1534,0.98096845,0.01903155,0.00547126
Missouri,GASCONADE,14006,13924,10,35,82,0.994145366,0.005854634,0.002498929
Missouri,GENTRY,6848,6785,6,27,63,0.990800234,0.009199766,0.003942757
Missouri,GREENE,207949,199639,3712,1775,8310,0.960038279,0.039961721,0.008535747
Missouri,GRUNDY,10536,10381,11,77,155,0.985288535,0.014711465,0.007308276
Missouri,HARRISON,8469,8374,8,37,95,0.988782619,0.011217381,0.004368875
Missouri,HENRY,20044,19545,227,144,499,0.97510477,0.02489523,0.007184195
Missouri,HICKORY,7335,7242,5,29,93,0.987321063,0.012678937,0.003953647
Missouri,HOLT,6034,5982,7,16,52,0.991382168,0.008617832,0.002651641
Missouri,HOWARD,9631,8802,732,45,829,0.913923788,0.086076212,0.004672412
Missouri,HOWELL,31447,30983,62,161,464,0.985245015,0.014754985,0.005119725
Missouri,IRON,10726,10601,49,44,125,0.988346075,0.011653925,0.004102182
Missouri,JACKSON,633232,470011,134828,18890,163221,0.74224139,0.25775861,0.029831089
Missouri,JASPER,90465,86530,1147,797,3935,0.956502515,0.043497485,0.008810037
Missouri,JEFFERSON,171380,168071,1188,1151,3309,0.980692029,0.019307971,0.00671607
Missouri,JOHNSON,42514,38589,2407,709,3925,0.907677471,0.092322529,0.016676859
Missouri,KNOX,4482,4454,6,9,28,0.993752789,0.006247211,0.002008032
Missouri,LACLEDE,27158,26702,95,141,456,0.983209367,0.016790633,0.00519184
Missouri,LAFAYETTE,31107,29831,873,219,1276,0.958980294,0.041019706,0.007040216
Missouri,LAWRENCE,30236,29667,24,211,569,0.981181373,0.018818627,0.006978436
Missouri,LEWIS,10233,9823,342,26,410,0.959933548,0.040066452,0.002540799
Missouri,LINCOLN,28892,27928,588,219,964,0.966634362,0.033365638,0.007579953
Missouri,LINN,13885,13645,107,94,240,0.98271516,0.01728484,0.006769896
Missouri,LIVINGSTON,14592,14148,316,63,444,0.969572368,0.030427632,0.004317434
Missouri,MCDONALD,16938,16230,4,121,708,0.958200496,0.041799504,0.007143701
Missouri,MACON,15345,14852,363,59,493,0.967872271,0.032127729,0.003844901
Missouri,MADISON,11127,10988,10,62,139,0.987507864,0.012492136,0.005572032
Missouri,MARIES,7976,7879,27,40,97,0.987838516,0.012161484,0.005015045
Missouri,MARION,27682,26131,1239,118,1551,0.943970811,0.056029189,0.004262698
Missouri,MERCER,3723,3706,3,7,17,0.99543379,0.00456621,0.001880204
Missouri,MILLER,20700,20469,23,101,231,0.98884058,0.01115942,0.004879227
Missouri,MISSISSIPPI,14442,11565,2796,40,2877,0.800789364,0.199210636,0.002769699
Missouri,MONITEAU,12298,12006,157,46,292,0.976256302,0.023743698,0.003740446
Missouri,MONROE,9104,8675,351,48,429,0.952877856,0.047122144,0.005272408
Missouri,MONTGOMERY,11355,10987,289,45,368,0.967591369,0.032408631,0.003963012
Missouri,MORGAN,15574,15314,94,69,260,0.983305509,0.016694491,0.004430461
Missouri,NEW MADRID,20928,17497,3267,93,3431,0.836056957,0.163943043,0.004443807
Missouri,NEWTON,44445,42757,173,353,1688,0.962020475,0.037979525,0.007942401
Missouri,NODAWAY,21709,21203,164,135,506,0.976691695,0.023308305,0.006218619
Missouri,OREGON,9470,9383,3,32,87,0.990813094,0.009186906,0.003379092
Missouri,OSAGE,12018,11901,38,56,117,0.990264603,0.009735397,0.004659677
Missouri,OZARK,8598,8490,2,56,108,0.987438939,0.012561061,0.006513143
Missouri,PEMISCOT,21921,16175,5575,89,5746,0.737876922,0.262123078,0.004060034
Missouri,PERRY,16648,16467,11,72,181,0.989127823,0.010872177,0.004324844
Missouri,PETTIS,35437,33781,1164,268,1656,0.953269182,0.046730818,0.007562717
Missouri,PHELPS,35248,33626,396,303,1622,0.953983205,0.046016795,0.008596232
Missouri,PIKE,15969,14939,832,119,1030,0.935500031,0.064499969,0.007451938
Missouri,PLATTE,57867,54438,1195,1161,3429,0.940743429,0.059256571,0.020063248
Missouri,POLK,21826,21384,67,173,442,0.979748923,0.020251077,0.007926326
Missouri,PULASKI,41307,32377,5493,1953,8930,0.783813881,0.216186119,0.047280122
Missouri,PUTNAM,5079,5042,1,24,37,0.992715101,0.007284899,0.00472534
Missouri,RALLS,8476,8300,138,14,176,0.979235488,0.020764512,0.001651723
Missouri,RANDOLPH,24370,22199,1826,179,2171,0.910915059,0.089084941,0.007345096
Missouri,RAY,21971,21410,296,119,561,0.974466342,0.025533658,0.00541623
Missouri,REYNOLDS,6661,6613,3,28,48,0.992793875,0.007206125,0.004203573
Missouri,RIPLEY,12303,12150,6,78,153,0.987564009,0.012435991,0.006339917
Missouri,ST. CHARLES,212907,203705,4917,2308,9202,0.956779251,0.043220749,0.010840414
Missouri,ST. CLAIR,8457,8356,22,33,101,0.988057231,0.011942769,0.003902093
Missouri,STE. GENEVIEVE,16037,15888,45,49,149,0.990708985,0.009291015,0.003055434
Missouri,ST. FRANCOIS,48904,47489,945,239,1415,0.971065761,0.028934239,0.004887126
Missouri,ST. LOUIS,993529,829052,138786,9811,164477,0.834451737,0.165548263,0.0098749
Missouri,SALINE,23523,21862,1342,208,1661,0.929388258,0.070611742,0.00884241
Missouri,SCHUYLER,4236,4207,0,18,29,0.993153919,0.006846081,0.004249292
Missouri,SCOTLAND,4822,4797,3,12,25,0.994815429,0.005184571,0.002488594
Missouri,SCOTT,39376,35537,3486,206,3839,0.902504063,0.097495937,0.005231613
Missouri,SHANNON,7613,7559,3,22,54,0.99290687,0.00709313,0.002889794
Missouri,SHELBY,6942,6841,55,23,101,0.985450879,0.014549121,0.003313166
Missouri,STODDARD,28895,28249,408,132,646,0.977643191,0.022356809,0.004568264
Missouri,STONE,19078,18790,6,114,288,0.984904078,0.015095922,0.005975469
Missouri,SULLIVAN,6326,6281,1,28,45,0.9928865,0.0071135,0.004426178
Missouri,TANEY,25561,25119,16,194,442,0.982708032,0.017291968,0.007589687
Missouri,TEXAS,21476,21203,16,113,273,0.987288136,0.012711864,0.005261687
Missouri,VERNON,19041,18703,59,102,338,0.982248831,0.017751169,0.005356862
Missouri,WARREN,19534,18790,507,152,744,0.961912563,0.038087437,0.007781304
Missouri,WASHINGTON,20380,19863,378,83,517,0.974631992,0.025368008,0.00407262
Missouri,WAYNE,11543,11437,7,44,106,0.990816945,0.009183055,0.003811834
Missouri,WEBSTER,23753,23232,190,140,521,0.978065929,0.021934071,0.005893992
Missouri,WORTH,2440,2424,1,9,16,0.993442623,0.006557377,0.003688525
Missouri,WRIGHT,16758,16524,36,61,234,0.98603652,0.01396348,0.003640053
Missouri,ST. LOUIS CITY,396685,198956,187805,5124,197729,0.501546567,0.498453433,0.01291705
Montana,BEAVERHEAD,8424,8138,8,133,286,0.966049383,0.033950617,0.015788224
Montana,BIG HORN,11337,4801,16,294,6536,0.423480639,0.576519361,0.025932786
Montana,BLAINE,6728,4026,6,54,2702,0.598394768,0.401605232,0.008026159
Montana,BROADWATER,3318,3235,1,33,83,0.974984931,0.025015069,0.00994575
Montana,CARBON,8080,7928,3,90,152,0.981188119,0.018811881,0.011138614
Montana,CARTER,1503,1480,0,12,23,0.984697272,0.015302728,0.007984032
Montana,CASCADE,77691,71569,1018,1398,6122,0.921200654,0.078799346,0.017994362
Montana,CHOUTEAU,5452,5205,4,25,247,0.954695525,0.045304475,0.004585473
Montana,CUSTER,11697,11309,11,160,388,0.966829101,0.033170899,0.013678721
Montana,DANIELS,2266,2230,0,12,36,0.984112974,0.015887026,0.005295675
Montana,DAWSON,9505,9341,0,64,164,0.982745923,0.017254077,0.006733298
Montana,DEER LODGE,10278,9816,29,157,462,0.955049621,0.044950379,0.015275345
Montana,FALLON,3103,3075,0,6,28,0.990976474,0.009023526,0.001933613
Montana,FERGUS,12083,11874,8,72,209,0.982702971,0.017297029,0.005958785
Montana,FLATHEAD,59218,57447,55,616,1771,0.970093553,0.029906447,0.010402243
Montana,GALLATIN,50463,48751,78,593,1712,0.966074153,0.033925847,0.011751184
Montana,GARFIELD,1589,1583,0,0,6,0.99622404,0.00377596,0
Montana,GLACIER,12121,5244,11,78,6877,0.432637571,0.567362429,0.006435113
Montana,GOLDEN VALLEY,912,890,0,8,22,0.975877193,0.024122807,0.00877193
Montana,GRANITE,2548,2514,0,9,34,0.986656201,0.013343799,0.003532182
Montana,HILL,17654,14646,19,176,3008,0.829613685,0.170386315,0.009969412
Montana,JEFFERSON,7939,7715,4,83,224,0.97178486,0.02821514,0.010454717
Montana,JUDITH BASIN,2282,2262,0,8,20,0.991235758,0.008764242,0.003505697
Montana,LAKE,21041,16270,14,402,4771,0.773252222,0.226747778,0.019105556
Montana,LEWIS AND CLARK,47495,45597,63,576,1898,0.960037899,0.039962101,0.012127592
Montana,LIBERTY,2295,2274,3,4,21,0.990849673,0.009150327,0.001742919
Montana,LINCOLN,17481,16945,11,197,536,0.969338139,0.030661861,0.011269378
Montana,MCCONE,2276,2246,1,10,30,0.986818981,0.013181019,0.004393673
Montana,MADISON,5989,5847,0,88,142,0.976289865,0.023710135,0.014693605
Montana,MEAGHER,1819,1774,0,26,45,0.975261132,0.024738868,0.014293568
Montana,MINERAL,3315,3174,3,41,141,0.957466063,0.042533937,0.012368024
Montana,MISSOULA,78687,75017,172,962,3670,0.953359513,0.046640487,0.012225654
Montana,MUSSELSHELL,4106,4034,2,36,72,0.982464686,0.017535314,0.008767657
Montana,PARK,14562,14091,60,232,471,0.967655542,0.032344458,0.015931877
Montana,PETROLEUM,519,516,0,0,3,0.994219653,0.005780347,0
Montana,PHILLIPS,5163,4718,2,44,445,0.913809801,0.086190199,0.008522177
Montana,PONDERA,6433,5676,5,31,757,0.882325509,0.117674491,0.004818903
Montana,POWDER RIVER,2090,2030,0,20,60,0.971291866,0.028708134,0.009569378
Montana,POWELL,6620,6239,22,77,381,0.94244713,0.05755287,0.01163142
Montana,PRAIRIE,1383,1348,0,16,35,0.974692697,0.025307303,0.011569053
Montana,RAVALLI,25010,24256,34,369,754,0.969852059,0.030147941,0.014754098
Montana,RICHLAND,10716,10309,3,240,407,0.96201941,0.03798059,0.022396417
Montana,ROOSEVELT,10999,5545,17,103,5454,0.50413674,0.49586326,0.009364488
Montana,ROSEBUD,10505,7470,25,225,3035,0.711089957,0.288910043,0.021418372
Montana,SANDERS,8669,8058,12,104,611,0.929518976,0.070481024,0.01199677
Montana,SHERIDAN,4732,4632,0,38,100,0.978867287,0.021132713,0.008030431
Montana,SILVER BOW,33941,32500,32,810,1441,0.957543973,0.042456027,0.023864942
Montana,STILLWATER,6536,6383,5,92,153,0.976591187,0.023408813,0.014075887
Montana,SWEET GRASS,3154,3121,2,7,33,0.989537096,0.010462904,0.002219404
Montana,TETON,6271,6127,3,37,144,0.977037155,0.022962845,0.005900175
Montana,TOOLE,5046,4871,5,36,175,0.965319065,0.034680935,0.007134364
Montana,TREASURE,874,840,0,26,34,0.961098398,0.038901602,0.029748284
Montana,VALLEY,8239,7390,9,62,849,0.896953514,0.103046486,0.007525185
Montana,WHEATLAND,2246,2196,1,22,50,0.977738201,0.022261799,0.009795191
Montana,WIBAUX,1191,1185,0,2,6,0.994962217,0.005037783,0.001679261
Montana,YELLOWSTONE,113419,106068,465,3158,7351,0.935187226,0.064812774,0.027843659
Montana,YELLOWSTONE NATIONAL PARK,52,52,0,0,0,1,0,0
Nebraska,ADAMS,29625,28922,181,303,703,0.976270042,0.023729958,0.010227848
Nebraska,ANTELOPE,7965,7928,2,5,37,0.995354677,0.004645323,0.000627746
Nebraska,ARTHUR,462,459,0,0,3,0.993506494,0.006493506,0
Nebraska,BANNER,852,829,1,19,23,0.973004695,0.026995305,0.022300469
Nebraska,BLAINE,675,671,1,0,4,0.994074074,0.005925926,0
Nebraska,BOONE,6667,6636,1,17,31,0.995350232,0.004649768,0.002549873
Nebraska,BOX BUTTE,13130,12022,49,722,1108,0.9156131,0.0843869,0.054988576
Nebraska,BOYD,2835,2806,0,6,29,0.989770723,0.010229277,0.002116402
Nebraska,BROWN,3657,3617,1,21,40,0.989062073,0.010937927,0.005742412
Nebraska,BUFFALO,37447,35992,161,1023,1455,0.961145085,0.038854915,0.02731861
Nebraska,BURT,7868,7708,8,74,160,0.979664464,0.020335536,0.009405186
Nebraska,BUTLER,8601,8542,10,20,59,0.993140333,0.006859667,0.002325311
Nebraska,CASS,21318,20909,39,195,409,0.980814335,0.019185665,0.0091472
Nebraska,CEDAR,10131,10085,6,17,46,0.995459481,0.004540519,0.001678018
Nebraska,CHASE,4381,4281,1,88,100,0.977174161,0.022825839,0.020086738
Nebraska,CHERRY,6307,6091,2,24,216,0.965752339,0.034247661,0.003805296
Nebraska,CHEYENNE,9494,9090,6,317,404,0.957446809,0.042553191,0.033389509
Nebraska,CLAY,7123,7050,1,43,73,0.989751509,0.010248491,0.006036782
Nebraska,COLFAX,9139,8878,3,224,261,0.971441077,0.028558923,0.02451034
Nebraska,CUMING,10117,10064,8,15,53,0.994761293,0.005238707,0.001482653
Nebraska,CUSTER,12270,12104,3,84,166,0.986471068,0.013528932,0.006845966
Nebraska,DAKOTA,16742,14996,74,1016,1746,0.895711385,0.104288615,0.060685701
Nebraska,DAWES,9021,8409,53,142,612,0.932158297,0.067841703,0.015741049
Nebraska,DAWSON,19940,19164,11,663,776,0.96108325,0.03891675,0.033249749
Nebraska,DEUEL,2237,2118,1,102,119,0.946803755,0.053196245,0.045596781
Nebraska,DIXON,6143,6121,4,4,22,0.996418688,0.003581312,0.000651148
Nebraska,DODGE,34500,33979,63,223,521,0.984898551,0.015101449,0.006463768
Nebraska,DOUGLAS,416444,353374,45104,11368,63070,0.848551066,0.151448934,0.027297788
Nebraska,DUNDY,2582,2559,0,15,23,0.991092177,0.008907823,0.00580945
Nebraska,FILLMORE,7103,7014,13,35,89,0.987470083,0.012529917,0.004927495
Nebraska,FRANKLIN,3938,3908,6,8,30,0.99238192,0.00761808,0.002031488
Nebraska,FRONTIER,3101,3062,1,19,39,0.987423412,0.012576588,0.006127056
Nebraska,FURNAS,5553,5490,2,37,63,0.988654781,0.011345219,0.006663065
Nebraska,GAGE,22794,22459,45,110,335,0.98530315,0.01469685,0.004825831
Nebraska,GARDEN,2460,2445,0,15,15,0.993902439,0.006097561,0.006097561
Nebraska,GARFIELD,2141,2130,0,3,11,0.994862214,0.005137786,0.001401214
Nebraska,GOSPER,1928,1918,0,9,10,0.994813278,0.005186722,0.00466805
Nebraska,GRANT,769,759,0,2,10,0.986996099,0.013003901,0.00260078
Nebraska,GREELEY,3006,2997,0,2,9,0.997005988,0.002994012,0.000665336
Nebraska,HALL,48925,45986,134,2116,2939,0.939928462,0.060071538,0.043249872
Nebraska,HAMILTON,8862,8766,9,57,96,0.989167231,0.010832769,0.006431957
Nebraska,HARLAN,3810,3800,2,5,10,0.997375328,0.002624672,0.001312336
Nebraska,HAYES,1222,1212,0,6,10,0.991816694,0.008183306,0.004909984
Nebraska,HITCHCOCK,3750,3715,0,23,35,0.990666667,0.009333333,0.006133333
Nebraska,HOLT,12599,12526,3,23,73,0.994205889,0.005794111,0.001825542
Nebraska,HOOKER,793,779,0,14,14,0.982345523,0.017654477,0.017654477
Nebraska,HOWARD,6055,6000,1,42,55,0.990916598,0.009083402,0.006936416
Nebraska,JEFFERSON,8759,8646,2,81,113,0.987098984,0.012901016,0.009247631
Nebraska,JOHNSON,4673,4522,1,47,151,0.967686711,0.032313289,0.010057779
Nebraska,KEARNEY,6629,6506,0,114,123,0.981445165,0.018554835,0.017197164
Nebraska,KEITH,8584,8185,10,336,399,0.953518173,0.046481827,0.039142591
Nebraska,KEYA PAHA,1029,1027,0,1,2,0.998056365,0.001943635,0.000971817
Nebraska,KIMBALL,4108,3947,2,146,161,0.960808179,0.039191821,0.035540409
Nebraska,KNOX,9534,9025,0,9,509,0.946612125,0.053387875,0.00094399
Nebraska,LANCASTER,213641,200521,4583,3938,13120,0.938588567,0.061411433,0.018432791
Nebraska,LINCOLN,32508,30561,90,1623,1947,0.940107051,0.059892949,0.049926172
Nebraska,LOGAN,878,872,3,3,6,0.993166287,0.006833713,0.003416856
Nebraska,LOUP,683,681,0,1,2,0.997071742,0.002928258,0.001464129
Nebraska,MCPHERSON,546,545,1,0,1,0.998168498,0.001831502,0
Nebraska,MADISON,32655,31524,238,569,1131,0.965365181,0.034634819,0.01742459
Nebraska,MERRICK,8042,7938,2,71,104,0.987067894,0.012932106,0.00882865
Nebraska,MORRILL,5423,4952,1,434,471,0.913147704,0.086852296,0.080029504
Nebraska,NANCE,4275,4224,1,38,51,0.988070175,0.011929825,0.008888889
Nebraska,NEMAHA,7980,7862,71,20,118,0.985213033,0.014786967,0.002506266
Nebraska,NUCKOLLS,5786,5760,1,17,26,0.995506395,0.004493605,0.002938127
Nebraska,OTOE,14252,14062,25,106,190,0.986668538,0.013331462,0.007437553
Nebraska,PAWNEE,3317,3290,3,17,27,0.991860115,0.008139885,0.005125113
Nebraska,PERKINS,3367,3299,0,53,68,0.97980398,0.02019602,0.015741016
Nebraska,PHELPS,9715,9587,5,91,128,0.986824498,0.013175502,0.009366958
Nebraska,PIERCE,7827,7779,0,14,48,0.993867382,0.006132618,0.00178868
Nebraska,PLATTE,29820,29374,53,255,446,0.985043595,0.014956405,0.008551308
Nebraska,POLK,5675,5623,1,30,52,0.990837004,0.009162996,0.005286344
Nebraska,RED WILLOW,11705,11435,13,210,270,0.976932935,0.023067065,0.017941051
Nebraska,RICHARDSON,9937,9701,5,44,236,0.976250377,0.023749623,0.004427896
Nebraska,ROCK,2019,2012,0,6,7,0.996532937,0.003467063,0.002971768
Nebraska,SALINE,12715,12486,16,74,229,0.981989776,0.018010224,0.005819898
Nebraska,SARPY,102583,91663,5236,3383,10920,0.893549613,0.106450387,0.032978174
Nebraska,SAUNDERS,18285,18090,14,104,195,0.989335521,0.010664479,0.005687722
Nebraska,SCOTTS BLUFF,36025,29938,51,5237,6087,0.831034004,0.168965996,0.14537127
Nebraska,SEWARD,15450,15280,20,80,170,0.988996764,0.011003236,0.005177994
Nebraska,SHERIDAN,6750,6170,2,68,580,0.914074074,0.085925926,0.010074074
Nebraska,SHERMAN,3718,3697,0,8,21,0.994351802,0.005648198,0.002151694
Nebraska,SIOUX,1549,1501,0,44,48,0.969012266,0.030987734,0.028405423
Nebraska,STANTON,6244,6157,23,23,87,0.986066624,0.013933376,0.003683536
Nebraska,THAYER,6635,6546,4,59,89,0.986586285,0.013413715,0.008892238
Nebraska,THOMAS,851,839,0,11,12,0.985898942,0.014101058,0.012925969
Nebraska,THURSTON,6936,3857,8,62,3079,0.556084198,0.443915802,0.00893887
Nebraska,VALLEY,5169,5126,6,17,43,0.991681176,0.008318824,0.003288837
Nebraska,WASHINGTON,16607,16348,82,104,259,0.984404167,0.015595833,0.006262419
Nebraska,WAYNE,9364,9241,39,22,123,0.986864588,0.013135412,0.002349423
Nebraska,WEBSTER,4279,4248,1,11,31,0.992755317,0.007244683,0.002570694
Nebraska,WHEELER,948,945,0,0,3,0.996835443,0.003164557,0
Nebraska,YORK,14428,14133,88,112,295,0.979553646,0.020446354,0.007762684
Nevada,CHURCHILL,17938,15430,200,1008,2508,0.860185082,0.139814918,0.056193556
Nevada,CLARK,741459,558875,68858,82904,182584,0.753750376,0.246249624,0.111811982
Nevada,DOUGLAS,27637,25019,81,1652,2618,0.905271918,0.094728082,0.059774939
Nevada,ELKO,33530,26730,249,4339,6800,0.79719654,0.20280346,0.129406502
Nevada,ESMERALDA,1344,1137,7,125,207,0.845982143,0.154017857,0.093005952
Nevada,EUREKA,1547,1354,5,138,193,0.875242405,0.124757595,0.089204913
Nevada,HUMBOLDT,12844,9721,70,2335,3123,0.756851448,0.243148552,0.181796948
Nevada,LANDER,6266,5200,9,789,1066,0.829875519,0.170124481,0.125917651
Nevada,LINCOLN,3775,3463,79,156,312,0.917350993,0.082649007,0.041324503
Nevada,LYON,20001,17707,65,1511,2294,0.885305735,0.114694265,0.075546223
Nevada,MINERAL,6475,4871,343,546,1604,0.752277992,0.247722008,0.084324324
Nevada,NYE,17781,15635,274,1237,2146,0.879309375,0.120690625,0.069568641
Nevada,PERSHING,4336,3442,13,662,894,0.793819188,0.206180812,0.152675277
Nevada,STOREY,2526,2345,8,96,181,0.92834521,0.07165479,0.038004751
Nevada,WASHOE,254667,212416,5414,22959,42251,0.834093149,0.165906851,0.090153023
Nevada,WHITE PINE,9264,7928,178,852,1336,0.855785838,0.144214162,0.091968912
Nevada,CARSON CITY,40443,35084,650,3110,5359,0.86749252,0.13250748,0.076898351
New Hampshire,BELKNAP,49216,48581,62,245,635,0.987097692,0.012902308,0.004978056
New Hampshire,CARROLL,35410,35039,64,132,371,0.989522734,0.010477266,0.003727761
New Hampshire,CHESHIRE,70121,69130,201,334,991,0.985867287,0.014132713,0.004763195
New Hampshire,COOS,34828,34449,33,150,379,0.989117951,0.010882049,0.00430688
New Hampshire,GRAFTON,74929,72915,384,599,2014,0.973121221,0.026878779,0.007994235
New Hampshire,HILLSBOROUGH,336073,323113,2738,5696,12960,0.96143695,0.03856305,0.016948699
New Hampshire,MERRIMACK,120005,117997,415,780,2008,0.983267364,0.016732636,0.006499729
New Hampshire,ROCKINGHAM,245845,238500,2232,2395,7345,0.970123452,0.029876548,0.009741911
New Hampshire,STRAFFORD,104233,101668,559,837,2565,0.975391671,0.024608329,0.008030086
New Hampshire,SULLIVAN,38592,38092,61,165,500,0.987043947,0.012956053,0.004275498
New Jersey,ATLANTIC,224327,165233,37734,16117,59094,0.736572058,0.263427942,0.071846011
New Jersey,BERGEN,825380,682210,38037,49776,143170,0.826540503,0.173459497,0.060306768
New Jersey,BURLINGTON,395066,318109,55063,12819,76957,0.8052047,0.1947953,0.032447743
New Jersey,CAMDEN,502824,376357,77875,36022,126467,0.748486548,0.251513452,0.071639381
New Jersey,CAPE MAY,95089,87192,5223,1855,7897,0.916951488,0.083048512,0.01950804
New Jersey,CUMBERLAND,138053,95129,22167,18348,42924,0.689075935,0.310924065,0.132905478
New Jersey,ESSEX,778206,350985,305786,97777,427221,0.451018111,0.548981889,0.12564411
New Jersey,GLOUCESTER,230082,202989,19591,4131,27093,0.88224633,0.11775367,0.017954468
New Jersey,HUDSON,553099,262077,69856,183465,291022,0.473833798,0.526166202,0.331703728
New Jersey,HUNTERDON,107776,102400,2119,1732,5376,0.950118765,0.049881235,0.016070368
New Jersey,MERCER,325824,236143,59449,19665,89681,0.72475631,0.27524369,0.06035467
New Jersey,MIDDLESEX,671780,516948,49733,59776,154832,0.769519783,0.230480217,0.088981512
New Jersey,MONMOUTH,553124,469109,45683,22407,84015,0.8481082,0.1518918,0.040509904
New Jersey,MORRIS,421353,372418,11931,19814,48935,0.883862225,0.116137775,0.047024704
New Jersey,OCEAN,433203,403371,11405,13950,29832,0.931136211,0.068863789,0.032201993
New Jersey,PASSAIC,453060,284276,57746,98092,168784,0.627457732,0.372542268,0.216509955
New Jersey,SALEM,65294,53839,9391,1436,11455,0.824562747,0.175437253,0.021992832
New Jersey,SOMERSET,240279,204834,14403,10187,35445,0.852483987,0.147516013,0.042396547
New Jersey,SUSSEX,130943,125403,1191,2911,5540,0.957691515,0.042308485,0.022231047
New Jersey,UNION,493819,322247,89222,67797,171572,0.652560959,0.347439041,0.137291194
New Jersey,WARREN,91607,87697,1240,1784,3910,0.957317672,0.042682328,0.019474494
New Mexico,BERNALILLO,480577,267965,11862,178310,212612,0.557590147,0.442409853,0.371033154
New Mexico,CATRON,2563,1808,7,728,755,0.705423332,0.294576668,0.284042138
New Mexico,CHAVES,57849,34792,1094,21271,23057,0.601427855,0.398572145,0.367698664
New Mexico,CIBOLA,23794,6491,179,8109,17303,0.272799866,0.727200134,0.340800202
New Mexico,COLFAX,12925,6571,29,6190,6354,0.508394584,0.491605416,0.478916828
New Mexico,CURRY,42207,28331,2772,10015,13876,0.671239368,0.328760632,0.237282915
New Mexico,DEBACA,2252,1480,2,736,772,0.657193606,0.342806394,0.326820604
New Mexico,DONA ANA,135510,55158,1968,76448,80352,0.407040071,0.592959929,0.564150247
New Mexico,EDDY,48605,30236,742,17145,18369,0.622075918,0.377924082,0.352741488
New Mexico,GRANT,27676,13241,120,14061,14435,0.478428964,0.521571036,0.508057523
New Mexico,GUADALUPE,4156,597,7,3505,3559,0.143647738,0.856352262,0.843358999
New Mexico,HARDING,987,517,2,461,470,0.523809524,0.476190476,0.467071935
New Mexico,HIDALGO,5958,2917,9,2984,3041,0.489593823,0.510406177,0.500839208
New Mexico,LEA,55765,36089,2546,16598,19676,0.647162199,0.352837801,0.29764189
New Mexico,LINCOLN,12219,8585,60,3427,3634,0.70259432,0.29740568,0.28046485
New Mexico,LOS ALAMOS,18115,15467,88,2008,2648,0.853822799,0.146177201,0.110847364
New Mexico,LUNA,18110,9113,209,8628,8997,0.50320265,0.49679735,0.476421866
New Mexico,MCKINLEY,60686,9614,282,7764,51072,0.158422041,0.841577959,0.127937251
New Mexico,MORA,4264,615,2,3623,3649,0.144230769,0.855769231,0.84967167
New Mexico,OTERO,51928,33268,2650,12380,18660,0.640656293,0.359343707,0.238407025
New Mexico,QUAY,10823,6497,124,4060,4326,0.600295667,0.399704333,0.375127044
New Mexico,RIO ARRIBA,34365,4375,117,24955,29990,0.127309763,0.872690237,0.726174887
New Mexico,ROOSEVELT,16702,11702,210,4548,5000,0.700634655,0.299365345,0.272302718
New Mexico,SANDOVAL,63319,32390,844,17372,30929,0.511536821,0.488463179,0.274356828
New Mexico,SAN JUAN,91605,45813,402,12009,45792,0.500114623,0.499885377,0.131095464
New Mexico,SAN MIGUEL,25743,4689,145,20491,21054,0.182146603,0.817853397,0.795983374
New Mexico,SANTA FE,98928,46450,505,48939,52478,0.469533398,0.530466602,0.49469311
New Mexico,SIERRA,9912,7419,29,2379,2493,0.748486683,0.251513317,0.240012107
New Mexico,SOCORRO,14764,5972,106,7057,8792,0.404497426,0.595502574,0.477986995
New Mexico,TAOS,23118,6401,46,15008,16717,0.276883813,0.723116187,0.649191106
New Mexico,TORRANCE,10285,6224,34,3892,4061,0.605153136,0.394846864,0.378415168
New Mexico,UNION,4124,2718,2,1390,1406,0.659068865,0.340931135,0.337051406
New Mexico,VALENCIA,45235,20659,448,22733,24576,0.45670388,0.54329612,0.502553333
New York,ALBANY,292594,257512,24068,5311,35082,0.88010007,0.11989993,0.018151432
New York,ALLEGANY,50470,49453,295,313,1017,0.979849415,0.020150585,0.006201704
New York,BRONX,1203789,272503,369113,523111,931286,0.226371067,0.773628933,0.43455373
New York,BROOME,212160,201385,4132,2478,10775,0.949212858,0.050787142,0.011679864
New York,CATTARAUGUS,84234,80757,742,534,3477,0.958722131,0.041277869,0.006339483
New York,CAYUGA,82313,77719,2774,1202,4594,0.944188646,0.055811354,0.014602797
New York,CHAUTAUQUA,141895,134436,2297,4055,7459,0.947432961,0.052567039,0.028577469
New York,CHEMUNG,95195,87800,4913,1441,7395,0.922317349,0.077682651,0.01513735
New York,CHENANGO,51768,50615,354,476,1153,0.977727554,0.022272446,0.009194869
New York,CLINTON,85969,79647,3330,2105,6322,0.926461864,0.073538136,0.02448557
New York,COLUMBIA,62982,59246,2290,1021,3736,0.940681465,0.059318535,0.016210981
New York,CORTLAND,48963,47838,317,447,1125,0.977023467,0.022976533,0.009129343
New York,DELAWARE,47225,45930,447,536,1295,0.972578084,0.027421916,0.011349921
New York,DUTCHESS,259462,222791,20558,9765,36671,0.858665238,0.141334762,0.037635569
New York,ERIE,968532,822166,108240,22249,146366,0.848878509,0.151121491,0.022971879
New York,ESSEX,37152,35227,931,748,1925,0.948185831,0.051814169,0.020133506
New York,FRANKLIN,46540,41435,1508,1123,5105,0.890309411,0.109690589,0.024129781
New York,FULTON,54191,52817,614,411,1374,0.974645236,0.025354764,0.007584285
New York,GENESEE,60060,57660,1038,451,2400,0.96003996,0.03996004,0.007509158
New York,GREENE,44739,40902,1977,1522,3837,0.914235902,0.085764098,0.034019536
New York,HAMILTON,5279,5219,12,31,60,0.988634211,0.011365789,0.005872324
New York,HERKIMER,65797,64990,182,370,807,0.987735003,0.012264997,0.005623357
New York,JEFFERSON,110943,100179,6200,3136,10764,0.902977205,0.097022795,0.028266768
New York,KINGS,2300664,923229,797802,462411,1377435,0.401288063,0.598711937,0.200990236
New York,LEWIS,26796,26403,110,128,393,0.985333632,0.014666368,0.004776832
New York,LIVINGSTON,62372,59485,1380,975,2887,0.953713205,0.046286795,0.015632014
New York,MADISON,69120,67139,716,572,1981,0.971339699,0.028660301,0.008275463
New York,MONROE,713968,589723,82876,26450,124245,0.825979596,0.174020404,0.037046478
New York,MONTGOMERY,51981,48601,343,2703,3380,0.934976241,0.065023759,0.051999769
New York,NASSAU,1287348,1063903,105315,77386,223445,0.826429994,0.173570006,0.060112728
New York,NEW YORK,1487536,726755,261120,386630,760781,0.488562966,0.511437034,0.259913037
New York,NIAGARA,220756,203818,11973,2098,16938,0.923272754,0.076727246,0.009503705
New York,ONEIDA,250836,229617,12638,5804,21219,0.915406879,0.084593121,0.023138624
New York,ONONDAGA,468973,414524,36912,7195,54449,0.883897367,0.116102633,0.015342035
New York,ONTARIO,95101,91496,1596,1266,3605,0.962092933,0.037907067,0.013312163
New York,ORANGE,307647,260968,20731,21535,46679,0.848270908,0.151729092,0.069999057
New York,ORLEANS,41846,37890,2574,1029,3956,0.905462888,0.094537112,0.024590164
New York,OSWEGO,121771,119132,578,1159,2639,0.978328173,0.021671827,0.009517866
New York,OTSEGO,60517,58595,757,720,1922,0.968240329,0.031759671,0.011897483
New York,PUTNAM,83941,80016,806,2246,3925,0.953240967,0.046759033,0.026756889
New York,QUEENS,1951598,937557,390842,381120,1014041,0.480404776,0.519595224,0.195286119
New York,RENSSELAER,154429,144946,5024,1864,9483,0.93859314,0.06140686,0.012070272
New York,RICHMOND,378977,303081,28172,30239,75896,0.799734549,0.200265451,0.079791122
New York,ROCKLAND,265475,212066,24352,17711,53409,0.798817214,0.201182786,0.06671438
New York,ST. LAWRENCE,111974,107708,1364,1275,4266,0.96190187,0.03809813,0.011386572
New York,SARATOGA,181276,175536,2131,1951,5740,0.968335577,0.031664423,0.010762594
New York,SCHENECTADY,149285,138428,6133,2489,10857,0.927273336,0.072726664,0.016672807
New York,SCHOHARIE,31859,30767,369,538,1092,0.965723971,0.034276029,0.016886908
New York,SCHUYLER,18662,18254,148,165,408,0.978137391,0.021862609,0.008841496
New York,SENECA,33683,32501,513,363,1182,0.964908114,0.035091886,0.01077695
New York,STEUBEN,99088,96638,1135,518,2450,0.975274503,0.024725497,0.005227676
New York,SUFFOLK,1321864,1130694,77303,87852,191170,0.855378466,0.144621534,0.066460695
New York,SULLIVAN,69277,58243,5572,4747,11034,0.840726359,0.159273641,0.06852202
New York,TIOGA,52337,51256,298,367,1081,0.979345396,0.020654604,0.007012248
New York,TOMPKINS,94097,83475,3023,2117,10622,0.887116486,0.112883514,0.022498061
New York,ULSTER,165304,148769,7198,6832,16535,0.899972172,0.100027828,0.041329913
New York,WARREN,59209,58059,299,476,1150,0.980577277,0.019422723,0.008039318
New York,WASHINGTON,59330,56097,1712,1313,3233,0.945508175,0.054491825,0.022130457
New York,WAYNE,89123,84263,2735,1518,4860,0.945468622,0.054531378,0.01703264
New York,WESTCHESTER,874866,640558,114265,86194,234308,0.732178414,0.267821586,0.098522517
New York,WYOMING,42507,39442,1840,1004,3065,0.927894229,0.072105771,0.023619639
New York,YATES,22810,22330,139,230,480,0.978956598,0.021043402,0.010083297
North Carolina,ALAMANCE,108213,85913,20763,736,22300,0.793924944,0.206075056,0.006801401
North Carolina,ALEXANDER,27544,25597,1662,184,1947,0.929313099,0.070686901,0.006680221
North Carolina,ALLEGHANY,9590,9316,176,85,274,0.971428571,0.028571429,0.008863399
North Carolina,ANSON,23474,12232,11078,67,11242,0.52108716,0.47891284,0.002854222
North Carolina,ASHE,22209,21910,144,102,299,0.98653699,0.01346301,0.004592733
North Carolina,AVERY,14867,14554,156,118,313,0.97894666,0.02105334,0.007937042
North Carolina,BEAUFORT,42283,28845,13155,197,13438,0.682189059,0.317810941,0.004659083
North Carolina,BERTIE,20388,7782,12512,32,12606,0.381695115,0.618304885,0.001569551
North Carolina,BLADEN,28663,16860,11167,150,11803,0.588214772,0.411785228,0.005233228
North Carolina,BRUNSWICK,50985,41120,9172,376,9865,0.806511719,0.193488281,0.007374718
North Carolina,BUNCOMBE,174821,158117,14279,1173,16704,0.904450838,0.095549162,0.00670972
North Carolina,BURKE,75744,69306,5159,344,6438,0.915003169,0.084996831,0.004541614
North Carolina,CABARRUS,98935,84964,12805,483,13971,0.858786072,0.141213928,0.004881993
North Carolina,CALDWELL,70709,66322,3864,315,4387,0.937956979,0.062043021,0.004454878
North Carolina,CAMDEN,5904,4375,1481,24,1529,0.741023035,0.258976965,0.004065041
North Carolina,CARTERET,52556,47188,4369,450,5368,0.897861329,0.102138671,0.008562295
North Carolina,CASWELL,20693,12099,8409,136,8594,0.584690475,0.415309525,0.006572271
North Carolina,CATAWBA,118412,105795,10649,921,12617,0.893448299,0.106551701,0.007777928
North Carolina,CHATHAM,38759,29194,8794,564,9565,0.753218607,0.246781393,0.014551459
North Carolina,CHEROKEE,20170,19233,358,131,937,0.953544869,0.046455131,0.006494794
North Carolina,CHOWAN,13506,8314,5041,95,5192,0.615578262,0.384421738,0.007033911
North Carolina,CLAY,7155,7028,41,40,127,0.982250175,0.017749825,0.005590496
North Carolina,CLEVELAND,84714,66152,17701,376,18562,0.780886276,0.219113724,0.004438464
North Carolina,COLUMBUS,49587,32816,15122,242,16771,0.661786355,0.338213645,0.004880311
North Carolina,CRAVEN,81613,57796,20940,1821,23817,0.708171492,0.291828508,0.022312622
North Carolina,CUMBERLAND,274566,165057,86216,13298,109509,0.601156006,0.398843994,0.048432799
North Carolina,CURRITUCK,13736,11965,1542,110,1771,0.871068725,0.128931275,0.008008154
North Carolina,DARE,22746,21626,807,199,1120,0.950760573,0.049239427,0.008748791
North Carolina,DAVIDSON,126677,112937,12275,602,13740,0.891535164,0.108464836,0.004752244
North Carolina,DAVIE,27859,25115,2473,129,2744,0.901504002,0.098495998,0.004630461
North Carolina,DUPLIN,39995,25635,13200,1015,14360,0.640955119,0.359044881,0.025378172
North Carolina,DURHAM,181835,108722,67385,2054,73113,0.597915693,0.402084307,0.011295955
North Carolina,EDGECOMBE,56558,24581,31565,255,31977,0.434615793,0.565384207,0.004508646
North Carolina,FORSYTH,265878,195660,65858,2102,70218,0.735901428,0.264098572,0.007905882
North Carolina,FRANKLIN,36414,23197,12791,290,13217,0.637035206,0.362964794,0.00796397
North Carolina,GASTON,175093,150295,22602,864,24798,0.858372408,0.141627592,0.004934521
North Carolina,GATES,9305,5087,4176,21,4218,0.546695325,0.453304675,0.002256851
North Carolina,GRAHAM,7196,6707,1,29,489,0.932045581,0.067954419,0.004030017
North Carolina,GRANVILLE,38345,22913,14872,356,15432,0.597548572,0.402451428,0.009284131
North Carolina,GREENE,15384,8690,6505,169,6694,0.564872595,0.435127405,0.010985439
North Carolina,GUILFORD,347420,247891,91282,2887,99529,0.713519659,0.286480341,0.008309827
North Carolina,HALIFAX,55516,25915,27488,237,29601,0.466802363,0.533197637,0.00426904
North Carolina,HARNETT,67822,50553,15221,1159,17269,0.745377606,0.254622394,0.01708885
North Carolina,HAYWOOD,46942,45815,647,240,1127,0.975991649,0.024008351,0.005112692
North Carolina,HENDERSON,69285,65606,2348,846,3679,0.946900484,0.053099516,0.012210435
North Carolina,HERTFORD,22523,9172,12952,81,13351,0.407228167,0.592771833,0.003596324
North Carolina,HOKE,22856,9556,9840,218,13300,0.418095905,0.581904095,0.009537977
North Carolina,HYDE,5411,3582,1778,43,1829,0.661984846,0.338015154,0.007946775
North Carolina,IREDELL,92931,76897,14821,672,16034,0.827463387,0.172536613,0.007231172
North Carolina,JACKSON,26846,23507,425,155,3339,0.875623929,0.124376071,0.005773672
North Carolina,JOHNSTON,81306,65370,14331,1262,15936,0.803999705,0.196000295,0.01552161
North Carolina,JONES,9414,5665,3670,53,3749,0.601763331,0.398236669,0.005629913
North Carolina,LEE,41374,30928,9310,800,10446,0.747522599,0.252477401,0.019335815
North Carolina,LENOIR,57274,34136,22456,463,23138,0.596012152,0.403987848,0.008083947
North Carolina,LINCOLN,50319,45359,4096,570,4960,0.901428884,0.098571116,0.011327729
North Carolina,MCDOWELL,35681,33820,1474,114,1861,0.94784339,0.05215661,0.003194978
North Carolina,MACON,23499,22818,384,165,681,0.971020043,0.028979957,0.007021575
North Carolina,MADISON,16953,16684,135,86,269,0.984132602,0.015867398,0.005072848
North Carolina,MARTIN,25078,13772,11149,99,11306,0.5491666,0.4508334,0.003947683
North Carolina,MECKLENBURG,511433,360554,133866,6693,150879,0.70498775,0.29501225,0.013086758
North Carolina,MITCHELL,14433,14324,23,50,109,0.992447863,0.007552137,0.003464283
North Carolina,MONTGOMERY,23346,16564,5986,556,6782,0.709500557,0.290499443,0.023815643
North Carolina,MOORE,59013,47260,10832,470,11753,0.800840493,0.199159507,0.007964347
North Carolina,NASH,76677,51563,24067,606,25114,0.672470232,0.327529768,0.007903283
North Carolina,NEW HANOVER,120284,94288,23983,924,25996,0.783878155,0.216121845,0.00768182
North Carolina,NORTHAMPTON,20798,8371,12257,116,12427,0.402490624,0.597509376,0.005577459
North Carolina,ONSLOW,149838,108890,29137,8035,40948,0.726718189,0.273281811,0.053624581
North Carolina,ORANGE,93851,75055,14847,1279,18796,0.799725096,0.200274904,0.013627985
North Carolina,PAMLICO,11372,8317,2940,61,3055,0.731357721,0.268642279,0.005364052
North Carolina,PASQUOTANK,31298,19259,11557,246,12039,0.615342833,0.384657167,0.007859927
North Carolina,PENDER,28855,19723,8739,273,9132,0.683521054,0.316478946,0.009461099
North Carolina,PERQUIMANS,10447,6959,3421,28,3488,0.666124246,0.333875754,0.002680195
North Carolina,PERSON,30180,20655,9080,249,9525,0.684393638,0.315606362,0.008250497
North Carolina,PITT,107924,70217,35813,977,37707,0.650615248,0.349384752,0.009052667
North Carolina,POLK,14416,13201,1053,115,1215,0.915718646,0.084281354,0.007977248
North Carolina,RANDOLPH,106546,98659,6350,734,7887,0.925975635,0.074024365,0.006889043
North Carolina,RICHMOND,44518,30729,12798,293,13789,0.69026012,0.30973988,0.006581607
North Carolina,ROBESON,105179,37850,26125,704,67329,0.35986271,0.64013729,0.006693351
North Carolina,ROCKINGHAM,86064,67603,17492,620,18461,0.78549684,0.21450316,0.007203941
North Carolina,ROWAN,110605,91521,17719,651,19084,0.827458072,0.172541928,0.00588581
North Carolina,RUTHERFORD,56918,49896,6488,342,7022,0.876629537,0.123370463,0.006008644
North Carolina,SAMPSON,47297,30016,15630,727,17281,0.634627989,0.365372011,0.015370954
North Carolina,SCOTLAND,33754,18867,12071,318,14887,0.558955976,0.441044024,0.009421106
North Carolina,STANLY,51765,45102,5954,309,6663,0.871283686,0.128716314,0.005969284
North Carolina,STOKES,37223,34787,2063,254,2436,0.934556591,0.065443409,0.006823738
North Carolina,SURRY,61704,58160,2765,602,3544,0.942564501,0.057435499,0.009756256
North Carolina,SWAIN,11268,7930,191,78,3338,0.703762868,0.296237132,0.006922258
North Carolina,TRANSYLVANIA,25520,24004,1185,154,1516,0.940595611,0.059404389,0.006034483
North Carolina,TYRRELL,3856,2294,1542,11,1562,0.594917012,0.405082988,0.002852697
North Carolina,UNION,84211,69624,13358,675,14587,0.826780349,0.173219651,0.00801558
North Carolina,VANCE,38892,21019,17475,271,17873,0.540445336,0.459554664,0.006968014
North Carolina,WAKE,423380,321008,87565,5396,102372,0.758203033,0.241796967,0.012745052
North Carolina,WARREN,17265,6571,9818,98,10694,0.380596583,0.619403417,0.005676224
North Carolina,WASHINGTON,13997,7531,6351,65,6466,0.538043867,0.461956133,0.004643852
North Carolina,WATAUGA,36952,35725,766,249,1227,0.966794761,0.033205239,0.006738472
North Carolina,WAYNE,104666,68529,33683,1356,36137,0.654739839,0.345260161,0.012955497
North Carolina,WILKES,59393,56044,2818,362,3349,0.943612884,0.056387116,0.006094994
North Carolina,WILSON,66061,40461,24817,537,25600,0.612479375,0.387520625,0.008128851
North Carolina,YADKIN,30488,28755,1294,388,1733,0.943157964,0.056842036,0.012726319
North Carolina,YANCEY,15419,15181,151,49,238,0.984564498,0.015435502,0.003177897
North Dakota,ADAMS,3174,3160,3,1,14,0.995589162,0.004410838,0.00031506
North Dakota,BARNES,12545,12389,27,34,156,0.987564767,0.012435233,0.002710243
North Dakota,BENSON,7198,4408,0,24,2790,0.612392331,0.387607669,0.00333426
North Dakota,BILLINGS,1108,1105,0,0,3,0.997292419,0.002707581,0
North Dakota,BOTTINEAU,8011,7916,6,16,95,0.988141306,0.011858694,0.001997254
North Dakota,BOWMAN,3596,3580,0,6,16,0.995550612,0.004449388,0.001668521
North Dakota,BURKE,3002,2970,1,14,32,0.98934044,0.01065956,0.004663558
North Dakota,BURLEIGH,60131,57919,66,361,2212,0.96321365,0.03678635,0.006003559
North Dakota,CASS,102874,99986,274,700,2888,0.971926823,0.028073177,0.00680444
North Dakota,CAVALIER,6064,6004,4,8,60,0.990105541,0.009894459,0.001319261
North Dakota,DICKEY,6107,6032,8,33,75,0.987719011,0.012280989,0.005403635
North Dakota,DIVIDE,2899,2876,1,7,23,0.99206623,0.00793377,0.002414626
North Dakota,DUNN,4005,3596,0,26,409,0.897877653,0.102122347,0.006491885
North Dakota,EDDY,2951,2897,0,4,54,0.981701118,0.018298882,0.001355473
North Dakota,EMMONS,4830,4814,0,7,16,0.996687371,0.003312629,0.001449275
North Dakota,FOSTER,3983,3949,0,10,34,0.991463721,0.008536279,0.00251067
North Dakota,GOLDEN VALLEY,2108,2087,0,1,21,0.990037951,0.009962049,0.000474383
North Dakota,GRAND FORKS,70683,66128,1413,1053,4555,0.935557348,0.064442652,0.0148975
North Dakota,GRANT,3549,3501,1,10,48,0.986475063,0.013524937,0.002817695
North Dakota,GRIGGS,3303,3286,0,4,17,0.994853164,0.005146836,0.00121102
North Dakota,HETTINGER,3445,3428,0,3,17,0.995065312,0.004934688,0.000870827
North Dakota,KIDDER,3332,3321,0,7,11,0.996698679,0.003301321,0.00210084
North Dakota,LAMOURE,5383,5368,0,8,15,0.99721345,0.00278655,0.00148616
North Dakota,LOGAN,2847,2832,1,9,15,0.994731296,0.005268704,0.003161222
North Dakota,MCHENRY,6528,6493,4,13,35,0.99463848,0.00536152,0.001991422
North Dakota,MCINTOSH,4021,4002,1,6,19,0.995274807,0.004725193,0.001492166
North Dakota,MCKENZIE,6383,5426,2,54,957,0.8500705,0.1499295,0.008459972
North Dakota,MCLEAN,10457,9857,3,38,600,0.942622167,0.057377833,0.003633929
North Dakota,MERCER,9808,9493,12,42,315,0.967883361,0.032116639,0.004282219
North Dakota,MORTON,23700,23168,12,74,532,0.977552743,0.022447257,0.003122363
North Dakota,MOUNTRAIL,7021,5591,4,25,1430,0.79632531,0.20367469,0.003560746
North Dakota,NELSON,4410,4391,2,8,19,0.99569161,0.00430839,0.001814059
North Dakota,OLIVER,2381,2338,0,4,43,0.981940361,0.018059639,0.001679966
North Dakota,PEMBINA,9238,8978,14,87,260,0.97185538,0.02814462,0.009417623
North Dakota,PIERCE,5052,5011,2,1,41,0.991884402,0.008115598,0.000197941
North Dakota,RAMSEY,12681,12001,20,49,680,0.946376469,0.053623531,0.003864049
North Dakota,RANSOM,5921,5872,4,24,49,0.991724371,0.008275629,0.004053369
North Dakota,RENVILLE,3160,3106,14,6,54,0.982911392,0.017088608,0.001898734
North Dakota,RICHLAND,18148,17595,21,46,553,0.969528323,0.030471677,0.002534715
North Dakota,ROLETTE,12772,4204,28,65,8568,0.329157532,0.670842468,0.005089258
North Dakota,SARGENT,4549,4523,1,10,26,0.994284458,0.005715542,0.002198285
North Dakota,SHERIDAN,2148,2137,0,1,11,0.994878957,0.005121043,0.000465549
North Dakota,SIOUX,3761,905,3,29,2856,0.240627493,0.759372507,0.007710715
North Dakota,SLOPE,907,903,0,1,4,0.995589857,0.004410143,0.001102536
North Dakota,STARK,22832,22471,17,126,361,0.984188858,0.015811142,0.00551857
North Dakota,STEELE,2420,2411,0,5,9,0.996280992,0.003719008,0.002066116
North Dakota,STUTSMAN,22241,21873,46,84,368,0.983453981,0.016546019,0.003776809
North Dakota,TOWNER,3627,3562,2,5,65,0.982078853,0.017921147,0.00137855
North Dakota,TRAILL,8752,8568,12,101,184,0.978976234,0.021023766,0.011540219
North Dakota,WALSH,13840,13231,17,441,609,0.95599711,0.04400289,0.031864162
North Dakota,WARD,57921,54131,1385,857,3790,0.934566047,0.065433953,0.014796015
North Dakota,WELLS,5864,5846,2,7,18,0.996930423,0.003069577,0.001193724
North Dakota,WILLIAMS,21129,19953,18,110,1176,0.9443419,0.0556581,0.005206115
Ohio,ADAMS,25371,25138,47,90,233,0.990816286,0.009183714,0.003547357
Ohio,ALLEN,109755,95442,12236,1240,14313,0.869591363,0.130408637,0.011297891
Ohio,ASHLAND,47507,46535,456,191,972,0.979539857,0.020460143,0.00402046
Ohio,ASHTABULA,99821,94579,3099,1538,5242,0.947486,0.052514,0.01540758
Ohio,ATHENS,59549,55884,1654,438,3665,0.938454046,0.061545954,0.007355287
Ohio,AUGLAIZE,44585,44058,65,243,527,0.988179881,0.011820119,0.005450264
Ohio,BELMONT,71074,69357,1290,194,1717,0.97584208,0.02415792,0.002729549
Ohio,BROWN,34966,34451,405,49,515,0.985271407,0.014728593,0.001401361
Ohio,BUTLER,291479,273854,13069,1467,17625,0.939532522,0.060467478,0.005032953
Ohio,CARROLL,26521,26192,134,99,329,0.987594736,0.012405264,0.003732891
Ohio,CHAMPAIGN,36019,34564,986,246,1455,0.959604653,0.040395347,0.006829729
Ohio,CLARK,147548,132640,12954,970,14908,0.898961694,0.101038306,0.006574132
Ohio,CLERMONT,150187,147494,1274,721,2693,0.982069021,0.017930979,0.004800682
Ohio,CLINTON,35415,34373,713,122,1042,0.970577439,0.029422561,0.003444868
Ohio,COLUMBIANA,108276,106057,1406,405,2219,0.979506077,0.020493923,0.003740441
Ohio,COSHOCTON,35427,34723,414,106,704,0.980128151,0.019871849,0.002992068
Ohio,CRAWFORD,47870,47188,252,246,682,0.985753081,0.014246919,0.005138918
Ohio,CUYAHOGA,1412140,1011481,348153,31447,400659,0.716275298,0.283724702,0.022269038
Ohio,DARKE,53619,52874,183,343,745,0.986105671,0.013894329,0.006396986
Ohio,DEFIANCE,39350,35999,472,2673,3351,0.914841169,0.085158831,0.067928844
Ohio,DELAWARE,66929,64670,1411,336,2259,0.966247815,0.033752185,0.005020245
Ohio,ERIE,76779,68861,6264,1180,7918,0.896872843,0.103127157,0.015368786
Ohio,FAIRFIELD,103461,101269,1125,489,2192,0.978813273,0.021186727,0.004726419
Ohio,FAYETTE,27466,26544,655,89,922,0.966431224,0.033568776,0.00324037
Ohio,FRANKLIN,961437,778255,151943,9236,183182,0.809470615,0.190529385,0.009606454
Ohio,FULTON,38498,36367,85,1842,2131,0.944646475,0.055353525,0.047846641
Ohio,GALLIA,30954,29727,856,156,1227,0.960360535,0.039639465,0.005039736
Ohio,GEAUGA,81129,79379,1056,294,1750,0.978429415,0.021570585,0.003623858
Ohio,GREENE,136731,123209,9516,1379,13522,0.90110509,0.09889491,0.010085496
Ohio,GUERNSEY,39024,38062,613,130,962,0.975348503,0.024651497,0.003331283
Ohio,HAMILTON,866228,669704,180531,5198,196524,0.773126706,0.226873294,0.00600073
Ohio,HANCOCK,65536,62808,562,1680,2728,0.958374023,0.041625977,0.025634766
Ohio,HARDIN,31111,30555,232,145,556,0.982128508,0.017871492,0.004660731
Ohio,HARRISON,16085,15610,388,43,475,0.970469381,0.029530619,0.002673298
Ohio,HENRY,29108,27487,147,1332,1621,0.944310842,0.055689158,0.045760616
Ohio,HIGHLAND,35728,34785,685,108,943,0.973606135,0.026393865,0.003022839
Ohio,HOCKING,25533,25118,234,93,415,0.983746524,0.016253476,0.003642345
Ohio,HOLMES,32849,32607,52,123,242,0.992632957,0.007367043,0.003744406
Ohio,HURON,56240,54390,589,1006,1850,0.967105263,0.032894737,0.017887624
Ohio,JACKSON,30230,29828,217,89,402,0.986701952,0.013298048,0.002944095
Ohio,JEFFERSON,80298,74941,4484,426,5357,0.93328601,0.06671399,0.005305238
Ohio,KNOX,47473,46622,374,171,851,0.982074021,0.017925979,0.003602047
Ohio,LAKE,215499,208835,3461,1469,6664,0.969076423,0.030923577,0.006816737
Ohio,LAWRENCE,61834,60003,1555,139,1831,0.970388459,0.029611541,0.002247954
Ohio,LICKING,128300,124737,2198,604,3563,0.97222915,0.02777085,0.004707716
Ohio,LOGAN,42310,41046,798,159,1264,0.970125266,0.029874734,0.003757977
Ohio,LORAIN,271126,232874,20696,15261,38252,0.858914306,0.141085694,0.056287483
Ohio,LUCAS,462361,372497,67856,15658,89864,0.805641047,0.194358953,0.033865313
Ohio,MADISON,37068,33837,2739,216,3231,0.912835869,0.087164131,0.005827129
Ohio,MAHONING,264806,218122,39213,5946,46684,0.823704901,0.176295099,0.022454174
Ohio,MARION,64274,60644,2688,485,3630,0.943523042,0.056476958,0.007545819
Ohio,MEDINA,122354,119934,847,711,2420,0.980221325,0.019778675,0.005811007
Ohio,MEIGS,22987,22690,177,59,297,0.987079654,0.012920346,0.002566668
Ohio,MERCER,39443,38972,12,280,471,0.988058718,0.011941282,0.007098852
Ohio,MIAMI,93182,90261,1769,366,2921,0.968652744,0.031347256,0.003927797
Ohio,MONROE,15497,15415,19,24,82,0.994708653,0.005291347,0.001548687
Ohio,MONTGOMERY,573809,460568,101421,4539,113241,0.802650359,0.197349641,0.007910298
Ohio,MORGAN,14194,13493,570,36,701,0.950612935,0.049387065,0.002536283
Ohio,MORROW,27749,27504,63,92,245,0.991170853,0.008829147,0.003315435
Ohio,MUSKINGUM,82068,77953,3440,247,4115,0.949858654,0.050141346,0.003009699
Ohio,NOBLE,11336,11282,7,23,54,0.995236415,0.004763585,0.002028934
Ohio,OTTAWA,40029,38132,261,1491,1897,0.952609358,0.047390642,0.037247995
Ohio,PAULDING,20488,19580,210,628,908,0.955681374,0.044318626,0.030652089
Ohio,PERRY,31557,31345,57,81,212,0.993281998,0.006718002,0.002566784
Ohio,PICKAWAY,48255,44711,2990,323,3544,0.926556833,0.073443167,0.006693607
Ohio,PIKE,24249,23736,327,74,513,0.978844488,0.021155512,0.003051672
Ohio,PORTAGE,142585,136407,3867,798,6178,0.956671459,0.043328541,0.005596662
Ohio,PREBLE,40113,39746,141,105,367,0.990850846,0.009149154,0.002617605
Ohio,PUTNAM,33819,32313,25,1418,1506,0.955468819,0.044531181,0.041929093
Ohio,RICHLAND,126137,114444,9914,903,11693,0.907299206,0.092700794,0.007158883
Ohio,ROSS,69330,64137,4412,346,5193,0.92509736,0.07490264,0.004990625
Ohio,SANDUSKY,61963,56687,1490,3544,5276,0.914852412,0.085147588,0.057195423
Ohio,SCIOTO,80327,77074,2447,261,3253,0.959503031,0.040496969,0.003249219
Ohio,SENECA,59733,56574,1143,1676,3159,0.94711466,0.05288534,0.028058192
Ohio,SHELBY,44915,43673,613,185,1242,0.972347768,0.027652232,0.004118891
Ohio,STARK,367585,337210,24895,2755,30375,0.917366051,0.082633949,0.007494865
Ohio,SUMMIT,514990,444821,60846,3017,70169,0.863746869,0.136253131,0.005858366
Ohio,TRUMBULL,227813,209819,15136,1454,17994,0.921014165,0.078985835,0.006382428
Ohio,TUSCARAWAS,84090,82911,623,228,1179,0.985979308,0.014020692,0.002711381
Ohio,UNION,31969,30471,1149,159,1498,0.953142106,0.046857894,0.004973568
Ohio,VAN WERT,30464,29674,187,482,790,0.974067752,0.025932248,0.015821954
Ohio,VINTON,11098,11042,4,33,56,0.994954046,0.005045954,0.002973509
Ohio,WARREN,113909,110124,2385,524,3785,0.966771721,0.033228279,0.004600163
Ohio,WASHINGTON,62254,60931,773,225,1323,0.978748354,0.021251646,0.003614226
Ohio,WAYNE,101461,98804,1547,429,2657,0.973812598,0.026187402,0.004228226
Ohio,WILLIAMS,36956,35934,20,826,1022,0.972345492,0.027654508,0.022350904
Ohio,WOOD,113269,107989,1149,2882,5280,0.953385304,0.046614696,0.025443855
Ohio,WYANDOT,22254,21985,19,162,269,0.987912285,0.012087715,0.00727959
Oklahoma,ADAIR,18421,10171,4,245,8250,0.552141578,0.447858422,0.013300038
Oklahoma,ALFALFA,6416,5941,202,102,475,0.925966334,0.074033666,0.015897756
Oklahoma,ATOKA,12778,10325,751,118,2453,0.808029426,0.191970574,0.009234622
Oklahoma,BEAVER,6023,5653,1,300,370,0.93856882,0.06143118,0.049809065
Oklahoma,BECKHAM,18812,17270,375,788,1542,0.918031044,0.081968956,0.041888156
Oklahoma,BLAINE,11470,9697,483,287,1773,0.845422842,0.154577158,0.025021796
Oklahoma,BRYAN,32089,26540,422,465,5549,0.827074698,0.172925302,0.014490947
Oklahoma,CADDO,29550,21031,738,1430,8519,0.711708968,0.288291032,0.048392555
Oklahoma,CANADIAN,74409,66469,1766,1921,7940,0.893292478,0.106707522,0.025816769
Oklahoma,CARTER,42919,34865,3544,781,8054,0.812344183,0.187655817,0.018197069
Oklahoma,CHEROKEE,34049,21900,377,470,12149,0.643190696,0.356809304,0.013803636
Oklahoma,CHOCTAW,15302,10837,1954,195,4465,0.708208077,0.291791923,0.012743432
Oklahoma,CIMARRON,3301,2851,0,412,450,0.863677673,0.136322327,0.124810663
Oklahoma,CLEVELAND,174253,151661,5203,4655,22592,0.870349434,0.129650566,0.026714031
Oklahoma,COAL,5780,4746,48,39,1034,0.821107266,0.178892734,0.006747405
Oklahoma,COMANCHE,111486,77187,19547,6923,34299,0.692347021,0.307652979,0.062097483
Oklahoma,COTTON,6651,5771,140,231,880,0.867689069,0.132310931,0.034731619
Oklahoma,CRAIG,14104,10819,470,101,3285,0.767087351,0.232912649,0.007161089
Oklahoma,CREEK,60915,53134,1911,660,7781,0.872264631,0.127735369,0.01083477
Oklahoma,CUSTER,26897,22585,928,1625,4312,0.839684723,0.160315277,0.06041566
Oklahoma,DELAWARE,28070,20743,20,227,7327,0.738973994,0.261026006,0.008086926
Oklahoma,DEWEY,5551,5160,5,73,391,0.929562241,0.070437759,0.013150784
Oklahoma,ELLIS,4497,4281,2,138,216,0.951967979,0.048032021,0.030687125
Oklahoma,GARFIELD,56735,51906,2002,1086,4829,0.914884992,0.085115008,0.019141623
Oklahoma,GARVIN,26605,23629,721,331,2976,0.888141327,0.111858673,0.01244127
Oklahoma,GRADY,41747,37286,1524,728,4461,0.893142022,0.106857978,0.017438379
Oklahoma,GRANT,5689,5542,3,58,147,0.974160661,0.025839339,0.010195113
Oklahoma,GREER,6559,5611,450,336,948,0.855465772,0.144534228,0.051227321
Oklahoma,HARMON,3793,2818,280,656,975,0.742947535,0.257052465,0.172950171
Oklahoma,HARPER,4063,3952,3,72,111,0.972680286,0.027319714,0.017720896
Oklahoma,HASKELL,10940,9177,98,74,1763,0.838848263,0.161151737,0.006764168
Oklahoma,HUGHES,13023,10283,381,136,2740,0.78960301,0.21039699,0.010443062
Oklahoma,JACKSON,28764,21925,2641,3325,6839,0.762237519,0.237762481,0.115595884
Oklahoma,JEFFERSON,7010,6306,40,310,704,0.89957204,0.10042796,0.044222539
Oklahoma,JOHNSTON,10032,8126,213,120,1906,0.810007974,0.189992026,0.011961722
Oklahoma,KAY,48056,42552,854,851,5504,0.885466955,0.114533045,0.017708507
Oklahoma,KINGFISHER,13212,12132,304,407,1080,0.918256131,0.081743869,0.030805328
Oklahoma,KIOWA,11347,9365,609,604,1982,0.825328281,0.174671719,0.053229929
Oklahoma,LATIMER,10333,8488,150,115,1845,0.821445853,0.178554147,0.011129391
Oklahoma,LE FLORE,43270,36674,1025,419,6596,0.847561821,0.152438179,0.009683383
Oklahoma,LINCOLN,29216,26258,780,307,2958,0.898754107,0.101245893,0.010507941
Oklahoma,LOGAN,29011,23444,3974,556,5567,0.80810727,0.19189273,0.019165144
Oklahoma,LOVE,8157,6911,360,335,1246,0.847247763,0.152752237,0.04106902
Oklahoma,MCCLAIN,22795,20488,229,578,2307,0.898793595,0.101206405,0.025356438
Oklahoma,MCCURTAIN,33433,24659,3428,459,8774,0.737564682,0.262435318,0.01372895
Oklahoma,MCINTOSH,16779,12674,880,150,4105,0.755348948,0.244651052,0.008939746
Oklahoma,MAJOR,8055,7781,3,132,274,0.965983861,0.034016139,0.016387337
Oklahoma,MARSHALL,10829,9295,184,275,1534,0.858343337,0.141656663,0.025394773
Oklahoma,MAYES,33366,26952,68,308,6414,0.807768387,0.192231613,0.009230954
Oklahoma,MURRAY,12042,10337,203,169,1705,0.858412224,0.141587776,0.014034214
Oklahoma,MUSKOGEE,68078,48503,9495,873,19575,0.712462176,0.287537824,0.012823526
Oklahoma,NOBLE,11045,9783,199,126,1262,0.885740154,0.114259846,0.011407877
Oklahoma,NOWATA,9992,7934,359,73,2058,0.794035228,0.205964772,0.007305845
Oklahoma,OKFUSKEE,11551,7760,1325,140,3791,0.671803307,0.328196693,0.012120163
Oklahoma,OKLAHOMA,599611,451584,87597,25452,148027,0.753128278,0.246871722,0.04244752
Oklahoma,OKMULGEE,36490,27157,4413,458,9333,0.744231296,0.255768704,0.012551384
Oklahoma,OSAGE,41645,30703,4148,660,10942,0.737255373,0.262744627,0.015848241
Oklahoma,OTTAWA,30561,24378,188,375,6183,0.797683322,0.202316678,0.012270541
Oklahoma,PAWNEE,15575,13706,117,113,1869,0.88,0.12,0.007255217
Oklahoma,PAYNE,61507,54439,1759,917,7068,0.88508625,0.11491375,0.014908872
Oklahoma,PITTSBURG,40581,33552,1498,479,7029,0.826790863,0.173209137,0.011803553
Oklahoma,PONTOTOC,34119,28064,855,411,6055,0.8225329,0.1774671,0.012046074
Oklahoma,POTTAWATOMIE,58760,49481,1313,990,9279,0.842086453,0.157913547,0.016848196
Oklahoma,PUSHMATAHA,10997,9094,112,136,1903,0.826952805,0.173047195,0.012367009
Oklahoma,ROGER MILLS,4147,3909,2,73,238,0.942609115,0.057390885,0.017603087
Oklahoma,ROGERS,55170,46870,442,618,8300,0.849555918,0.150444082,0.01120174
Oklahoma,SEMINOLE,25412,18885,1913,340,6527,0.743152841,0.256847159,0.013379506
Oklahoma,SEQUOYAH,33828,25720,782,299,8108,0.760316897,0.239683103,0.008838832
Oklahoma,STEPHENS,42299,38553,941,943,3746,0.911439987,0.088560013,0.022293671
Oklahoma,TEXAS,16419,14511,69,1634,1908,0.883793166,0.116206834,0.09951885
Oklahoma,TILLMAN,10384,7541,1018,1461,2843,0.726213405,0.273786595,0.140697227
Oklahoma,TULSA,503341,411379,49173,11958,91962,0.817296823,0.182703177,0.023757254
Oklahoma,WAGONER,47883,40739,1977,638,7144,0.850802999,0.149197001,0.013324144
Oklahoma,WASHINGTON,48066,41870,1268,788,6196,0.871093913,0.128906087,0.016394125
Oklahoma,WASHITA,11441,10752,20,406,689,0.939777991,0.060222009,0.035486409
Oklahoma,WOODS,9103,8759,49,141,344,0.96221026,0.03778974,0.015489399
Oklahoma,WOODWARD,18976,17754,132,575,1222,0.935602867,0.064397133,0.030301433
Oregon,BAKER,15317,14829,29,276,488,0.968139975,0.031860025,0.018019194
Oregon,BENTON,70811,64103,580,1735,6708,0.905268955,0.094731045,0.024501843
Oregon,CLACKAMAS,278850,263965,1107,7129,14885,0.946620047,0.053379953,0.025565716
Oregon,CLATSOP,33301,31756,99,648,1545,0.953604997,0.046395003,0.019458875
Oregon,COLUMBIA,37557,36067,37,684,1490,0.96032697,0.03967303,0.018212317
Oregon,COOS,60273,56879,133,1353,3394,0.943689546,0.056310454,0.022447862
Oregon,CROOK,14111,13455,11,388,656,0.953511445,0.046488555,0.027496279
Oregon,CURRY,19327,18367,31,354,960,0.950328556,0.049671444,0.018316345
Oregon,DESCHUTES,74958,72303,78,1526,2655,0.964580165,0.035419835,0.020358067
Oregon,DOUGLAS,94649,90196,140,2225,4453,0.952952488,0.047047512,0.023507908
Oregon,GILLIAM,1717,1668,0,30,49,0.971461852,0.028538148,0.017472335
Oregon,GRANT,7853,7595,6,152,258,0.967146314,0.032853686,0.01935566
Oregon,HARNEY,7060,6544,2,221,516,0.926912181,0.073087819,0.031303116
Oregon,HOOD RIVER,16903,13628,36,2752,3275,0.806247412,0.193752588,0.162811335
Oregon,JACKSON,146389,136957,319,5949,9432,0.935568929,0.064431071,0.040638299
Oregon,JEFFERSON,13676,9590,20,1448,4086,0.701228429,0.298771571,0.105878912
Oregon,JOSEPHINE,62649,59521,123,1749,3128,0.950071031,0.049928969,0.027917445
Oregon,KLAMATH,57702,51704,352,2984,5998,0.89605213,0.10394787,0.051713979
Oregon,LAKE,7186,6689,5,270,497,0.93083774,0.06916226,0.037573059
Oregon,LANE,282912,265391,2040,6852,17521,0.938069082,0.061930918,0.024219545
Oregon,LINCOLN,38889,36962,63,598,1927,0.950448713,0.049551287,0.015377099
Oregon,LINN,91227,87081,171,2177,4146,0.954552928,0.045447072,0.023863549
Oregon,MALHEUR,26038,19839,63,5155,6199,0.761924879,0.238075121,0.197979876
Oregon,MARION,228483,201218,2039,18225,27265,0.880669459,0.119330541,0.079765234
Oregon,MORROW,7625,6688,8,825,937,0.877114754,0.122885246,0.108196721
Oregon,MULTNOMAH,583887,497700,34415,18390,86187,0.852390959,0.147609041,0.03149582
Oregon,POLK,49541,45145,192,2802,4396,0.911265417,0.088734583,0.056559214
Oregon,SHERMAN,1918,1853,0,28,65,0.966110532,0.033889468,0.01459854
Oregon,TILLAMOOK,21570,20765,38,374,805,0.962679648,0.037320352,0.017338897
Oregon,UMATILLA,59249,51303,350,5307,7946,0.865888032,0.134111968,0.089571132
Oregon,UNION,23598,22612,99,381,986,0.958216798,0.041783202,0.016145436
Oregon,WALLOWA,6911,6738,6,113,173,0.974967443,0.025032557,0.016350745
Oregon,WASCO,21683,19474,59,1065,2209,0.898122953,0.101877047,0.04911682
Oregon,WASHINGTON,311554,280239,1986,14401,31315,0.899487729,0.100512271,0.046223127
Oregon,WHEELER,1396,1370,1,12,26,0.981375358,0.018624642,0.008595989
Oregon,YAMHILL,65551,59538,344,4129,6013,0.908269897,0.091730103,0.062989123
Pennsylvania,ADAMS,78274,75735,861,1216,2539,0.967562664,0.032437336,0.015535171
Pennsylvania,ALLEGHENY,1336449,1163292,148599,8731,173157,0.870435011,0.129564989,0.006532984
Pennsylvania,ARMSTRONG,73478,72585,564,164,893,0.987846702,0.012153298,0.002231961
Pennsylvania,BEAVER,186093,173870,10411,1124,12223,0.934317787,0.065682213,0.006039991
Pennsylvania,BEDFORD,47919,47526,146,118,393,0.99179866,0.00820134,0.002462489
Pennsylvania,BERKS,336523,307387,9214,17174,29136,0.913420479,0.086579521,0.051033659
Pennsylvania,BLAIR,130542,128525,1056,431,2017,0.984549034,0.015450966,0.003301619
Pennsylvania,BRADFORD,60967,60253,148,218,714,0.988288746,0.011711254,0.003575705
Pennsylvania,BUCKS,541174,508282,14928,8895,32892,0.939221027,0.060778973,0.016436488
Pennsylvania,BUTLER,152013,149954,806,563,2059,0.986455106,0.013544894,0.003703631
Pennsylvania,CAMBRIA,163029,157800,3682,985,5229,0.967925952,0.032074048,0.00604187
Pennsylvania,CAMERON,5913,5878,7,3,35,0.994080839,0.005919161,0.000507357
Pennsylvania,CARBON,56846,55991,113,509,855,0.984959364,0.015040636,0.008954016
Pennsylvania,CENTRE,123786,115655,2726,1350,8131,0.934314058,0.065685942,0.010905918
Pennsylvania,CHESTER,376396,339637,23479,8565,36759,0.902339557,0.097660443,0.02275529
Pennsylvania,CLARION,41699,41107,197,116,592,0.985803017,0.014196983,0.002781841
Pennsylvania,CLEARFIELD,78097,77448,175,200,649,0.991689822,0.008310178,0.002560918
Pennsylvania,CLINTON,37182,36782,143,91,400,0.989242106,0.010757894,0.002447421
Pennsylvania,COLUMBIA,63202,62317,265,341,885,0.985997279,0.014002721,0.005395399
Pennsylvania,CRAWFORD,86169,84381,1058,303,1788,0.979250078,0.020749922,0.003516346
Pennsylvania,CUMBERLAND,195257,188129,2979,1355,7128,0.963494267,0.036505733,0.006939572
Pennsylvania,DAUPHIN,237813,193697,34843,6024,44116,0.8144929,0.1855071,0.025330827
Pennsylvania,DELAWARE,547651,470258,60688,5998,77393,0.858681898,0.141318102,0.010952231
Pennsylvania,ELK,34878,34677,15,56,201,0.994237055,0.005762945,0.001605597
Pennsylvania,ERIE,275572,256177,14008,3364,19395,0.92961912,0.07038088,0.012207336
Pennsylvania,FAYETTE,145351,139398,5083,452,5953,0.959043969,0.040956031,0.003109714
Pennsylvania,FOREST,4802,4722,43,23,80,0.983340275,0.016659725,0.004789671
Pennsylvania,FRANKLIN,121082,116506,2699,1065,4576,0.96220743,0.03779257,0.008795692
Pennsylvania,FULTON,13837,13642,124,31,195,0.98590735,0.01409265,0.00224037
Pennsylvania,GREENE,39550,38789,365,209,761,0.980758534,0.019241466,0.00528445
Pennsylvania,HUNTINGDON,44164,41874,1951,195,2290,0.948147813,0.051852187,0.004415361
Pennsylvania,INDIANA,89994,87768,1168,370,2226,0.975265018,0.024734982,0.004111385
Pennsylvania,JEFFERSON,46083,45815,49,98,268,0.994184406,0.005815594,0.002126598
Pennsylvania,JUNIATA,20625,20487,26,49,138,0.993309091,0.006690909,0.002375758
Pennsylvania,LACKAWANNA,219039,214817,1537,1089,4222,0.980724894,0.019275106,0.004971717
Pennsylvania,LANCASTER,422822,392898,9147,15639,29924,0.929227902,0.070772098,0.036987196
Pennsylvania,LAWRENCE,96246,92645,2894,357,3601,0.962585458,0.037414542,0.003709245
Pennsylvania,LEBANON,113744,109486,615,2666,4258,0.962565058,0.037434942,0.023438599
Pennsylvania,LEHIGH,291130,265946,6107,15001,25184,0.913495689,0.086504311,0.051526809
Pennsylvania,LUZERNE,328149,320571,3795,2023,7578,0.976906832,0.023093168,0.006164882
Pennsylvania,LYCOMING,118710,114593,2779,641,4117,0.965318844,0.034681156,0.005399714
Pennsylvania,MC KEAN,47131,45888,460,511,1243,0.9736267,0.0263733,0.010842121
Pennsylvania,MERCER,121003,114086,5858,506,6917,0.942836128,0.057163872,0.004181715
Pennsylvania,MIFFLIN,46197,45840,97,132,357,0.992272225,0.007727775,0.002857328
Pennsylvania,MONROE,95709,91171,1662,2052,4538,0.952585441,0.047414559,0.02143999
Pennsylvania,MONTGOMERY,678111,614659,38303,8357,63452,0.906428299,0.093571701,0.012323941
Pennsylvania,MONTOUR,17735,17397,76,116,338,0.980941641,0.019058359,0.006540739
Pennsylvania,NORTHAMPTON,247105,227521,4968,11591,19584,0.920746241,0.079253759,0.046907185
Pennsylvania,NORTHUMBERLAND,96771,95659,311,532,1112,0.988508954,0.011491046,0.005497515
Pennsylvania,PERRY,41172,40758,95,194,414,0.989944623,0.010055377,0.00471194
Pennsylvania,PHILADELPHIA,1585577,825839,623510,89193,759738,0.520844462,0.479155538,0.056252708
Pennsylvania,PIKE,27966,26890,246,651,1076,0.961524709,0.038475291,0.023278266
Pennsylvania,POTTER,16717,16573,20,72,144,0.991386014,0.008613986,0.004306993
Pennsylvania,SCHUYLKILL,152585,150486,805,677,2099,0.986243733,0.013756267,0.004436871
Pennsylvania,SNYDER,36680,36260,143,148,420,0.988549618,0.011450382,0.004034896
Pennsylvania,SOMERSET,78218,77701,101,231,517,0.993390268,0.006609732,0.002953284
Pennsylvania,SULLIVAN,6104,5985,56,25,119,0.980504587,0.019495413,0.004095675
Pennsylvania,SUSQUEHANNA,40380,39961,79,162,419,0.989623576,0.010376424,0.004011887
Pennsylvania,TIOGA,41126,40553,212,139,573,0.986067208,0.013932792,0.003379857
Pennsylvania,UNION,36176,34376,858,638,1800,0.950243255,0.049756745,0.017636002
Pennsylvania,VENANGO,59381,58488,484,201,893,0.98496152,0.01503848,0.003384921
Pennsylvania,WARREN,45050,44687,53,116,363,0.991942286,0.008057714,0.002574917
Pennsylvania,WASHINGTON,204584,195820,6754,1186,8764,0.95716185,0.04283815,0.00579713
Pennsylvania,WAYNE,39944,39153,276,371,791,0.980197276,0.019802724,0.009288003
Pennsylvania,WESTMORELAND,370321,360067,6848,1359,10254,0.972310509,0.027689491,0.003669789
Pennsylvania,WYOMING,28076,27691,133,135,385,0.98628722,0.01371278,0.004808377
Pennsylvania,YORK,339574,321249,10558,5165,18325,0.946035327,0.053964673,0.015210234
Rhode Island,BRISTOL,48859,47640,178,672,1219,0.975050656,0.024949344,0.013753863
Rhode Island,KENT,161135,156759,1010,1737,4376,0.972842647,0.027157353,0.010779781
Rhode Island,NEWPORT,87194,80700,3272,1712,6494,0.925522398,0.074477602,0.019634379
Rhode Island,PROVIDENCE,596270,505558,28793,40569,90712,0.847867577,0.152132423,0.068037969
Rhode Island,WASHINGTON,110006,105452,1030,1062,4554,0.958602258,0.041397742,0.009654019
South Carolina,ABBEVILLE,23862,16195,7499,98,7667,0.678694158,0.321305842,0.004106948
South Carolina,AIKEN,120940,90130,29176,867,30810,0.745245576,0.254754424,0.007168844
South Carolina,ALLENDALE,11722,3598,7939,161,8124,0.306944207,0.693055793,0.013734858
South Carolina,ANDERSON,145196,120013,24097,559,25183,0.826558583,0.173441417,0.003849968
South Carolina,BAMBERG,16902,6428,10356,75,10474,0.380310022,0.619689978,0.004437345
South Carolina,BARNWELL,20293,11421,8677,146,8872,0.562804908,0.437195092,0.007194599
South Carolina,BEAUFORT,86425,58842,24415,2168,27583,0.680844663,0.319155337,0.025085334
South Carolina,BERKELEY,128776,92460,30909,2599,36316,0.71799093,0.28200907,0.020182332
South Carolina,CALHOUN,12753,6134,6565,39,6619,0.480984866,0.519015134,0.003058104
South Carolina,CHARLESTON,295039,185343,102522,3873,109696,0.628198306,0.371801694,0.013127078
South Carolina,CHEROKEE,44506,34873,9120,259,9633,0.783557273,0.216442727,0.00581944
South Carolina,CHESTER,32170,19154,12830,80,13016,0.59539944,0.40460056,0.002486789
South Carolina,CHESTERFIELD,38577,25505,12814,160,13072,0.661145242,0.338854758,0.004147549
South Carolina,CLARENDON,28450,12223,16021,144,16227,0.429630931,0.570369069,0.005061511
South Carolina,COLLETON,34377,18603,15395,176,15774,0.541146697,0.458853303,0.005119702
South Carolina,DARLINGTON,61851,36794,24707,211,25057,0.594881247,0.405118753,0.003411424
South Carolina,DILLON,29114,15844,12705,76,13270,0.544205537,0.455794463,0.002610428
South Carolina,DORCHESTER,83060,61684,19026,1040,21376,0.742643872,0.257356128,0.012521069
South Carolina,EDGEFIELD,18375,9756,8496,79,8619,0.530938776,0.469061224,0.00429932
South Carolina,FAIRFIELD,22295,9200,12948,105,13095,0.412648576,0.587351424,0.004709576
South Carolina,FLORENCE,114344,69252,44136,508,45092,0.60564612,0.39435388,0.004442734
South Carolina,GEORGETOWN,46302,26070,19925,187,20232,0.563042633,0.436957367,0.004038702
South Carolina,GREENVILLE,320167,257069,57485,3028,63098,0.8029216,0.1970784,0.009457564
South Carolina,GREENWOOD,59567,41108,17923,251,18459,0.690113654,0.309886346,0.004213743
South Carolina,HAMPTON,18191,8253,9844,71,9938,0.453685889,0.546314111,0.003903029
South Carolina,HORRY,144053,116284,25052,1259,27769,0.807230672,0.192769328,0.008739839
South Carolina,JASPER,15487,6496,8872,69,8991,0.41944857,0.58055143,0.00445535
South Carolina,KERSHAW,43599,30862,12315,245,12737,0.707860272,0.292139728,0.005619395
South Carolina,LANCASTER,54516,40394,13780,212,14122,0.740956783,0.259043217,0.003888767
South Carolina,LAURENS,58092,41369,16362,211,16723,0.712129037,0.287870963,0.00363217
South Carolina,LEE,18437,6839,11481,75,11598,0.370938873,0.629061127,0.004067907
South Carolina,LEXINGTON,167611,146535,18427,1302,21076,0.874256463,0.125743537,0.007767987
South Carolina,MCCORMICK,8868,3640,5180,26,5228,0.410464592,0.589535408,0.00293189
South Carolina,MARION,33899,15095,18479,110,18804,0.445293371,0.554706629,0.003244933
South Carolina,MARLBORO,29361,14287,14222,79,15074,0.486597868,0.513402132,0.002690644
South Carolina,NEWBERRY,33172,21426,11470,147,11746,0.645906186,0.354093814,0.004431448
South Carolina,OCONEE,57494,51683,5029,528,5811,0.898928584,0.101071416,0.009183567
South Carolina,ORANGEBURG,84803,34830,49109,331,49973,0.410716602,0.589283398,0.003903164
South Carolina,PICKENS,93894,85617,6780,571,8277,0.911847402,0.088152598,0.006081326
South Carolina,RICHLAND,285720,157969,118652,4647,127751,0.552880442,0.447119558,0.016264175
South Carolina,SALUDA,16357,10842,5406,86,5515,0.662835483,0.337164517,0.005257688
South Carolina,SPARTANBURG,226800,176556,46750,1521,50244,0.778465608,0.221534392,0.006706349
South Carolina,SUMTER,102637,56130,44139,1239,46507,0.546878806,0.453121194,0.01207167
South Carolina,UNION,30337,21149,9059,69,9188,0.697135511,0.302864489,0.00227445
South Carolina,WILLIAMSBURG,36815,13082,23560,129,23733,0.355344289,0.644655711,0.003504007
South Carolina,YORK,131497,103019,26293,735,28478,0.783432322,0.216567678,0.005589481
South Dakota,AURORA,3135,3085,0,7,50,0.984051037,0.015948963,0.002232855
South Dakota,BEADLE,18253,17898,66,76,355,0.980551142,0.019448858,0.004163699
South Dakota,BENNETT,3206,1698,8,35,1508,0.52963194,0.47036806,0.010917031
South Dakota,BON HOMME,7089,6874,22,34,215,0.969671322,0.030328678,0.004796163
South Dakota,BROOKINGS,25207,24600,73,76,607,0.975919387,0.024080613,0.003015036
South Dakota,BROWN,35580,34307,44,111,1273,0.964221473,0.035778527,0.00311973
South Dakota,BRULE,5485,5059,6,31,426,0.922333637,0.077666363,0.005651778
South Dakota,BUFFALO,1759,393,0,3,1366,0.223422399,0.776577601,0.001705514
South Dakota,BUTTE,7914,7548,21,219,366,0.953752843,0.046247157,0.027672479
South Dakota,CAMPBELL,1965,1960,2,0,5,0.997455471,0.002544529,0
South Dakota,CHARLES MIX,9131,7106,4,34,2025,0.778228014,0.221771986,0.003723579
South Dakota,CLARK,4403,4368,6,13,35,0.992050874,0.007949126,0.002952532
South Dakota,CLAY,13186,12503,56,100,683,0.948202639,0.051797361,0.007583801
South Dakota,CODINGTON,22698,22298,16,55,400,0.982377302,0.017622698,0.002423121
South Dakota,CORSON,4195,2143,1,47,2052,0.510846246,0.489153754,0.011203814
South Dakota,CUSTER,6179,5962,9,45,217,0.964881049,0.035118951,0.007282732
South Dakota,DAVISON,17503,17143,22,38,360,0.979432097,0.020567903,0.002171056
South Dakota,DAY,6978,6496,1,11,482,0.930925767,0.069074233,0.001576383
South Dakota,DEUEL,4522,4487,1,14,35,0.992260062,0.007739938,0.003095975
South Dakota,DEWEY,5523,1815,11,46,3708,0.328625747,0.671374253,0.008328807
South Dakota,DOUGLAS,3746,3720,0,2,26,0.993059263,0.006940737,0.000533903
South Dakota,EDMUNDS,4356,4327,1,5,29,0.993342516,0.006657484,0.001147842
South Dakota,FALL RIVER,7353,6731,27,120,622,0.915408677,0.084591323,0.016319869
South Dakota,FAULK,2744,2734,0,3,10,0.996355685,0.003644315,0.001093294
South Dakota,GRANT,8372,8308,3,11,64,0.992355471,0.007644529,0.001313903
South Dakota,GREGORY,5359,5044,1,27,315,0.941220377,0.058779623,0.005038253
South Dakota,HAAKON,2624,2561,4,11,63,0.975990854,0.024009146,0.004192073
South Dakota,HAMLIN,4974,4940,4,13,34,0.993164455,0.006835545,0.002613591
South Dakota,HAND,4272,4242,3,11,30,0.992977528,0.007022472,0.002574906
South Dakota,HANSON,2994,2985,0,2,9,0.996993988,0.003006012,0.000668003
South Dakota,HARDING,1669,1644,5,3,25,0.985020971,0.014979029,0.001797484
South Dakota,HUGHES,14817,13687,18,112,1130,0.923736249,0.076263751,0.007558885
South Dakota,HUTCHINSON,8262,8216,1,14,46,0.994432341,0.005567659,0.001694505
South Dakota,HYDE,1696,1630,1,7,66,0.961084906,0.038915094,0.004127358
South Dakota,JACKSON,2811,1607,3,14,1204,0.571682675,0.428317325,0.004980434
South Dakota,JERAULD,2425,2412,0,1,13,0.994639175,0.005360825,0.000412371
South Dakota,JONES,1324,1315,0,1,9,0.993202417,0.006797583,0.000755287
South Dakota,KINGSBURY,5925,5902,0,5,23,0.996118143,0.003881857,0.000843882
South Dakota,LAKE,10550,10449,12,27,101,0.99042654,0.00957346,0.002559242
South Dakota,LAWRENCE,20655,19726,29,327,929,0.955022997,0.044977003,0.015831518
South Dakota,LINCOLN,15427,15282,21,23,145,0.990600895,0.009399105,0.001490893
South Dakota,LYMAN,3638,2575,3,18,1063,0.707806487,0.292193513,0.004947774
South Dakota,MCCOOK,5688,5646,0,8,42,0.992616034,0.007383966,0.00140647
South Dakota,MCPHERSON,3228,3223,1,0,5,0.998451053,0.001548947,0
South Dakota,MARSHALL,4844,4563,1,13,281,0.941990091,0.058009909,0.002683732
South Dakota,MEADE,21878,20437,508,387,1441,0.934134747,0.065865253,0.017689003
South Dakota,MELLETTE,2137,1126,1,15,1011,0.526906879,0.473093121,0.007019186
South Dakota,MINER,3272,3261,0,6,11,0.996638142,0.003361858,0.001833741
South Dakota,MINNEHAHA,123809,120047,739,648,3762,0.969614487,0.030385513,0.005233868
South Dakota,MOODY,6507,5945,10,13,562,0.913631474,0.086368526,0.001997848
South Dakota,PENNINGTON,81343,71882,1249,1777,9461,0.883690053,0.116309947,0.021845764
South Dakota,PERKINS,3932,3851,6,17,81,0.979399797,0.020600203,0.004323499
South Dakota,POTTER,3190,3157,0,5,33,0.989655172,0.010344828,0.001567398
South Dakota,ROBERTS,9914,7609,0,28,2305,0.767500504,0.232499496,0.002824289
South Dakota,SANBORN,2833,2815,0,15,18,0.993646311,0.006353689,0.005294741
South Dakota,SHANNON,9902,492,4,179,9410,0.049686932,0.950313068,0.018077156
South Dakota,SPINK,7981,7898,2,15,83,0.989600301,0.010399699,0.001879464
South Dakota,STANLEY,2453,2287,1,10,166,0.932327762,0.067672238,0.004076641
South Dakota,SULLY,1589,1569,1,3,20,0.987413468,0.012586532,0.00188798
South Dakota,TODD,8352,1424,10,123,6928,0.170498084,0.829501916,0.014727011
South Dakota,TRIPP,6924,6238,0,9,686,0.900924321,0.099075679,0.001299827
South Dakota,TURNER,8576,8524,4,18,52,0.993936567,0.006063433,0.002098881
South Dakota,UNION,10189,10047,20,67,142,0.986063402,0.013936598,0.006575719
South Dakota,WALWORTH,6087,5589,1,26,498,0.918186299,0.081813701,0.004271398
South Dakota,YANKTON,19252,18589,110,89,663,0.96556202,0.03443798,0.004622896
South Dakota,ZIEBACH,2220,789,3,29,1431,0.355405405,0.644594595,0.013063063
Tennessee,ANDERSON,68250,64320,2753,381,3930,0.942417582,0.057582418,0.005582418
Tennessee,BEDFORD,30411,27005,3056,172,3406,0.888001052,0.111998948,0.005655848
Tennessee,BENTON,14524,14050,345,72,474,0.967364362,0.032635638,0.004957312
Tennessee,BLEDSOE,9669,9213,373,38,456,0.95283897,0.04716103,0.003930086
Tennessee,BLOUNT,85969,82207,2780,368,3762,0.95624004,0.04375996,0.004280613
Tennessee,BRADLEY,73712,69704,2871,712,4008,0.945626221,0.054373779,0.009659214
Tennessee,CAMPBELL,35079,34621,130,117,458,0.986943756,0.013056244,0.003335329
Tennessee,CANNON,10467,10215,184,39,252,0.975924334,0.024075666,0.003725996
Tennessee,CARROLL,27514,24214,3129,125,3300,0.88006106,0.11993894,0.004543142
Tennessee,CARTER,51505,50637,455,191,868,0.983147267,0.016852733,0.003708378
Tennessee,CHEATHAM,27140,26344,532,139,796,0.970670597,0.029329403,0.005121592
Tennessee,CHESTER,12819,11334,1386,53,1485,0.88415633,0.11584367,0.004134488
Tennessee,CLAIBORNE,26137,25641,248,83,496,0.981023071,0.018976929,0.003175575
Tennessee,CLAY,7238,7083,116,27,155,0.978585245,0.021414755,0.003730312
Tennessee,COCKE,29141,28278,612,144,863,0.970385368,0.029614632,0.004941491
Tennessee,COFFEE,40339,38257,1492,261,2082,0.948387417,0.051612583,0.006470165
Tennessee,CROCKETT,13378,11064,2250,49,2314,0.827029451,0.172970549,0.00366273
Tennessee,CUMBERLAND,34736,34384,42,124,352,0.989866421,0.010133579,0.003569784
Tennessee,DAVIDSON,510784,378925,118813,4775,131859,0.741849784,0.258150216,0.009348374
Tennessee,DECATUR,10472,9961,417,49,511,0.951203209,0.048796791,0.004679144
Tennessee,DEKALB,14360,14049,215,62,311,0.978342618,0.021657382,0.004317549
Tennessee,DICKSON,35061,33008,1741,177,2053,0.94144491,0.05855509,0.005048344
Tennessee,DYER,34854,30455,4138,137,4399,0.873787801,0.126212199,0.003930682
Tennessee,FAYETTE,25559,14157,11224,130,11402,0.55389491,0.44610509,0.005086271
Tennessee,FENTRESS,14669,14600,2,39,69,0.995296203,0.004703797,0.002658668
Tennessee,FRANKLIN,34725,32292,2086,187,2433,0.929935205,0.070064795,0.005385169
Tennessee,GIBSON,46315,37116,8919,181,9199,0.801381842,0.198618158,0.003908021
Tennessee,GILES,25741,22119,3397,109,3622,0.859290626,0.140709374,0.00423449
Tennessee,GRAINGER,17095,16902,102,41,193,0.988710149,0.011289851,0.002398362
Tennessee,GREENE,55853,54323,1202,163,1530,0.972606664,0.027393336,0.002918375
Tennessee,GRUNDY,13362,13243,18,68,119,0.991094148,0.008905852,0.005089059
Tennessee,HAMBLEN,50480,47770,2313,175,2710,0.946315372,0.053684628,0.003466719
Tennessee,HAMILTON,285536,226239,54303,1946,59297,0.792330914,0.207669086,0.006815253
Tennessee,HANCOCK,6739,6564,119,35,175,0.974031755,0.025968245,0.005193649
Tennessee,HARDEMAN,23377,14399,8724,175,8978,0.615947299,0.384052701,0.007485991
Tennessee,HARDIN,22633,21487,987,87,1146,0.94936597,0.05063403,0.003843945
Tennessee,HAWKINS,44565,43552,740,134,1013,0.977269157,0.022730843,0.003006844
Tennessee,HAYWOOD,19437,9621,9620,156,9816,0.494983794,0.505016206,0.00802593
Tennessee,HENDERSON,21844,19908,1799,100,1936,0.911371544,0.088628456,0.004577916
Tennessee,HENRY,27888,24862,2812,110,3026,0.89149455,0.10850545,0.003944349
Tennessee,HICKMAN,16754,15781,858,67,973,0.941924317,0.058075683,0.003999045
Tennessee,HOUSTON,7018,6701,264,41,317,0.954830436,0.045169564,0.00584212
Tennessee,HUMPHREYS,15795,15123,550,63,672,0.957454891,0.042545109,0.003988604
Tennessee,JACKSON,9297,9212,7,38,85,0.990857266,0.009142734,0.00408734
Tennessee,JEFFERSON,33016,31862,926,100,1154,0.96504725,0.03495275,0.003028835
Tennessee,JOHNSON,13766,13644,61,32,122,0.991137585,0.008862415,0.002324568
Tennessee,KNOX,335749,300040,29483,2067,35709,0.893643764,0.106356236,0.006156385
Tennessee,LAKE,7129,5408,1688,27,1721,0.758591668,0.241408332,0.003787347
Tennessee,LAUDERDALE,23491,15914,7250,178,7577,0.677450939,0.322549061,0.00757737
Tennessee,LAWRENCE,35303,34545,482,145,758,0.978528737,0.021471263,0.0041073
Tennessee,LEWIS,9247,9035,119,54,212,0.977073646,0.022926354,0.005839732
Tennessee,LINCOLN,28157,25499,2414,137,2658,0.905600739,0.094399261,0.004865575
Tennessee,LOUDON,31255,30668,400,83,587,0.981219005,0.018780995,0.002655575
Tennessee,MCMINN,42383,39949,2041,174,2434,0.942571314,0.057428686,0.00410542
Tennessee,MCNAIRY,22422,20836,1430,95,1586,0.9292659,0.0707341,0.00423691
Tennessee,MACON,15906,15778,44,39,128,0.991952722,0.008047278,0.002451905
Tennessee,MADISON,77982,53219,24065,376,24763,0.682452361,0.317547639,0.004821626
Tennessee,MARION,24860,23678,1029,85,1182,0.952453741,0.047546259,0.003419147
Tennessee,MARSHALL,21539,19462,1906,92,2077,0.903570268,0.096429732,0.004271322
Tennessee,MAURY,54812,45662,8597,323,9150,0.833065752,0.166934248,0.00589287
Tennessee,MEIGS,8033,7868,118,17,165,0.979459729,0.020540271,0.00211627
Tennessee,MONROE,30541,29468,831,123,1073,0.9648669,0.0351331,0.004027373
Tennessee,MONTGOMERY,100498,77505,17580,3228,22993,0.771209377,0.228790623,0.032120042
Tennessee,MOORE,4721,4518,174,20,203,0.957000635,0.042999365,0.004236391
Tennessee,MORGAN,17300,16907,263,60,393,0.977283237,0.022716763,0.003468208
Tennessee,OBION,31717,28241,3238,138,3476,0.890405776,0.109594224,0.004350979
Tennessee,OVERTON,17636,17519,30,73,117,0.993365843,0.006634157,0.004139261
Tennessee,PERRY,6612,6442,119,36,170,0.974289171,0.025710829,0.005444646
Tennessee,PICKETT,4548,4529,0,13,19,0.995822339,0.004177661,0.002858399
Tennessee,POLK,13643,13540,0,36,103,0.992450341,0.007549659,0.002638716
Tennessee,PUTNAM,51373,49660,873,294,1713,0.966655636,0.033344364,0.005722851
Tennessee,RHEA,24344,23517,578,132,827,0.96602859,0.03397141,0.005422281
Tennessee,ROANE,47227,45274,1456,212,1953,0.958646537,0.041353463,0.004488958
Tennessee,ROBERTSON,41494,36672,4536,173,4822,0.883790428,0.116209572,0.004169277
Tennessee,RUTHERFORD,118570,105139,10602,926,13431,0.886725141,0.113274859,0.007809733
Tennessee,SCOTT,18358,18234,5,38,124,0.993245452,0.006754548,0.002069942
Tennessee,SEQUATCHIE,8863,8827,2,25,36,0.99593817,0.00406183,0.002820715
Tennessee,SEVIER,51043,50266,215,237,777,0.984777541,0.015222459,0.004643144
Tennessee,SHELBY,826330,451209,358827,7091,375121,0.546039718,0.453960282,0.008581317
Tennessee,SMITH,14143,13589,459,48,554,0.960828678,0.039171322,0.003393905
Tennessee,STEWART,9479,9252,96,48,227,0.976052326,0.023947674,0.005063825
Tennessee,SULLIVAN,143596,139678,2551,521,3918,0.972715117,0.027284883,0.003628235
Tennessee,SUMNER,103281,96630,5539,567,6651,0.93560287,0.06439713,0.005489877
Tennessee,TIPTON,37568,28280,8823,253,9288,0.752768313,0.247231687,0.006734455
Tennessee,TROUSDALE,5920,5016,851,31,904,0.847297297,0.152702703,0.005236486
Tennessee,UNICOI,16549,16421,3,97,128,0.992265394,0.007734606,0.005861381
Tennessee,UNION,13694,13624,3,38,70,0.994888272,0.005111728,0.002774938
Tennessee,VAN BUREN,4846,4815,5,10,31,0.993602972,0.006397028,0.002063558
Tennessee,WARREN,32992,31414,1125,276,1578,0.952170223,0.047829777,0.008365664
Tennessee,WASHINGTON,92315,88047,3268,471,4268,0.953766993,0.046233007,0.005102096
Tennessee,WAYNE,13935,13719,137,52,216,0.984499462,0.015500538,0.003731611
Tennessee,WEAKLEY,31972,29300,2214,128,2672,0.916426874,0.083573126,0.004003503
Tennessee,WHITE,20090,19587,378,74,503,0.974962668,0.025037332,0.003683425
Tennessee,WILLIAMSON,81021,74519,5378,522,6502,0.919749201,0.080250799,0.006442774
Tennessee,WILSON,67675,62266,4589,386,5409,0.920073883,0.079926117,0.005703731
Texas,ANDERSON,48024,32665,11091,3953,15359,0.680180743,0.319819257,0.08231301
Texas,ANDREWS,14338,9281,259,4552,5057,0.647300879,0.352699121,0.31747803
Texas,ANGELINA,69884,52777,10551,6072,17107,0.755208631,0.244791369,0.086886841
Texas,ARANSAS,17892,13306,301,3588,4586,0.743684328,0.256315672,0.200536553
Texas,ARCHER,7973,7733,11,189,240,0.969898407,0.030101593,0.023705004
Texas,ARMSTRONG,2021,1951,0,55,70,0.965363681,0.034636319,0.02721425
Texas,ATASCOSA,30533,14194,108,16064,16339,0.464874071,0.535125929,0.526119281
Texas,AUSTIN,19832,15125,2556,2073,4707,0.762656313,0.237343687,0.104528035
Texas,BAILEY,7064,4184,117,2740,2880,0.592298981,0.407701019,0.38788222
Texas,BANDERA,10562,9276,23,1172,1286,0.878242757,0.121757243,0.110963833
Texas,BASTROP,38263,26665,4351,6933,11598,0.696887332,0.303112668,0.18119332
Texas,BAYLOR,4385,3848,180,334,537,0.877537058,0.122462942,0.076168757
Texas,BEE,25135,11211,690,12909,13924,0.44603143,0.55396857,0.513586632
Texas,BELL,191088,124908,34977,24995,66180,0.65366742,0.34633258,0.130803609
Texas,BEXAR,1185394,496149,81356,589180,689245,0.418551975,0.581448025,0.497033054
Texas,BLANCO,5972,5038,56,840,934,0.843603483,0.156396517,0.140656397
Texas,BORDEN,799,669,0,120,130,0.837296621,0.162703379,0.150187735
Texas,BOSQUE,15125,13320,312,1430,1805,0.880661157,0.119338843,0.094545455
Texas,BOWIE,81665,61964,17697,1334,19701,0.758758342,0.241241658,0.016335027
Texas,BRAZORIA,191707,139683,15425,33797,52024,0.728627541,0.271372459,0.176295075
Texas,BRAZOS,121862,87139,13409,16713,34723,0.71506294,0.28493706,0.137146937
Texas,BREWSTER,8681,4833,77,3702,3848,0.556733095,0.443266905,0.426448566
Texas,BRISCOE,1971,1532,68,367,439,0.777270421,0.222729579,0.186199899
Texas,BROOKS,8204,824,2,7338,7380,0.10043881,0.89956119,0.894441736
Texas,BROWN,34371,28814,1530,3799,5557,0.838323005,0.161676995,0.110529225
Texas,BURLESON,13625,9543,2392,1624,4082,0.70040367,0.29959633,0.119192661
Texas,BURNET,22677,19814,255,2440,2863,0.873748732,0.126251268,0.107598007
Texas,CALDWELL,26392,13547,2675,9988,12845,0.513299485,0.486700515,0.378448015
Texas,CALHOUN,19053,11021,542,6893,8032,0.578439091,0.421560909,0.361780297
Texas,CALLAHAN,11859,11289,2,489,570,0.951935239,0.048064761,0.041234505
Texas,CAMERON,260120,45354,567,212995,214766,0.174357989,0.825642011,0.818833615
Texas,CAMP,9904,7015,2349,501,2889,0.708299677,0.291700323,0.050585622
Texas,CARSON,6576,6158,11,354,418,0.936435523,0.063564477,0.053832117
Texas,CASS,29982,23464,6020,373,6518,0.782602895,0.217397105,0.012440798
Texas,CASTRO,9070,4574,259,4187,4496,0.50429989,0.49570011,0.461631753
Texas,CHAMBERS,20088,16170,2540,1195,3918,0.804958184,0.195041816,0.059488252
Texas,CHEROKEE,41049,31201,6858,2697,9848,0.760091598,0.239908402,0.065701966
Texas,CHILDRESS,5953,4736,318,853,1217,0.795565261,0.204434739,0.143289098
Texas,CLAY,10024,9642,33,242,382,0.96189146,0.03810854,0.024142059
Texas,COCHRAN,4377,2275,230,1857,2102,0.519762394,0.480237606,0.424263194
Texas,COKE,3424,2977,4,422,447,0.869450935,0.130549065,0.123247664
Texas,COLEMAN,9710,8288,244,1139,1422,0.853553038,0.146446962,0.117301751
Texas,COLLIN,264036,226654,10727,18158,37382,0.858420821,0.141579179,0.068770925
Texas,COLLINGSWORTH,3573,2750,227,561,823,0.769661349,0.230338651,0.157010915
Texas,COLORADO,18383,12437,3060,2833,5946,0.676548985,0.323451015,0.154109775
Texas,COMAL,51832,39233,421,11864,12599,0.756926223,0.243073777,0.228893348
Texas,COMANCHE,13381,11109,10,2205,2272,0.83020701,0.16979299,0.16478589
Texas,CONCHO,3044,1827,14,1194,1217,0.600197109,0.399802891,0.392247043
Texas,COOKE,30777,27864,1151,1408,2913,0.905351399,0.094648601,0.045748449
Texas,CORYELL,64213,42681,13293,6243,21532,0.664678492,0.335321508,0.097223304
Texas,COTTLE,2247,1676,196,367,571,0.7458834,0.2541166,0.163328883
Texas,CRANE,4652,2920,128,1577,1732,0.627687016,0.372312984,0.338993981
Texas,CROCKETT,4078,2016,31,2021,2062,0.49435998,0.50564002,0.495586072
Texas,CROSBY,7304,3869,297,3111,3435,0.529709748,0.470290252,0.425930997
Texas,CULBERSON,3407,950,2,2419,2457,0.278837687,0.721162313,0.710008805
Texas,DALLAM,5461,4157,102,1151,1304,0.761215895,0.238784105,0.210767259
Texas,DALLAS,1852810,1115096,362130,315630,737714,0.601840448,0.398159552,0.17035206
Texas,DAWSON,14349,7569,608,6120,6780,0.527493205,0.472506795,0.426510558
Texas,DEAF SMITH,19153,9417,287,9356,9736,0.491672323,0.508327677,0.488487443
Texas,DELTA,4857,4344,400,67,513,0.894379246,0.105620754,0.013794523
Texas,DENTON,273525,232885,13314,19013,40640,0.851421259,0.148578741,0.069511014
Texas,DEWITT,18840,12265,1956,4567,6575,0.651008493,0.348991507,0.242409766
Texas,DICKENS,2571,1964,111,479,607,0.763905095,0.236094905,0.186308829
Texas,DIMMIT,10433,1655,50,8688,8778,0.158631266,0.841368734,0.83274226
Texas,DONLEY,3696,3415,127,139,281,0.923971861,0.076028139,0.037608225
Texas,DUVAL,12918,1601,8,11267,11317,0.123935594,0.876064406,0.872193838
Texas,EASTLAND,18488,16605,395,1404,1883,0.898150151,0.101849849,0.075941151
Texas,ECTOR,118934,74822,5391,37315,44112,0.629105218,0.370894782,0.313745439
Texas,EDWARDS,2266,1076,0,1182,1190,0.474845543,0.525154457,0.521624007
Texas,ELLIS,85167,64895,8407,11243,20272,0.761973534,0.238026466,0.132011225
Texas,EL PASO,591610,151313,20525,411619,440297,0.255764777,0.744235223,0.695760721
Texas,ERATH,27991,25123,192,2458,2868,0.897538495,0.102461505,0.08781394
Texas,FALLS,17712,10843,4732,2072,6869,0.61218383,0.38781617,0.116982836
Texas,FANNIN,24804,22466,1623,485,2338,0.90574101,0.09425899,0.019553298
Texas,FAYETTE,20095,16678,1662,1702,3417,0.829957701,0.170042299,0.084697686
Texas,FISHER,4842,3652,186,997,1190,0.754233788,0.245766212,0.20590665
Texas,FLOYD,8497,4759,313,3381,3738,0.560080028,0.439919972,0.397905143
Texas,FOARD,1794,1478,73,233,316,0.823857302,0.176142698,0.129877369
Texas,FORT BEND,225421,121245,45678,43892,104176,0.53786027,0.46213973,0.194711229
Texas,FRANKLIN,7802,7040,349,357,762,0.902332735,0.097667265,0.045757498
Texas,FREESTONE,15818,12124,2999,619,3694,0.76646858,0.23353142,0.039132634
Texas,FRIO,13472,3509,141,9749,9963,0.260466152,0.739533848,0.72364905
Texas,GAINES,14123,9096,324,4608,5027,0.644055796,0.355944204,0.326276287
Texas,GALVESTON,217399,144852,37414,30962,72547,0.666295613,0.333704387,0.142420158
Texas,GARZA,5143,3354,306,1454,1789,0.652148551,0.347851449,0.282714369
Texas,GILLESPIE,17204,14676,29,2426,2528,0.853057429,0.146942571,0.141013718
Texas,GLASSCOCK,1447,1018,0,424,429,0.703524534,0.296475466,0.293020041
Texas,GOLIAD,5980,3420,387,2145,2560,0.571906355,0.428093645,0.358695652
Texas,GONZALES,17205,9398,1581,6142,7807,0.546236559,0.453763441,0.356989247
Texas,GRAY,23967,20841,882,1895,3126,0.86957066,0.13042934,0.079067051
Texas,GRAYSON,95021,84271,6511,2795,10750,0.886867114,0.113132886,0.02941455
Texas,GREGG,104948,80358,19835,3775,24590,0.765693486,0.234306514,0.035970195
Texas,GRIMES,18828,11554,4552,2657,7274,0.613660506,0.386339494,0.141119609
Texas,GUADALUPE,64873,41454,3451,19246,23419,0.639002358,0.360997642,0.296671959
Texas,HALE,34671,18181,1766,14428,16490,0.524386375,0.475613625,0.41614029
Texas,HALL,3905,2850,301,727,1055,0.729833547,0.270166453,0.186171575
Texas,HAMILTON,7733,7284,2,403,449,0.941937152,0.058062848,0.052114315
Texas,HANSFORD,5848,4637,0,1174,1211,0.792920657,0.207079343,0.200752394
Texas,HARDEMAN,5283,4331,318,589,952,0.819799356,0.180200644,0.111489684
Texas,HARDIN,41320,37006,3459,679,4314,0.895595353,0.104404647,0.01643272
Texas,HARRIS,2818199,1528113,527964,644935,1290086,0.542230339,0.457769661,0.228846508
Texas,HARRISON,57483,39907,15960,1278,17576,0.694240036,0.305759964,0.02223266
Texas,HARTLEY,3634,3388,9,201,246,0.932305999,0.067694001,0.055310952
Texas,HASKELL,6820,5229,239,1312,1591,0.766715543,0.233284457,0.192375367
Texas,HAYS,65614,44661,2091,18249,20953,0.680662663,0.319337337,0.278126619
Texas,HEMPHILL,3720,3275,7,412,445,0.880376344,0.119623656,0.110752688
Texas,HENDERSON,58543,51135,4727,2368,7408,0.873460533,0.126539467,0.040448901
Texas,HIDALGO,383545,54259,518,326972,329286,0.141467103,0.858532897,0.852499707
Texas,HILL,27146,22310,2492,2230,4836,0.821852207,0.178147793,0.082148383
Texas,HOCKLEY,24199,15410,997,7654,8789,0.636803174,0.363196826,0.316294062
Texas,HOOD,28981,27251,52,1353,1730,0.940305718,0.059694282,0.04668576
Texas,HOPKINS,28833,24755,2469,1407,4078,0.858564839,0.141435161,0.048798252
Texas,HOUSTON,21375,14042,6272,965,7333,0.656935673,0.343064327,0.045146199
Texas,HOWARD,32343,22226,1174,8607,10117,0.687196611,0.312803389,0.266116316
Texas,HUDSPETH,2915,956,9,1935,1959,0.327958834,0.672041166,0.66380789
Texas,HUNT,64343,54118,6736,2876,10225,0.841086054,0.158913946,0.044697947
Texas,HUTCHINSON,25689,22098,661,2509,3591,0.860212542,0.139787458,0.097668263
Texas,IRION,1629,1240,2,385,389,0.761203192,0.238796808,0.236341314
Texas,JACK,6981,6668,51,232,313,0.955164017,0.044835983,0.033233061
Texas,JACKSON,13039,9047,1195,2772,3992,0.693841552,0.306158448,0.21259299
Texas,JASPER,31102,24529,5852,594,6573,0.788663108,0.211336892,0.01909845
Texas,JEFF DAVIS,1946,1154,6,770,792,0.593011305,0.406988695,0.395683453
Texas,JEFFERSON,239397,147333,73779,12629,92064,0.615433777,0.384566223,0.052753376
Texas,JIM HOGG,5109,424,3,4659,4685,0.082990801,0.917009199,0.911920141
Texas,JIM WELLS,37679,10092,191,27201,27587,0.267841503,0.732158497,0.721914064
Texas,JOHNSON,97165,86434,2449,7457,10731,0.889558998,0.110441002,0.076745742
Texas,JONES,16490,12970,651,2786,3520,0.786537295,0.213462705,0.168950879
Texas,KARNES,12455,6136,343,5916,6319,0.492653553,0.507346447,0.474989964
Texas,KAUFMAN,52220,41225,7233,3340,10995,0.789448487,0.210551513,0.063960169
Texas,KENDALL,14589,12052,49,2392,2537,0.826101858,0.173898142,0.163959147
Texas,KENEDY,460,93,0,362,367,0.202173913,0.797826087,0.786956522
Texas,KENT,1010,883,6,120,127,0.874257426,0.125742574,0.118811881
Texas,KERR,36304,29303,752,5994,7001,0.807156236,0.192843764,0.165105773
Texas,KIMBLE,4122,3330,2,772,792,0.807860262,0.192139738,0.187287724
Texas,KING,354,301,0,53,53,0.850282486,0.149717514,0.149717514
Texas,KINNEY,3119,1463,48,1570,1656,0.469060596,0.530939404,0.503366464
Texas,KLEBERG,30274,10279,955,18529,19995,0.339532272,0.660467728,0.612043338
Texas,KNOX,4837,3396,335,1088,1441,0.702088071,0.297911929,0.22493281
Texas,LAMAR,43949,36546,6369,475,7403,0.831554757,0.168445243,0.010807982
Texas,LAMB,15072,8700,794,5509,6372,0.577229299,0.422770701,0.365512208
Texas,LAMPASAS,13521,11321,241,1753,2200,0.837290141,0.162709859,0.129650174
Texas,LA SALLE,5254,1102,52,4068,4152,0.209744956,0.790255044,0.774267225
Texas,LAVACA,18690,15716,1316,1596,2974,0.840877475,0.159122525,0.085393258
Texas,LEE,12854,9650,1752,1410,3204,0.75073907,0.24926093,0.109693481
Texas,LEON,12665,10507,1601,509,2158,0.829609159,0.170390841,0.040189499
Texas,LIBERTY,52726,42699,6821,2880,10027,0.809828168,0.190171832,0.054622008
Texas,LIMESTONE,20946,15239,4127,1459,5707,0.727537477,0.272462523,0.069655304
Texas,LIPSCOMB,3143,2723,1,379,420,0.86636971,0.13363029,0.120585428
Texas,LIVE OAK,9556,6158,3,3324,3398,0.644411888,0.355588112,0.347844286
Texas,LLANO,11631,11098,22,453,533,0.95417419,0.04582581,0.03894764
Texas,LOVING,107,93,0,14,14,0.869158879,0.130841121,0.130841121
Texas,LUBBOCK,222636,151414,16646,51011,71222,0.68009666,0.31990334,0.229122873
Texas,LYNN,6758,3683,222,2819,3075,0.544983723,0.455016277,0.417135247
Texas,MCCULLOCH,8778,6289,151,2317,2489,0.716450216,0.283549784,0.263955343
Texas,MCLENNAN,189123,134507,29036,23643,54616,0.711214395,0.288785605,0.12501388
Texas,MCMULLEN,817,493,0,320,324,0.603427173,0.396572827,0.391676867
Texas,MADISON,10931,7127,2547,1178,3804,0.651998902,0.348001098,0.107766901
Texas,MARION,9984,6696,3093,147,3288,0.670673077,0.329326923,0.014723558
Texas,MARTIN,4956,2881,87,1960,2075,0.581315577,0.418684423,0.395480226
Texas,MASON,3423,2734,6,671,689,0.798714578,0.201285422,0.196026877
Texas,MATAGORDA,36928,21878,5030,9088,15050,0.592450173,0.407549827,0.24610052
Texas,MAVERICK,36378,1571,13,34024,34807,0.043185442,0.956814558,0.93529056
Texas,MEDINA,27312,14928,71,12134,12384,0.546572935,0.453427065,0.444273579
Texas,MENARD,2252,1511,7,726,741,0.670959147,0.329040853,0.322380107
Texas,MIDLAND,106611,74499,8016,22780,32112,0.698792807,0.301207193,0.213674011
Texas,MILAM,22946,16528,2884,3456,6418,0.720299834,0.279700166,0.150614486
Texas,MILLS,4531,4029,10,484,502,0.88920768,0.11079232,0.106819687
Texas,MITCHELL,8016,5241,362,2389,2775,0.653817365,0.346182635,0.298028942
Texas,MONTAGUE,17274,16632,4,548,642,0.962834317,0.037165683,0.031723978
Texas,MONTGOMERY,182201,159436,7659,13237,22765,0.87505557,0.12494443,0.072650534
Texas,MOORE,17865,11707,79,5693,6158,0.655303666,0.344696334,0.318667786
Texas,MORRIS,13200,9660,3220,239,3540,0.731818182,0.268181818,0.018106061
Texas,MOTLEY,1532,1319,68,136,213,0.860966057,0.139033943,0.088772846
Texas,NACOGDOCHES,54753,42575,8948,2788,12178,0.777582963,0.222417037,0.050919584
Texas,NAVARRO,39926,29120,7523,2891,10806,0.729349296,0.270650704,0.072408957
Texas,NEWTON,13569,10329,3027,153,3240,0.761220429,0.238779571,0.011275702
Texas,NOLAN,16594,11524,732,4246,5070,0.69446788,0.30553212,0.255875618
Texas,NUECES,291145,123716,11946,152051,167429,0.424929159,0.575070841,0.522251799
Texas,OCHILTREE,9128,7373,2,1641,1755,0.807734443,0.192265557,0.179776512
Texas,OLDHAM,2278,2020,9,200,258,0.886742757,0.113257243,0.087796313
Texas,ORANGE,80509,71142,6734,1933,9367,0.883652759,0.116347241,0.024009738
Texas,PALO PINTO,25055,21707,783,2301,3348,0.866373977,0.133626023,0.091837956
Texas,PANOLA,22035,17429,4042,477,4606,0.790968913,0.209031087,0.021647379
Texas,PARKER,64785,60950,570,2697,3835,0.940804199,0.059195801,0.041630007
Texas,PARMER,9863,5600,113,4096,4263,0.567778566,0.432221434,0.415289466
Texas,PECOS,14675,6209,51,8331,8466,0.423100511,0.576899489,0.56770017
Texas,POLK,30687,24531,3848,1610,6156,0.79939388,0.20060612,0.052465213
Texas,POTTER,97874,66877,8460,19246,30997,0.683296892,0.316703108,0.196640579
Texas,PRESIDIO,6637,1197,2,5417,5440,0.180352569,0.819647431,0.81618201
Texas,RAINS,6715,6234,284,158,481,0.928369322,0.071630678,0.023529412
Texas,RANDALL,89673,81364,1082,6144,8309,0.907341117,0.092658883,0.068515607
Texas,REAGAN,4514,2458,108,1941,2056,0.544528135,0.455471865,0.429995569
Texas,REAL,2412,1814,0,574,598,0.752072968,0.247927032,0.237976783
Texas,RED RIVER,14317,11107,2857,273,3210,0.775791018,0.224208982,0.019068241
Texas,REEVES,15852,3909,340,11545,11943,0.24659349,0.75340651,0.728299268
Texas,REFUGIO,7976,4181,608,3164,3795,0.524197593,0.475802407,0.39669007
Texas,ROBERTS,1025,988,0,34,37,0.963902439,0.036097561,0.033170732
Texas,ROBERTSON,15511,9373,4197,1904,6138,0.604280833,0.395719167,0.122751596
Texas,ROCKWALL,25604,22981,851,1500,2623,0.89755507,0.10244493,0.058584596
Texas,RUNNELS,11294,8340,181,2740,2954,0.738445192,0.261554808,0.242606694
Texas,RUSK,43735,32899,8924,1736,10836,0.752235052,0.247764948,0.039693609
Texas,SABINE,9586,8339,1109,111,1247,0.869914459,0.130085541,0.011579387
Texas,SAN AUGUSTINE,7999,5607,2236,138,2392,0.70096262,0.29903738,0.017252157
Texas,SAN JACINTO,16372,13319,2534,431,3053,0.813523088,0.186476912,0.026325434
Texas,SAN PATRICIO,58749,27669,863,29809,31080,0.470969719,0.529030281,0.507395871
Texas,SAN SABA,5401,4373,13,998,1028,0.809664877,0.190335123,0.184780596
Texas,SCHLEICHER,2990,1898,24,1062,1092,0.634782609,0.365217391,0.355183946
Texas,SCURRY,18634,13214,866,4454,5420,0.709133841,0.290866159,0.239025437
Texas,SHACKELFORD,3316,3016,12,272,300,0.909529554,0.090470446,0.082026538
Texas,SHELBY,22034,16719,4710,539,5315,0.758781883,0.241218117,0.024462195
Texas,SHERMAN,2858,2302,4,538,556,0.805458362,0.194541638,0.188243527
Texas,SMITH,151309,109853,31289,8986,41456,0.72601762,0.27398238,0.059388404
Texas,SOMERVELL,5360,4547,10,749,813,0.848320896,0.151679104,0.139738806
Texas,STARR,40518,1001,9,39390,39517,0.024705069,0.975294931,0.972160521
Texas,STEPHENS,9010,7950,234,767,1060,0.882352941,0.117647059,0.085127636
Texas,STERLING,1438,1067,0,366,371,0.742002782,0.257997218,0.254520167
Texas,STONEWALL,2013,1677,88,237,336,0.833084948,0.166915052,0.117734724
Texas,SUTTON,4135,2244,1,1866,1891,0.542684401,0.457315599,0.451269649
Texas,SWISHER,8133,5254,332,2496,2879,0.646010082,0.353989918,0.306897824
Texas,TARRANT,1170103,857272,138302,139879,312831,0.732646613,0.267353387,0.119544177
Texas,TAYLOR,119655,92955,7336,17511,26700,0.776858468,0.223141532,0.146345744
Texas,TERRELL,1410,651,1,751,759,0.461702128,0.538297872,0.532624113
Texas,TERRY,13218,7486,438,5194,5732,0.566348918,0.433651082,0.392949009
Texas,THROCKMORTON,1880,1732,0,136,148,0.921276596,0.078723404,0.072340426
Texas,TITUS,24009,18128,3188,2556,5881,0.75505019,0.24494981,0.106460077
Texas,TOM GREEN,98458,67642,3955,25501,30816,0.687013752,0.312986248,0.259003839
Texas,TRAVIS,576407,375279,60998,121689,201128,0.651066,0.348934,0.211116451
Texas,TRINITY,11445,9485,1642,272,1960,0.828746177,0.171253823,0.023765837
Texas,TYLER,16646,14426,1986,177,2220,0.866634627,0.133365373,0.010633185
Texas,UPSHUR,31370,26714,3858,641,4656,0.851577941,0.148422059,0.020433535
Texas,UPTON,4447,2666,88,1666,1781,0.599505284,0.400494716,0.374634585
Texas,UVALDE,23340,9030,35,14104,14310,0.38688946,0.61311054,0.60428449
Texas,VAL VERDE,38721,10418,680,27299,28303,0.269052969,0.730947031,0.705017949
Texas,VAN ZANDT,37944,34786,1451,1515,3158,0.916772085,0.083227915,0.039927261
Texas,VICTORIA,74361,43835,4638,25372,30526,0.589489114,0.410510886,0.34120036
Texas,WALKER,50917,32856,12050,5493,18061,0.645285465,0.354714535,0.107881454
Texas,WALLER,23390,11956,8738,2592,11434,0.511158615,0.488841385,0.110816588
Texas,WARD,13115,7728,432,4830,5387,0.589248952,0.410751048,0.368280595
Texas,WASHINGTON,26154,19321,5427,1158,6833,0.738739772,0.261260228,0.04427621
Texas,WEBB,133239,7427,68,125069,125812,0.055741937,0.944258063,0.938681617
Texas,WHARTON,39955,23501,6166,10103,16454,0.58818671,0.41181329,0.252859467
Texas,WHEELER,5879,5297,145,378,582,0.901003572,0.098996428,0.064296649
Texas,WICHITA,122378,98127,10986,10555,24251,0.801835297,0.198164703,0.086249162
Texas,WILBARGER,15121,11437,1336,2185,3684,0.75636532,0.24363468,0.144501025
Texas,WILLACY,17705,2648,73,14937,15057,0.149562271,0.850437729,0.843659983
Texas,WILLIAMSON,139551,110724,6537,20004,28827,0.793430359,0.206569641,0.143345444
Texas,WILSON,22650,14273,235,8054,8377,0.630154525,0.369845475,0.355584989
Texas,WINKLER,8626,5236,155,3172,3390,0.607002087,0.392997913,0.367725481
Texas,WISE,34679,31340,387,2663,3339,0.903716947,0.096283053,0.076789988
Texas,WOOD,29380,26069,2374,788,3311,0.887304289,0.112695711,0.026820967
Texas,YOAKUM,8786,5442,85,3217,3344,0.619394491,0.380605509,0.366150694
Texas,YOUNG,18126,16597,260,1164,1529,0.915646033,0.084353967,0.064217147
Texas,ZAPATA,9279,1726,1,7519,7553,0.186011424,0.813988576,0.810324388
Texas,ZAVALA,12162,954,284,10875,11208,0.078441046,0.921558954,0.894178589
Utah,BEAVER,4765,4584,5,120,181,0.96201469,0.03798531,0.025183631
Utah,BOX ELDER,36485,34085,16,1610,2400,0.934219542,0.065780458,0.044127724
Utah,CACHE,70183,65737,213,1780,4446,0.936651326,0.063348674,0.025362267
Utah,CARBON,20228,17670,54,2247,2558,0.873541625,0.126458375,0.111083646
Utah,DAGGETT,690,665,0,15,25,0.963768116,0.036231884,0.02173913
Utah,DAVIS,187941,174198,2282,7275,13743,0.926875988,0.073124012,0.038708957
Utah,DUCHESNE,12645,11630,8,350,1015,0.919731119,0.080268881,0.027678924
Utah,EMERY,10332,10035,4,219,297,0.971254355,0.028745645,0.021196283
Utah,GARFIELD,3980,3868,1,35,112,0.971859296,0.028140704,0.00879397
Utah,GRAND,6620,6108,6,291,512,0.92265861,0.07734139,0.043957704
Utah,IRON,20789,19669,40,382,1120,0.946125355,0.053874645,0.018375102
Utah,JUAB,5817,5644,2,73,173,0.970259584,0.029740416,0.012549424
Utah,KANE,5169,4962,5,101,207,0.959953569,0.040046431,0.019539563
Utah,MILLARD,11333,10647,2,402,686,0.939468808,0.060531192,0.035471632
Utah,MORGAN,5528,5421,7,78,107,0.980643994,0.019356006,0.014109986
Utah,PIUTE,1277,1252,0,15,25,0.980422866,0.019577134,0.01174628
Utah,RICH,1725,1696,1,21,29,0.983188406,0.016811594,0.012173913
Utah,SALT LAKE,725956,651565,5205,43647,74391,0.897526847,0.102473153,0.060123479
Utah,SAN JUAN,12621,5347,10,440,7274,0.423658981,0.576341019,0.034862531
Utah,SANPETE,16259,15329,11,560,930,0.94280091,0.05719909,0.034442463
Utah,SEVIER,15431,14798,5,289,633,0.958978679,0.041021321,0.018728533
Utah,SUMMIT,15518,15035,18,326,483,0.968874855,0.031125145,0.021007862
Utah,TOOELE,26601,22865,224,2960,3736,0.859554152,0.140445848,0.111274012
Utah,UINTAH,22211,19178,9,691,3033,0.86344604,0.13655396,0.031110711
Utah,UTAH,263590,249056,359,8488,14534,0.944861338,0.055138662,0.032201525
Utah,WASATCH,10089,9752,3,253,337,0.966597284,0.033402716,0.025076816
Utah,WASHINGTON,48560,46665,63,862,1895,0.960976112,0.039023888,0.017751236
Utah,WAYNE,2177,2109,1,25,68,0.968764355,0.031235645,0.011483693
Utah,WEBER,158330,141684,2314,11042,16646,0.894865155,0.105134845,0.069740416
Vermont,ADDISON,32953,32336,126,208,617,0.981276363,0.018723637,0.00631202
Vermont,BENNINGTON,35845,35276,114,220,569,0.984126098,0.015873902,0.006137537
Vermont,CALEDONIA,27846,27535,52,90,311,0.98883143,0.01116857,0.003232062
Vermont,CHITTENDEN,131761,127989,783,1179,3772,0.971372409,0.028627591,0.00894802
Vermont,ESSEX,6405,6331,13,30,74,0.988446526,0.011553474,0.004683841
Vermont,FRANKLIN,39980,39097,58,136,883,0.977913957,0.022086043,0.003401701
Vermont,GRAND ISLE,5318,5249,15,20,69,0.987025197,0.012974803,0.003760812
Vermont,LAMOILLE,19735,19493,27,89,242,0.987737522,0.012262478,0.004509754
Vermont,ORANGE,26149,25855,45,103,294,0.98875674,0.01124326,0.003938965
Vermont,ORLEANS,24053,23802,48,92,251,0.989564711,0.010435289,0.003824887
Vermont,RUTLAND,62142,61428,145,273,714,0.988510186,0.011489814,0.004393164
Vermont,WASHINGTON,54928,53758,165,663,1170,0.978699388,0.021300612,0.012070347
Vermont,WINDHAM,41588,40788,150,303,800,0.980763682,0.019236318,0.007285756
Vermont,WINDSOR,54055,53247,127,255,808,0.985052262,0.014947738,0.004717417
Virginia,ACCOMACK,31703,20315,10834,452,11388,0.640791092,0.359208908,0.014257326
Virginia,ALBEMARLE,68040,58700,6799,786,9340,0.862727807,0.137272193,0.011552028
Virginia,ALLEGHANY,13176,12741,328,54,435,0.966985428,0.033014572,0.004098361
Virginia,AMELIA,8787,5905,2809,45,2882,0.672015477,0.327984523,0.005121202
Virginia,AMHERST,28578,22421,5720,231,6157,0.784554552,0.215445448,0.008083141
Virginia,APPOMATTOX,12298,9439,2810,30,2859,0.767523174,0.232476826,0.002439421
Virginia,ARLINGTON,170936,118728,17225,23089,52208,0.694575748,0.305424252,0.135073946
Virginia,AUGUSTA,54677,52259,1998,239,2418,0.955776652,0.044223348,0.004371125
Virginia,BATH,4799,4515,247,23,284,0.940821004,0.059178996,0.004792665
Virginia,BEDFORD,45656,41721,3584,177,3935,0.913811985,0.086188015,0.003876818
Virginia,BLAND,6514,6250,229,24,264,0.959471907,0.040528093,0.003684372
Virginia,BOTETOURT,24992,23647,1114,143,1345,0.946182778,0.053817222,0.005721831
Virginia,BRUNSWICK,15987,6594,9321,47,9393,0.412460124,0.587539876,0.002939889
Virginia,BUCHANAN,31333,30954,55,257,379,0.987904127,0.012095873,0.008202215
Virginia,BUCKINGHAM,12873,7551,5237,38,5322,0.586576556,0.413423444,0.002951915
Virginia,CAMPBELL,47572,40290,6857,216,7282,0.846926764,0.153073236,0.004540486
Virginia,CAROLINE,19217,11631,7230,100,7586,0.605245356,0.394754644,0.005203726
Virginia,CARROLL,26594,26286,109,151,308,0.98841844,0.01158156,0.005677972
Virginia,CHARLES CITY,6282,1794,3962,24,4488,0.285577841,0.714422159,0.003820439
Virginia,CHARLOTTE,11688,7372,4258,33,4316,0.630732375,0.369267625,0.002823409
Virginia,CHESTERFIELD,209274,175516,27024,2511,33758,0.838689947,0.161310053,0.011998624
Virginia,CLARKE,12101,10916,1052,82,1185,0.902074209,0.097925791,0.006776299
Virginia,CRAIG,4372,4350,8,5,22,0.994967978,0.005032022,0.001143641
Virginia,CULPEPER,27791,22452,4764,192,5339,0.807887446,0.192112554,0.006908711
Virginia,CUMBERLAND,7825,4738,3023,45,3087,0.605495208,0.394504792,0.005750799
Virginia,DICKENSON,17620,17467,68,58,153,0.991316686,0.008683314,0.003291714
Virginia,DINWIDDIE,20960,13293,7454,122,7667,0.634208015,0.365791985,0.005820611
Virginia,ESSEX,8689,5311,3259,30,3378,0.611232593,0.388767407,0.003452641
Virginia,FAIRFAX,818584,633935,61964,51874,184649,0.77442877,0.22557123,0.063370405
Virginia,FAUQUIER,48741,42291,5425,602,6450,0.867667877,0.132332123,0.012350998
Virginia,FLOYD,12005,11616,292,59,389,0.967596835,0.032403165,0.004914619
Virginia,FLUVANNA,12429,9475,2841,69,2954,0.762330035,0.237669965,0.005551533
Virginia,FRANKLIN,39549,35057,4225,137,4492,0.886419378,0.113580622,0.003464057
Virginia,FREDERICK,45723,44312,830,291,1411,0.969140258,0.030859742,0.006364412
Virginia,GILES,16366,15994,283,57,372,0.97726995,0.02273005,0.00348283
Virginia,GLOUCESTER,30131,26239,3343,287,3892,0.870830706,0.129169294,0.009525074
Virginia,GOOCHLAND,14163,9880,4200,33,4283,0.697592318,0.302407682,0.002330015
Virginia,GRAYSON,16278,15687,486,75,591,0.963693328,0.036306672,0.004607446
Virginia,GREENE,10297,9536,664,53,761,0.926094979,0.073905021,0.00514713
Virginia,GREENSVILLE,8853,3884,4870,64,4969,0.438721337,0.561278663,0.007229188
Virginia,HALIFAX,29033,17440,11333,164,11593,0.60069576,0.39930424,0.005648745
Virginia,HANOVER,63306,56191,6385,321,7115,0.887609389,0.112390611,0.005070609
Virginia,HENRICO,217881,167062,43648,2171,50819,0.766758001,0.233241999,0.009964155
Virginia,HENRY,56942,43396,13119,253,13546,0.762108812,0.237891188,0.004443118
Virginia,HIGHLAND,2635,2625,3,5,10,0.996204934,0.003795066,0.001897533
Virginia,ISLE OF WIGHT,25053,16883,7876,172,8170,0.67389135,0.32610865,0.006865445
Virginia,JAMES CITY,34859,27526,6430,382,7333,0.789638257,0.210361743,0.010958433
Virginia,KING AND QUEEN,6289,3552,2632,28,2737,0.564795675,0.435204325,0.004452218
Virginia,KING GEORGE,13527,10490,2724,156,3037,0.775486065,0.224513935,0.011532491
Virginia,KING WILLIAM,10913,7307,3295,66,3606,0.669568405,0.330431595,0.006047833
Virginia,LANCASTER,10896,7554,3248,75,3342,0.693281938,0.306718062,0.00688326
Virginia,LEE,24496,24240,91,119,256,0.989549314,0.010450686,0.004857936
Virginia,LOUDOUN,86129,75557,6126,2156,10572,0.877253887,0.122746113,0.025032219
Virginia,LOUISA,20325,14899,5205,108,5426,0.73303813,0.26696187,0.005313653
Virginia,LUNENBURG,11419,7040,4266,83,4379,0.616516332,0.383483668,0.007268587
Virginia,MADISON,11949,10156,1697,35,1793,0.849945602,0.150054398,0.002929115
Virginia,MATHEWS,8348,7112,1159,49,1236,0.851940585,0.148059415,0.005869669
Virginia,MECKLENBURG,29241,17873,11192,108,11368,0.611230806,0.388769194,0.003693444
Virginia,MIDDLESEX,8653,6475,2112,48,2178,0.748295389,0.251704611,0.005547209
Virginia,MONTGOMERY,73913,67431,2800,793,6482,0.912302301,0.087697699,0.01072883
Virginia,NELSON,12778,10219,2395,118,2559,0.799733918,0.200266082,0.009234622
Virginia,NEW KENT,10445,8039,2140,78,2406,0.769650551,0.230349449,0.007467688
Virginia,NORTHAMPTON,13061,6747,6025,256,6314,0.516576066,0.483423934,0.019600337
Virginia,NORTHUMBERLAND,10524,7361,3082,51,3163,0.699448879,0.300551121,0.004846066
Virginia,NOTTOWAY,14993,8709,6124,83,6284,0.580871073,0.419128927,0.005535917
Virginia,ORANGE,21421,18138,3059,142,3283,0.846739181,0.153260819,0.006629009
Virginia,PAGE,21690,21055,439,106,635,0.970723836,0.029276164,0.004887045
Virginia,PATRICK,17473,16069,1248,123,1404,0.919647456,0.080352544,0.007039432
Virginia,PITTSYLVANIA,55655,40443,14867,239,15212,0.726673255,0.273326745,0.004294313
Virginia,POWHATAN,15328,11938,3273,59,3390,0.778836117,0.221163883,0.003849165
Virginia,PRINCE EDWARD,17320,10856,6235,114,6464,0.626789838,0.373210162,0.006581986
Virginia,PRINCE GEORGE,27394,17808,7832,1060,9586,0.650069358,0.349930642,0.038694605
Virginia,PRINCE WILLIAM,215686,174082,24677,9662,41604,0.807108482,0.192891518,0.044796602
Virginia,PULASKI,34496,32228,1991,154,2268,0.934253247,0.065746753,0.004464286
Virginia,RAPPAHANNOCK,6622,6041,491,67,581,0.912262156,0.087737844,0.010117789
Virginia,RICHMOND,7273,5004,2186,52,2269,0.688024199,0.311975801,0.007149732
Virginia,ROANOKE,79332,76181,2012,440,3151,0.960280845,0.039719155,0.005546312
Virginia,ROCKBRIDGE,18350,17639,569,56,711,0.961253406,0.038746594,0.003051771
Virginia,ROCKINGHAM,57482,55881,864,546,1601,0.972147803,0.027852197,0.009498626
Virginia,RUSSELL,28667,28248,315,76,419,0.985383891,0.014616109,0.002651132
Virginia,SCOTT,23204,22962,143,74,242,0.989570764,0.010429236,0.003189105
Virginia,SHENANDOAH,31636,30860,358,292,776,0.975470982,0.024529018,0.009229991
Virginia,SMYTH,32370,31508,656,104,862,0.973370405,0.026629595,0.003212851
Virginia,SOUTHAMPTON,17550,9605,7845,67,7945,0.547293447,0.452706553,0.003817664
Virginia,SPOTSYLVANIA,57403,49606,6153,843,7797,0.864170862,0.135829138,0.014685644
Virginia,STAFFORD,61236,54761,4241,1252,6475,0.894261545,0.105738455,0.02044549
Virginia,SURRY,6145,2704,3410,19,3441,0.440032547,0.559967453,0.003091945
Virginia,SUSSEX,10248,4244,5951,23,6004,0.414129586,0.585870414,0.00224434
Virginia,TAZEWELL,45960,44349,1184,134,1611,0.964947781,0.035052219,0.002915579
Virginia,WARREN,26142,24492,1286,248,1650,0.936883176,0.063116824,0.00948665
Virginia,WASHINGTON,45887,44967,681,138,920,0.979950749,0.020049251,0.003007388
Virginia,WESTMORELAND,15480,10187,5093,100,5293,0.658074935,0.341925065,0.006459948
Virginia,WISE,39573,38596,706,113,977,0.97531145,0.02468855,0.002855482
Virginia,WYTHE,25466,24430,880,60,1036,0.959318307,0.040681693,0.002356083
Virginia,YORK,42422,34061,6560,723,8361,0.802908868,0.197091132,0.017043044
Virginia,ALEXANDRIA CITY,111183,71486,23957,10778,39697,0.642958006,0.357041994,0.09693928
Virginia,BEDFORD CITY,6073,4653,1327,53,1420,0.766178166,0.233821834,0.008727153
Virginia,BRISTOL CITY,18426,17194,1058,64,1232,0.933137957,0.066862043,0.003473353
Virginia,BUENA VISTA CITY,6406,6086,280,12,320,0.950046831,0.049953169,0.001873244
Virginia,CHARLOTTESVILLE CITY,40341,30345,8520,476,9996,0.752212389,0.247787611,0.01179941
Virginia,CHESAPEAKE CITY,151976,106310,41443,1913,45666,0.699518345,0.300481655,0.012587514
Virginia,CLIFTON FORGE CITY,4679,3950,693,25,729,0.844197478,0.155802522,0.005343022
Virginia,COLONIAL HEIGHTS CITY,16064,15398,128,161,666,0.958540837,0.041459163,0.01002241
Virginia,COVINGTON CITY,6991,5936,969,27,1055,0.849091689,0.150908311,0.003862108
Virginia,DANVILLE CITY,53056,33106,19345,276,19950,0.623982207,0.376017793,0.005202051
Virginia,EMPORIA CITY,5306,2825,2387,59,2481,0.532416133,0.467583867,0.011119487
Virginia,FAIRFAX CITY,19622,16100,936,1159,3522,0.820507594,0.179492406,0.059066354
Virginia,FALLS CHURCH CITY,9578,8189,284,604,1389,0.854980163,0.145019837,0.063061182
Virginia,FRANKLIN CITY,7864,3630,4192,15,4234,0.461597152,0.538402848,0.001907426
Virginia,FREDERICKSBURG CITY,19027,14245,4081,463,4782,0.748672938,0.251327062,0.024333841
Virginia,GALAX CITY,6670,6192,387,65,478,0.928335832,0.071664168,0.009745127
Virginia,HAMPTON CITY,133793,76909,51519,2636,56884,0.574835754,0.425164246,0.019702077
Virginia,HARRISONBURG CITY,30707,27691,2005,481,3016,0.901781353,0.098218647,0.015664181
Virginia,HOPEWELL CITY,23101,16456,5863,417,6645,0.712350115,0.287649885,0.018051167
Virginia,LEXINGTON CITY,6959,5982,809,62,977,0.859606265,0.140393735,0.008909326
Virginia,LYNCHBURG CITY,66049,47591,17371,476,18458,0.720540811,0.279459189,0.007206771
Virginia,MANASSAS CITY,27957,22545,2841,1601,5412,0.806416998,0.193583002,0.057266516
Virginia,MANASSAS PARK CITY,6734,5760,481,314,974,0.855360855,0.144639145,0.046629047
Virginia,MARTINSVILLE CITY,16162,10119,5929,59,6043,0.626098255,0.373901745,0.003650538
Virginia,NEWPORT NEWS CITY,170045,104424,56450,4710,65621,0.614096269,0.385903731,0.02769855
Virginia,NORFOLK CITY,261229,145136,100966,7611,116093,0.555589157,0.444410843,0.029135356
Virginia,NORTON CITY,4247,3900,268,31,347,0.918295267,0.081704733,0.00729927
Virginia,PETERSBURG CITY,38386,10051,27502,472,28335,0.261840254,0.738159746,0.01229615
Virginia,POQUOSON CITY,11005,10643,82,96,362,0.967105861,0.032894139,0.008723308
Virginia,PORTSMOUTH CITY,103907,52579,48876,1364,51328,0.506019806,0.493980194,0.013127123
Virginia,RADFORD CITY,15940,14521,952,175,1419,0.91097867,0.08902133,0.01097867
Virginia,RICHMOND CITY,203056,87222,111644,1898,115834,0.429546529,0.570453471,0.009347175
Virginia,ROANOKE CITY,96397,71524,23275,665,24873,0.741973298,0.258026702,0.006898555
Virginia,SALEM CITY,23756,22396,1051,111,1360,0.942751305,0.057248695,0.004672504
Virginia,SOUTH BOSTON CITY,6997,4356,2549,45,2641,0.622552523,0.377447477,0.006431328
Virginia,STAUNTON CITY,24461,21077,3072,169,3384,0.861657332,0.138342668,0.006908957
Virginia,SUFFOLK CITY,52141,28367,23141,319,23774,0.544044034,0.455955966,0.006118026
Virginia,VIRGINIA BEACH CITY,393069,309712,53720,12137,83357,0.787932907,0.212067093,0.03087753
Virginia,WAYNESBORO CITY,18549,16586,1738,150,1963,0.894172193,0.105827807,0.008086689
Virginia,WILLIAMSBURG CITY,11530,9272,1739,151,2258,0.804163053,0.195836947,0.013096271
Virginia,WINCHESTER CITY,21947,19297,2190,219,2650,0.879254568,0.120745432,0.009978585
Washington,ADAMS,13603,8933,29,4467,4670,0.656693376,0.343306624,0.328383445
Washington,ASOTIN,17605,16939,37,278,666,0.962169838,0.037830162,0.015790968
Washington,BENTON,112560,99778,1054,8624,12782,0.886442786,0.113557214,0.076616915
Washington,CHELAN,52250,46533,75,4786,5717,0.890583732,0.109416268,0.091598086
Washington,CLALLAM,56464,51838,302,1150,4626,0.918071692,0.081928308,0.020366959
Washington,CLARK,238053,221552,2873,5872,16501,0.930683503,0.069316497,0.024666776
Washington,COLUMBIA,4024,3515,1,463,509,0.873508946,0.126491054,0.115059642
Washington,COWLITZ,82119,77738,282,1672,4381,0.946650592,0.053349408,0.020360696
Washington,DOUGLAS,26205,23075,41,2721,3130,0.880557146,0.119442854,0.103835146
Washington,FERRY,6295,5044,20,85,1251,0.80127085,0.19872915,0.01350278
Washington,FRANKLIN,37473,23784,1251,11316,13689,0.634696982,0.365303018,0.301977424
Washington,GARFIELD,2248,2207,0,22,41,0.981761566,0.018238434,0.009786477
Washington,GRANT,54758,43580,569,9427,11178,0.795865444,0.204134556,0.172157493
Washington,GRAYS HARBOR,64175,59576,116,1173,4599,0.92833658,0.07166342,0.018278146
Washington,ISLAND,60195,53871,1424,2006,6324,0.89494144,0.10505856,0.033325027
Washington,JEFFERSON,20146,19070,78,241,1076,0.946589894,0.053410106,0.011962672
Washington,KING,1507319,1255190,74669,44337,252129,0.832730165,0.167269835,0.029414477
Washington,KITSAP,189731,167850,4973,6169,21881,0.884673564,0.115326436,0.032514455
Washington,KITTITAS,26725,25222,147,684,1503,0.943760524,0.056239476,0.025594013
Washington,KLICKITAT,16616,14955,24,928,1661,0.90003611,0.09996389,0.055849783
Washington,LEWIS,59358,56834,182,1366,2524,0.957478352,0.042521648,0.023012905
Washington,LINCOLN,8864,8603,12,83,261,0.970555054,0.029444946,0.009363718
Washington,MASON,38341,35299,308,883,3042,0.920659346,0.079340654,0.023030177
Washington,OKANOGAN,33350,26892,47,2779,6458,0.806356822,0.193643178,0.083328336
Washington,PACIFIC,18882,17431,55,433,1451,0.923154327,0.076845673,0.022931893
Washington,PEND OREILLE,8915,8564,12,120,351,0.960628155,0.039371845,0.01346046
Washington,PIERCE,586203,488396,41105,20562,97807,0.833151656,0.166848344,0.035076586
Washington,SAN JUAN,10035,9728,23,121,307,0.969407075,0.030592925,0.012057798
Washington,SKAGIT,79555,72420,264,4335,7135,0.91031362,0.08968638,0.054490604
Washington,SKAMANIA,8289,7868,4,172,421,0.949209796,0.050790204,0.020750392
Washington,SNOHOMISH,465642,428056,4640,10656,37586,0.919281336,0.080718664,0.022884534
Washington,SPOKANE,361364,337561,4972,6994,23803,0.934130129,0.065869871,0.019354446
Washington,STEVENS,30948,28475,65,483,2473,0.920091767,0.079908233,0.015606824
Washington,THURSTON,161238,145367,2761,4873,15871,0.901567869,0.098432131,0.030222404
Washington,WAHKIAKUM,3327,3185,3,71,142,0.957318906,0.042681094,0.021340547
Washington,WALLA WALLA,48439,42064,697,4703,6375,0.868391172,0.131608828,0.097091187
Washington,WHATCOM,127780,117213,623,3718,10567,0.917303177,0.082696823,0.029096885
Washington,WHITMAN,38775,35269,477,683,3506,0.909580916,0.090419084,0.017614442
Washington,YAKIMA,188823,132147,1785,45114,56676,0.699845887,0.300154113,0.238922165
West Virginia,BARBOUR,15699,15257,147,89,442,0.97184534,0.02815466,0.005669151
West Virginia,BERKELEY,59253,56274,2191,399,2979,0.949724065,0.050275935,0.006733836
West Virginia,BOONE,25870,25552,214,48,318,0.98770777,0.01229223,0.001855431
West Virginia,BRAXTON,12998,12872,46,37,126,0.990306201,0.009693799,0.002846592
West Virginia,BROOKE,26992,26605,201,85,387,0.985662418,0.014337582,0.003149081
West Virginia,CABELL,96827,91760,3961,442,5067,0.947669555,0.052330445,0.004564842
West Virginia,CALHOUN,7885,7818,2,18,67,0.991502854,0.008497146,0.002282815
West Virginia,CLAY,9983,9955,1,14,28,0.997195232,0.002804768,0.001402384
West Virginia,DODDRIDGE,6994,6941,2,12,53,0.992422076,0.007577924,0.001715756
West Virginia,FAYETTE,47952,44491,3009,252,3461,0.927823657,0.072176343,0.005255255
West Virginia,GILMER,7669,7573,32,24,96,0.987482071,0.012517929,0.003129482
West Virginia,GRANT,10428,10240,106,35,188,0.981971615,0.018028385,0.003356348
West Virginia,GREENBRIER,34693,33187,1265,137,1506,0.956590667,0.043409333,0.003948923
West Virginia,HAMPSHIRE,16498,16249,109,93,249,0.984907261,0.015092739,0.005637047
West Virginia,HANCOCK,35233,33975,899,199,1258,0.964294837,0.035705163,0.005648114
West Virginia,HARDY,10977,10694,209,55,283,0.974218821,0.025781179,0.005010476
West Virginia,HARRISON,69371,67318,965,817,2053,0.970405501,0.029594499,0.011777256
West Virginia,JACKSON,25938,25765,15,65,173,0.993330249,0.006669751,0.002505976
West Virginia,JEFFERSON,35926,32656,2632,428,3270,0.908979569,0.091020431,0.011913377
West Virginia,KANAWHA,207619,191383,13737,897,16236,0.921799065,0.078200935,0.004320414
West Virginia,LEWIS,17223,17038,48,67,185,0.98925855,0.01074145,0.003890147
West Virginia,LINCOLN,21382,21296,6,48,86,0.995977925,0.004022075,0.002244879
West Virginia,LOGAN,43032,41167,1355,281,1865,0.95666016,0.04333984,0.006530024
West Virginia,MCDOWELL,35233,30258,4732,182,4975,0.85879715,0.14120285,0.005165612
West Virginia,MARION,57249,54804,1849,311,2445,0.95729183,0.04270817,0.005432409
West Virginia,MARSHALL,37356,36800,203,229,556,0.985116179,0.014883821,0.006130207
West Virginia,MASON,25178,24901,112,53,277,0.988998332,0.011001668,0.002105012
West Virginia,MERCER,64980,60198,4121,269,4782,0.926408126,0.073591874,0.004139735
West Virginia,MINERAL,26697,25795,721,101,902,0.966213432,0.033786568,0.003783197
West Virginia,MINGO,33739,32706,822,124,1033,0.969382614,0.030617386,0.003675272
West Virginia,MONONGALIA,75509,71325,1811,637,4184,0.944589387,0.055410613,0.00843608
West Virginia,MONROE,12406,12173,159,41,233,0.981218765,0.018781235,0.003304852
West Virginia,MORGAN,12128,11944,91,50,184,0.984828496,0.015171504,0.004122691
West Virginia,NICHOLAS,26775,26629,4,57,146,0.994547152,0.005452848,0.002128852
West Virginia,OHIO,50871,48665,1683,146,2206,0.956635411,0.043364589,0.002870005
West Virginia,PENDLETON,8054,7849,165,27,205,0.974546809,0.025453191,0.003352371
West Virginia,PLEASANTS,7546,7505,17,9,41,0.994566658,0.005433342,0.001192685
West Virginia,POCAHONTAS,9008,8892,69,31,116,0.987122558,0.012877442,0.003441385
West Virginia,PRESTON,29037,28829,73,77,208,0.992836726,0.007163274,0.002651789
West Virginia,PUTNAM,42835,42373,126,145,462,0.989214427,0.010785573,0.003385082
West Virginia,RALEIGH,76819,70117,5862,320,6702,0.912755959,0.087244041,0.004165636
West Virginia,RANDOLPH,27803,27328,222,144,475,0.982915513,0.017084487,0.005179297
West Virginia,RITCHIE,10233,10205,7,7,28,0.997263755,0.002736245,0.000684061
West Virginia,ROANE,15120,15027,4,37,93,0.993849206,0.006150794,0.00244709
West Virginia,SUMMERS,14204,13228,698,211,976,0.931286961,0.068713039,0.01485497
West Virginia,TAYLOR,15144,14939,95,64,205,0.986463286,0.013536714,0.004226096
West Virginia,TUCKER,7728,7688,4,16,40,0.994824017,0.005175983,0.002070393
West Virginia,TYLER,9796,9740,4,22,56,0.994283381,0.005716619,0.002245815
West Virginia,UPSHUR,22867,22540,118,112,327,0.985699917,0.014300083,0.004897888
West Virginia,WAYNE,41636,41382,19,114,254,0.99389951,0.00610049,0.002738015
West Virginia,WEBSTER,10729,10676,3,29,53,0.995060117,0.004939883,0.002702955
West Virginia,WETZEL,19258,19154,16,37,104,0.994599647,0.005400353,0.001921279
West Virginia,WIRT,5192,5181,4,3,11,0.997881356,0.002118644,0.000577812
West Virginia,WOOD,86915,85378,786,254,1537,0.982316056,0.017683944,0.002922395
West Virginia,WYOMING,28990,28601,234,88,389,0.98658158,0.01341842,0.003035529
Wisconsin,ADAMS,15682,14849,353,308,833,0.946881775,0.053118225,0.019640352
Wisconsin,ASHLAND,16307,14690,13,106,1617,0.90084013,0.09915987,0.006500276
Wisconsin,BARRON,40750,40255,36,164,495,0.987852761,0.012147239,0.00402454
Wisconsin,BAYFIELD,14008,12676,29,50,1332,0.904911479,0.095088521,0.003569389
Wisconsin,BROWN,194594,185869,992,1525,8725,0.955163057,0.044836943,0.00783683
Wisconsin,BUFFALO,13584,13487,5,42,97,0.992859246,0.007140754,0.003091873
Wisconsin,BURNETT,13084,12462,22,43,622,0.952461021,0.047538979,0.003286457
Wisconsin,CALUMET,34291,33798,29,149,493,0.98562305,0.01437695,0.004345163
Wisconsin,CHIPPEWA,52360,51740,31,174,620,0.9881589,0.0118411,0.003323147
Wisconsin,CLARK,31647,31373,29,116,274,0.991341991,0.008658009,0.003665434
Wisconsin,COLUMBIA,45088,44234,233,358,854,0.981059262,0.018940738,0.007940028
Wisconsin,CRAWFORD,15940,15747,46,67,193,0.987892095,0.012107905,0.004203262
Wisconsin,DANE,367085,341057,10303,5744,26028,0.929095441,0.070904559,0.015647602
Wisconsin,DODGE,76559,74131,1113,911,2428,0.968285897,0.031714103,0.011899319
Wisconsin,DOOR,25690,25287,28,153,403,0.984312962,0.015687038,0.005955625
Wisconsin,DOUGLAS,41758,40317,169,201,1441,0.965491642,0.034508358,0.004813449
Wisconsin,DUNN,35909,34819,172,188,1090,0.969645493,0.030354507,0.005235456
Wisconsin,EAU CLAIRE,85183,81939,230,437,3244,0.961917284,0.038082716,0.005130132
Wisconsin,FLORENCE,4590,4556,4,11,34,0.992592593,0.007407407,0.002396514
Wisconsin,FOND DU LAC,90083,88157,251,937,1926,0.978619717,0.021380283,0.010401519
Wisconsin,FOREST,8776,7828,125,30,948,0.891978122,0.108021878,0.003418414
Wisconsin,GRANT,49264,48717,76,160,547,0.988896557,0.011103443,0.003247808
Wisconsin,GREEN,30339,30084,20,119,255,0.991594977,0.008405023,0.003922344
Wisconsin,GREEN LAKE,18651,18291,21,192,360,0.980698086,0.019301914,0.010294354
Wisconsin,IOWA,20150,20051,7,48,99,0.995086849,0.004913151,0.002382134
Wisconsin,IRON,6153,6117,1,8,36,0.994149196,0.005850804,0.001300179
Wisconsin,JACKSON,16588,15704,44,145,884,0.946708464,0.053291536,0.008741259
Wisconsin,JEFFERSON,67783,65969,188,1160,1814,0.973238128,0.026761872,0.017113436
Wisconsin,JUNEAU,21650,21228,28,152,422,0.980508083,0.019491917,0.007020785
Wisconsin,KENOSHA,128181,116223,5190,5580,11958,0.906710043,0.093289957,0.043532193
Wisconsin,KEWAUNEE,18878,18730,24,54,148,0.992160186,0.007839814,0.002860473
Wisconsin,LA CROSSE,97904,93954,405,640,3950,0.959654355,0.040345645,0.006537016
Wisconsin,LAFAYETTE,16076,15994,10,37,82,0.994899229,0.005100771,0.002301568
Wisconsin,LANGLADE,19505,19222,13,104,283,0.9854909,0.0145091,0.005331966
Wisconsin,LINCOLN,26993,26623,79,118,370,0.986292743,0.013707257,0.004371504
Wisconsin,MANITOWOC,80421,78360,113,582,2061,0.974372365,0.025627635,0.007236916
Wisconsin,MARATHON,115400,111927,87,470,3473,0.969904679,0.030095321,0.00407279
Wisconsin,MARINETTE,40548,40164,8,156,384,0.990529743,0.009470257,0.003847292
Wisconsin,MARQUETTE,12321,12074,31,149,247,0.979952926,0.020047074,0.012093174
Wisconsin,MENOMINEE,3890,413,0,55,3477,0.106169666,0.893830334,0.014138817
Wisconsin,MILWAUKEE,959275,698864,193583,44671,260411,0.728533528,0.271466472,0.04656746
Wisconsin,MONROE,36633,35836,136,234,797,0.97824366,0.02175634,0.006387683
Wisconsin,OCONTO,30226,29855,18,107,371,0.987725799,0.012274201,0.003539999
Wisconsin,ONEIDA,31679,31258,57,90,421,0.986710439,0.013289561,0.002840999
Wisconsin,OUTAGAMIE,140510,135505,191,987,5005,0.964379759,0.035620241,0.007024411
Wisconsin,OZAUKEE,72831,71274,485,517,1557,0.978621741,0.021378259,0.007098626
Wisconsin,PEPIN,7107,7057,2,20,50,0.992964683,0.007035317,0.002814127
Wisconsin,PIERCE,32765,32233,79,196,532,0.983763162,0.016236838,0.005981993
Wisconsin,POLK,34773,34258,20,131,515,0.985189659,0.014810341,0.003767291
Wisconsin,PORTAGE,61405,59656,152,572,1749,0.971516977,0.028483023,0.009315202
Wisconsin,PRICE,15600,15434,7,59,166,0.989358974,0.010641026,0.003782051
Wisconsin,RACINE,175034,147745,16693,9034,27289,0.844093148,0.155906852,0.05161283
Wisconsin,RICHLAND,17521,17375,12,59,146,0.991667142,0.008332858,0.003367388
Wisconsin,ROCK,139510,129788,6593,1754,9722,0.930313239,0.069686761,0.012572575
Wisconsin,RUSK,15079,14768,31,85,311,0.97937529,0.02062471,0.005636979
Wisconsin,ST. CROIX,50251,49743,44,192,508,0.989890748,0.010109252,0.003820819
Wisconsin,SAUK,46975,46347,53,207,628,0.986631187,0.013368813,0.004406599
Wisconsin,SAWYER,14181,11928,18,101,2253,0.84112545,0.15887455,0.007122206
Wisconsin,SHAWANO,37157,35162,42,129,1995,0.946308905,0.053691095,0.003471755
Wisconsin,SHEBOYGAN,103877,99447,412,1668,4430,0.957353408,0.042646592,0.016057453
Wisconsin,TAYLOR,18901,18774,2,42,127,0.993280779,0.006719221,0.002222105
Wisconsin,TREMPEALEAU,25263,25120,12,53,143,0.994339548,0.005660452,0.00209793
Wisconsin,VERNON,25617,25429,12,98,188,0.992661123,0.007338877,0.003825585
Wisconsin,VILAS,17707,16073,9,61,1634,0.907720111,0.092279889,0.003444965
Wisconsin,WALWORTH,75000,71834,443,2017,3166,0.957786667,0.042213333,0.026893333
Wisconsin,WASHBURN,13772,13554,25,34,218,0.984170781,0.015829219,0.002468777
Wisconsin,WASHINGTON,95328,94002,121,670,1326,0.986090131,0.013909869,0.007028365
Wisconsin,WAUKESHA,304715,294855,1058,5448,9860,0.967641895,0.032358105,0.017879002
Wisconsin,WAUPACA,46104,45465,22,406,639,0.986140031,0.013859969,0.008806177
Wisconsin,WAUSHARA,19385,18867,29,379,518,0.973278308,0.026721692,0.019551199
Wisconsin,WINNEBAGO,140320,136094,689,1144,4226,0.969883124,0.030116876,0.008152794
Wisconsin,WOOD,73605,71961,89,386,1644,0.977664561,0.022335439,0.005244209
Wyoming,ALBANY,30797,27714,238,1988,3083,0.899892847,0.100107153,0.064551742
Wyoming,BIG HORN,10525,9895,2,551,630,0.940142518,0.059857482,0.052351544
Wyoming,CAMPBELL,29370,28074,34,882,1296,0.95587334,0.04412666,0.030030644
Wyoming,CARBON,16659,14050,91,2315,2609,0.843387958,0.156612042,0.138963923
Wyoming,CONVERSE,11128,10411,15,565,717,0.935567937,0.064432063,0.050772825
Wyoming,CROOK,5294,5238,0,26,56,0.989421987,0.010578013,0.00491122
Wyoming,FREMONT,33662,26273,45,1336,7389,0.780494326,0.219505674,0.03968867
Wyoming,GOSHEN,12373,11171,24,1078,1202,0.902852986,0.097147014,0.087125192
Wyoming,HOT SPRINGS,4809,4626,14,67,183,0.961946351,0.038053649,0.01393221
Wyoming,JOHNSON,6145,6004,1,78,141,0.977054516,0.022945484,0.012693247
Wyoming,LARAMIE,73142,62410,2113,7310,10732,0.853271718,0.146728282,0.099942577
Wyoming,LINCOLN,12625,12266,9,252,359,0.971564356,0.028435644,0.019960396
Wyoming,NATRONA,61226,57888,438,2252,3338,0.945480678,0.054519322,0.036781759
Wyoming,NIOBRARA,2499,2434,6,36,65,0.973989596,0.026010404,0.014405762
Wyoming,PARK,23178,22112,19,825,1066,0.954008111,0.045991889,0.035594098
Wyoming,PLATTE,8145,7708,3,404,437,0.946347452,0.053652548,0.049600982
Wyoming,SHERIDAN,23562,22789,35,444,773,0.967192938,0.032807062,0.018843901
Wyoming,SUBLETTE,4843,4698,5,57,145,0.97005988,0.02994012,0.011769564
Wyoming,SWEETWATER,38823,34529,282,3470,4294,0.889395461,0.110604539,0.089380007
Wyoming,TETON,11172,10864,17,158,308,0.972431078,0.027568922,0.014142499
Wyoming,UINTA,18705,17725,25,773,980,0.947607592,0.052392408,0.041325849
Wyoming,WASHAKIE,8388,7490,7,801,898,0.892942299,0.107057701,0.095493562
Wyoming,WESTON,6518,6342,3,83,176,0.972997852,0.027002148,0.012733967